stateCode,reportDate,source,cases_day,recovered_day,deaths_day,reportDate_timestamp,ags,community_name,cases,deaths,recovered,population_number,population_density
DE-BW,05-03-2020,RKI,0,0,0,1583366400000,08111,Stuttgart,0,0,0,634830,3062
DE-BW,06-03-2020,RKI,1,1,0,1583452800000,08111,Stuttgart,1,0,1,634830,3062
DE-BW,07-03-2020,RKI,4,4,0,1583539200000,08111,Stuttgart,5,0,5,634830,3062
DE-BW,09-03-2020,RKI,7,7,0,1583712000000,08111,Stuttgart,12,0,12,634830,3062
DE-BW,10-03-2020,RKI,11,11,0,1583798400000,08111,Stuttgart,23,0,23,634830,3062
DE-BW,11-03-2020,RKI,5,5,0,1583884800000,08111,Stuttgart,28,0,28,634830,3062
DE-BW,12-03-2020,RKI,9,9,0,1583971200000,08111,Stuttgart,37,0,37,634830,3062
DE-BW,13-03-2020,RKI,37,37,0,1584057600000,08111,Stuttgart,74,0,74,634830,3062
DE-BW,14-03-2020,RKI,32,32,0,1584144000000,08111,Stuttgart,106,0,106,634830,3062
DE-BW,15-03-2020,RKI,19,19,0,1584230400000,08111,Stuttgart,125,0,125,634830,3062
DE-BW,16-03-2020,RKI,69,68,1,1584316800000,08111,Stuttgart,194,1,193,634830,3062
DE-BW,17-03-2020,RKI,26,26,0,1584403200000,08111,Stuttgart,220,1,219,634830,3062
DE-BW,18-03-2020,RKI,66,63,3,1584489600000,08111,Stuttgart,286,4,282,634830,3062
DE-BW,19-03-2020,RKI,33,31,2,1584576000000,08111,Stuttgart,319,6,313,634830,3062
DE-BW,20-03-2020,RKI,61,60,1,1584662400000,08111,Stuttgart,380,7,373,634830,3062
DE-BW,21-03-2020,RKI,44,44,0,1584748800000,08111,Stuttgart,424,7,417,634830,3062
DE-BW,22-03-2020,RKI,14,13,1,1584835200000,08111,Stuttgart,438,8,430,634830,3062
DE-BW,23-03-2020,RKI,24,23,1,1584921600000,08111,Stuttgart,462,9,453,634830,3062
DE-BW,24-03-2020,RKI,35,32,3,1585008000000,08111,Stuttgart,497,12,485,634830,3062
DE-BW,25-03-2020,RKI,35,34,1,1585094400000,08111,Stuttgart,532,13,519,634830,3062
DE-BW,26-03-2020,RKI,63,56,7,1585180800000,08111,Stuttgart,595,20,575,634830,3062
DE-BW,27-03-2020,RKI,55,54,1,1585267200000,08111,Stuttgart,650,21,629,634830,3062
DE-BW,28-03-2020,RKI,36,35,1,1585353600000,08111,Stuttgart,686,22,664,634830,3062
DE-BW,29-03-2020,RKI,42,41,1,1585440000000,08111,Stuttgart,728,23,705,634830,3062
DE-BW,30-03-2020,RKI,23,20,3,1585526400000,08111,Stuttgart,751,26,725,634830,3062
DE-BW,31-03-2020,RKI,44,42,2,1585612800000,08111,Stuttgart,795,28,767,634830,3062
DE-BW,01-04-2020,RKI,37,36,1,1585699200000,08111,Stuttgart,832,29,803,634830,3062
DE-BW,02-04-2020,RKI,25,22,3,1585785600000,08111,Stuttgart,857,32,825,634830,3062
DE-BW,03-04-2020,RKI,25,24,1,1585872000000,08111,Stuttgart,882,33,849,634830,3062
DE-BW,04-04-2020,RKI,25,24,1,1585958400000,08111,Stuttgart,907,34,873,634830,3062
DE-BW,05-04-2020,RKI,11,11,0,1586044800000,08111,Stuttgart,918,34,884,634830,3062
DE-BW,06-04-2020,RKI,23,19,4,1586131200000,08111,Stuttgart,941,38,903,634830,3062
DE-BW,07-04-2020,RKI,34,32,2,1586217600000,08111,Stuttgart,975,40,935,634830,3062
DE-BW,08-04-2020,RKI,22,18,4,1586304000000,08111,Stuttgart,997,44,953,634830,3062
DE-BW,09-04-2020,RKI,26,26,0,1586390400000,08111,Stuttgart,1023,44,979,634830,3062
DE-BW,10-04-2020,RKI,5,5,0,1586476800000,08111,Stuttgart,1028,44,984,634830,3062
DE-BW,11-04-2020,RKI,17,15,2,1586563200000,08111,Stuttgart,1045,46,999,634830,3062
DE-BW,12-04-2020,RKI,44,40,4,1586649600000,08111,Stuttgart,1089,50,1039,634830,3062
DE-BW,13-04-2020,RKI,5,5,0,1586736000000,08111,Stuttgart,1094,50,1044,634830,3062
DE-BW,14-04-2020,RKI,19,18,1,1586822400000,08111,Stuttgart,1113,51,1062,634830,3062
DE-BW,15-04-2020,RKI,23,17,6,1586908800000,08111,Stuttgart,1136,57,1079,634830,3062
DE-BW,16-04-2020,RKI,15,15,0,1586995200000,08111,Stuttgart,1151,57,1094,634830,3062
DE-BW,17-04-2020,RKI,11,11,0,1587081600000,08111,Stuttgart,1162,57,1105,634830,3062
DE-BW,18-04-2020,RKI,12,12,0,1587168000000,08111,Stuttgart,1174,57,1117,634830,3062
DE-BW,19-04-2020,RKI,11,10,1,1587254400000,08111,Stuttgart,1185,58,1127,634830,3062
DE-BW,20-04-2020,RKI,10,9,1,1587340800000,08111,Stuttgart,1195,59,1136,634830,3062
DE-BW,21-04-2020,RKI,8,8,0,1587427200000,08111,Stuttgart,1203,59,1144,634830,3062
DE-BW,22-04-2020,RKI,7,7,0,1587513600000,08111,Stuttgart,1210,59,1151,634830,3062
DE-BW,23-04-2020,RKI,22,22,0,1587600000000,08111,Stuttgart,1232,59,1173,634830,3062
DE-BW,24-04-2020,RKI,6,6,0,1587686400000,08111,Stuttgart,1238,59,1179,634830,3062
DE-BW,25-04-2020,RKI,10,10,0,1587772800000,08111,Stuttgart,1248,59,1189,634830,3062
DE-BW,26-04-2020,RKI,2,2,0,1587859200000,08111,Stuttgart,1250,59,1191,634830,3062
DE-BW,27-04-2020,RKI,3,3,0,1587945600000,08111,Stuttgart,1253,59,1194,634830,3062
DE-BW,28-04-2020,RKI,2,2,0,1588032000000,08111,Stuttgart,1255,59,1196,634830,3062
DE-BW,29-04-2020,RKI,8,8,0,1588118400000,08111,Stuttgart,1263,59,1204,634830,3062
DE-BW,30-04-2020,RKI,9,9,0,1588204800000,08111,Stuttgart,1272,59,1213,634830,3062
DE-BW,02-05-2020,RKI,5,5,0,1588377600000,08111,Stuttgart,1277,59,1218,634830,3062
DE-BW,04-05-2020,RKI,0,0,0,1588550400000,08111,Stuttgart,1277,59,1218,634830,3062
DE-BW,05-05-2020,RKI,2,2,0,1588636800000,08111,Stuttgart,1279,59,1220,634830,3062
DE-BW,06-05-2020,RKI,8,8,0,1588723200000,08111,Stuttgart,1287,59,1228,634830,3062
DE-BW,07-05-2020,RKI,3,3,0,1588809600000,08111,Stuttgart,1290,59,1231,634830,3062
DE-BW,08-05-2020,RKI,11,11,0,1588896000000,08111,Stuttgart,1301,59,1242,634830,3062
DE-BW,09-05-2020,RKI,7,5,2,1588982400000,08111,Stuttgart,1308,61,1247,634830,3062
DE-BW,10-05-2020,RKI,0,0,0,1589068800000,08111,Stuttgart,1308,61,1247,634830,3062
DE-BW,11-05-2020,RKI,4,4,0,1589155200000,08111,Stuttgart,1312,61,1251,634830,3062
DE-BW,12-05-2020,RKI,12,11,1,1589241600000,08111,Stuttgart,1324,62,1262,634830,3062
DE-BW,13-05-2020,RKI,5,4,1,1589328000000,08111,Stuttgart,1329,63,1266,634830,3062
DE-BW,14-05-2020,RKI,7,7,0,1589414400000,08111,Stuttgart,1336,63,1273,634830,3062
DE-BW,15-05-2020,RKI,8,8,0,1589500800000,08111,Stuttgart,1344,63,1281,634830,3062
DE-BW,16-05-2020,RKI,1,1,0,1589587200000,08111,Stuttgart,1345,63,1282,634830,3062
DE-BW,17-05-2020,RKI,0,0,0,1589673600000,08111,Stuttgart,1345,63,1282,634830,3062
DE-BW,18-05-2020,RKI,3,3,0,1589760000000,08111,Stuttgart,1348,63,1285,634830,3062
DE-BW,19-05-2020,RKI,6,6,0,1589846400000,08111,Stuttgart,1354,63,1291,634830,3062
DE-BW,20-05-2020,RKI,11,11,0,1589932800000,08111,Stuttgart,1365,63,1302,634830,3062
DE-BW,22-05-2020,RKI,5,5,0,1590105600000,08111,Stuttgart,1370,63,1307,634830,3062
DE-BW,23-05-2020,RKI,0,0,0,1590192000000,08111,Stuttgart,1370,63,1307,634830,3062
DE-BW,24-05-2020,RKI,2,2,0,1590278400000,08111,Stuttgart,1372,63,1309,634830,3062
DE-BW,25-05-2020,RKI,0,0,0,1590364800000,08111,Stuttgart,1372,63,1309,634830,3062
DE-BW,26-05-2020,RKI,6,6,0,1590451200000,08111,Stuttgart,1378,63,1315,634830,3062
DE-BW,27-05-2020,RKI,4,4,0,1590537600000,08111,Stuttgart,1382,63,1319,634830,3062
DE-BW,28-05-2020,RKI,5,4,1,1590624000000,08111,Stuttgart,1387,64,1323,634830,3062
DE-BW,29-05-2020,RKI,0,0,0,1590710400000,08111,Stuttgart,1387,64,1323,634830,3062
DE-BW,31-05-2020,RKI,0,0,0,1590883200000,08111,Stuttgart,1387,64,1323,634830,3062
DE-BW,03-06-2020,RKI,0,0,0,1591142400000,08111,Stuttgart,1387,64,1323,634830,3062
DE-BW,04-06-2020,RKI,3,3,0,1591228800000,08111,Stuttgart,1390,64,1326,634830,3062
DE-BW,05-06-2020,RKI,0,0,0,1591315200000,08111,Stuttgart,1390,64,1326,634830,3062
DE-BW,06-06-2020,RKI,4,4,0,1591401600000,08111,Stuttgart,1394,64,1330,634830,3062
DE-BW,07-06-2020,RKI,4,4,0,1591488000000,08111,Stuttgart,1398,64,1334,634830,3062
DE-BW,08-06-2020,RKI,2,2,0,1591574400000,08111,Stuttgart,1400,64,1336,634830,3062
DE-BW,09-06-2020,RKI,0,0,0,1591660800000,08111,Stuttgart,1400,64,1336,634830,3062
DE-BW,10-06-2020,RKI,0,0,0,1591747200000,08111,Stuttgart,1400,64,1336,634830,3062
DE-BW,12-06-2020,RKI,1,1,0,1591920000000,08111,Stuttgart,1401,64,1337,634830,3062
DE-BW,14-06-2020,RKI,1,1,0,1592092800000,08111,Stuttgart,1402,64,1338,634830,3062
DE-BW,15-06-2020,RKI,1,1,0,1592179200000,08111,Stuttgart,1403,64,1339,634830,3062
DE-BW,16-06-2020,RKI,2,2,0,1592265600000,08111,Stuttgart,1405,64,1341,634830,3062
DE-BW,17-06-2020,RKI,3,3,0,1592352000000,08111,Stuttgart,1408,64,1344,634830,3062
DE-BW,18-06-2020,RKI,3,3,0,1592438400000,08111,Stuttgart,1411,64,1347,634830,3062
DE-BW,19-06-2020,RKI,6,6,0,1592524800000,08111,Stuttgart,1417,64,1353,634830,3062
DE-BW,20-06-2020,RKI,1,1,0,1592611200000,08111,Stuttgart,1418,64,1354,634830,3062
DE-BW,23-06-2020,RKI,1,0,0,1592870400000,08111,Stuttgart,1419,64,1354,634830,3062
DE-BW,25-06-2020,RKI,3,2,0,1593043200000,08111,Stuttgart,1422,64,1356,634830,3062
DE-BW,26-06-2020,RKI,3,2,0,1593129600000,08111,Stuttgart,1425,64,1358,634830,3062
DE-BW,27-06-2020,RKI,2,1,0,1593216000000,08111,Stuttgart,1427,64,1359,634830,3062
DE-BW,30-06-2020,RKI,0,0,0,1593475200000,08111,Stuttgart,1427,64,1359,634830,3062
DE-BW,01-07-2020,RKI,4,1,0,1593561600000,08111,Stuttgart,1431,64,1360,634830,3062
DE-BW,03-07-2020,RKI,2,2,0,1593734400000,08111,Stuttgart,1433,64,1362,634830,3062
DE-BW,06-07-2020,RKI,7,1,0,1593993600000,08111,Stuttgart,1440,64,1363,634830,3062
DE-BW,08-07-2020,RKI,2,0,0,1594166400000,08111,Stuttgart,1442,64,1363,634830,3062
DE-BW,09-07-2020,RKI,7,0,0,1594252800000,08111,Stuttgart,1449,64,1363,634830,3062
DE-BW,10-07-2020,RKI,4,0,0,1594339200000,08111,Stuttgart,1453,64,1363,634830,3062
DE-BW,12-07-2020,RKI,4,0,0,1594512000000,08111,Stuttgart,1457,64,1363,634830,3062
DE-BW,13-07-2020,RKI,11,0,0,1594598400000,08111,Stuttgart,1468,64,1363,634830,3062
DE-BW,14-07-2020,RKI,4,0,0,1594684800000,08111,Stuttgart,1472,64,1363,634830,3062
DE-BW,15-07-2020,RKI,6,0,0,1594771200000,08111,Stuttgart,1478,64,1363,634830,3062
DE-BW,16-07-2020,RKI,1,0,0,1594857600000,08111,Stuttgart,1479,64,1363,634830,3062
DE-BW,05-03-2020,RKI,1,1,0,1583366400000,08115,Böblingen,1,0,1,391640,634
DE-BW,09-03-2020,RKI,0,0,0,1583712000000,08115,Böblingen,1,0,1,391640,634
DE-BW,11-03-2020,RKI,1,1,0,1583884800000,08115,Böblingen,2,0,2,391640,634
DE-BW,12-03-2020,RKI,4,4,0,1583971200000,08115,Böblingen,6,0,6,391640,634
DE-BW,13-03-2020,RKI,11,11,0,1584057600000,08115,Böblingen,17,0,17,391640,634
DE-BW,14-03-2020,RKI,5,5,0,1584144000000,08115,Böblingen,22,0,22,391640,634
DE-BW,15-03-2020,RKI,12,10,2,1584230400000,08115,Böblingen,34,2,32,391640,634
DE-BW,16-03-2020,RKI,8,8,0,1584316800000,08115,Böblingen,42,2,40,391640,634
DE-BW,17-03-2020,RKI,22,20,2,1584403200000,08115,Böblingen,64,4,60,391640,634
DE-BW,18-03-2020,RKI,43,43,0,1584489600000,08115,Böblingen,107,4,103,391640,634
DE-BW,19-03-2020,RKI,35,34,1,1584576000000,08115,Böblingen,142,5,137,391640,634
DE-BW,20-03-2020,RKI,61,58,3,1584662400000,08115,Böblingen,203,8,195,391640,634
DE-BW,21-03-2020,RKI,38,37,1,1584748800000,08115,Böblingen,241,9,232,391640,634
DE-BW,22-03-2020,RKI,28,28,0,1584835200000,08115,Böblingen,269,9,260,391640,634
DE-BW,23-03-2020,RKI,52,48,4,1584921600000,08115,Böblingen,321,13,308,391640,634
DE-BW,24-03-2020,RKI,49,47,2,1585008000000,08115,Böblingen,370,15,355,391640,634
DE-BW,25-03-2020,RKI,34,34,0,1585094400000,08115,Böblingen,404,15,389,391640,634
DE-BW,26-03-2020,RKI,56,55,1,1585180800000,08115,Böblingen,460,16,444,391640,634
DE-BW,27-03-2020,RKI,61,60,1,1585267200000,08115,Böblingen,521,17,504,391640,634
DE-BW,28-03-2020,RKI,50,50,0,1585353600000,08115,Böblingen,571,17,554,391640,634
DE-BW,29-03-2020,RKI,43,43,0,1585440000000,08115,Böblingen,614,17,597,391640,634
DE-BW,30-03-2020,RKI,33,33,0,1585526400000,08115,Böblingen,647,17,630,391640,634
DE-BW,31-03-2020,RKI,52,51,1,1585612800000,08115,Böblingen,699,18,681,391640,634
DE-BW,01-04-2020,RKI,82,74,8,1585699200000,08115,Böblingen,781,26,755,391640,634
DE-BW,02-04-2020,RKI,54,49,5,1585785600000,08115,Böblingen,835,31,804,391640,634
DE-BW,03-04-2020,RKI,47,46,1,1585872000000,08115,Böblingen,882,32,850,391640,634
DE-BW,04-04-2020,RKI,39,38,1,1585958400000,08115,Böblingen,921,33,888,391640,634
DE-BW,05-04-2020,RKI,64,57,7,1586044800000,08115,Böblingen,985,40,945,391640,634
DE-BW,06-04-2020,RKI,28,26,2,1586131200000,08115,Böblingen,1013,42,971,391640,634
DE-BW,07-04-2020,RKI,36,36,0,1586217600000,08115,Böblingen,1049,42,1007,391640,634
DE-BW,08-04-2020,RKI,22,20,2,1586304000000,08115,Böblingen,1071,44,1027,391640,634
DE-BW,09-04-2020,RKI,59,57,1,1586390400000,08115,Böblingen,1130,45,1084,391640,634
DE-BW,10-04-2020,RKI,17,16,1,1586476800000,08115,Böblingen,1147,46,1100,391640,634
DE-BW,11-04-2020,RKI,33,33,0,1586563200000,08115,Böblingen,1180,46,1133,391640,634
DE-BW,12-04-2020,RKI,1,1,0,1586649600000,08115,Böblingen,1181,46,1134,391640,634
DE-BW,13-04-2020,RKI,18,18,0,1586736000000,08115,Böblingen,1199,46,1152,391640,634
DE-BW,14-04-2020,RKI,6,6,0,1586822400000,08115,Böblingen,1205,46,1158,391640,634
DE-BW,15-04-2020,RKI,15,15,0,1586908800000,08115,Böblingen,1220,46,1173,391640,634
DE-BW,16-04-2020,RKI,26,26,0,1586995200000,08115,Böblingen,1246,46,1199,391640,634
DE-BW,17-04-2020,RKI,5,5,0,1587081600000,08115,Böblingen,1251,46,1204,391640,634
DE-BW,18-04-2020,RKI,10,9,1,1587168000000,08115,Böblingen,1261,47,1213,391640,634
DE-BW,19-04-2020,RKI,9,9,0,1587254400000,08115,Böblingen,1270,47,1222,391640,634
DE-BW,20-04-2020,RKI,1,1,0,1587340800000,08115,Böblingen,1271,47,1223,391640,634
DE-BW,21-04-2020,RKI,11,11,0,1587427200000,08115,Böblingen,1282,47,1234,391640,634
DE-BW,22-04-2020,RKI,5,5,0,1587513600000,08115,Böblingen,1287,47,1239,391640,634
DE-BW,23-04-2020,RKI,4,4,0,1587600000000,08115,Böblingen,1291,47,1243,391640,634
DE-BW,24-04-2020,RKI,4,4,0,1587686400000,08115,Böblingen,1295,47,1247,391640,634
DE-BW,25-04-2020,RKI,1,1,0,1587772800000,08115,Böblingen,1296,47,1248,391640,634
DE-BW,26-04-2020,RKI,1,1,0,1587859200000,08115,Böblingen,1297,47,1249,391640,634
DE-BW,27-04-2020,RKI,0,0,0,1587945600000,08115,Böblingen,1297,47,1249,391640,634
DE-BW,28-04-2020,RKI,0,0,0,1588032000000,08115,Böblingen,1297,47,1249,391640,634
DE-BW,29-04-2020,RKI,3,3,0,1588118400000,08115,Böblingen,1300,47,1252,391640,634
DE-BW,30-04-2020,RKI,6,6,0,1588204800000,08115,Böblingen,1306,47,1258,391640,634
DE-BW,04-05-2020,RKI,0,0,0,1588550400000,08115,Böblingen,1306,47,1258,391640,634
DE-BW,06-05-2020,RKI,3,3,0,1588723200000,08115,Böblingen,1309,47,1261,391640,634
DE-BW,07-05-2020,RKI,0,0,0,1588809600000,08115,Böblingen,1309,47,1261,391640,634
DE-BW,08-05-2020,RKI,0,0,0,1588896000000,08115,Böblingen,1309,47,1261,391640,634
DE-BW,11-05-2020,RKI,0,0,0,1589155200000,08115,Böblingen,1309,47,1261,391640,634
DE-BW,12-05-2020,RKI,0,0,0,1589241600000,08115,Böblingen,1309,47,1261,391640,634
DE-BW,14-05-2020,RKI,6,6,0,1589414400000,08115,Böblingen,1315,47,1267,391640,634
DE-BW,15-05-2020,RKI,0,0,0,1589500800000,08115,Böblingen,1315,47,1267,391640,634
DE-BW,16-05-2020,RKI,0,0,0,1589587200000,08115,Böblingen,1315,47,1267,391640,634
DE-BW,20-05-2020,RKI,0,0,0,1589932800000,08115,Böblingen,1315,47,1267,391640,634
DE-BW,21-05-2020,RKI,1,1,0,1590019200000,08115,Böblingen,1316,47,1268,391640,634
DE-BW,23-05-2020,RKI,1,1,0,1590192000000,08115,Böblingen,1317,47,1269,391640,634
DE-BW,25-05-2020,RKI,0,0,0,1590364800000,08115,Böblingen,1317,47,1269,391640,634
DE-BW,26-05-2020,RKI,4,4,0,1590451200000,08115,Böblingen,1321,47,1273,391640,634
DE-BW,28-05-2020,RKI,0,0,0,1590624000000,08115,Böblingen,1321,47,1273,391640,634
DE-BW,30-05-2020,RKI,0,0,0,1590796800000,08115,Böblingen,1321,47,1273,391640,634
DE-BW,04-06-2020,RKI,1,1,0,1591228800000,08115,Böblingen,1322,47,1274,391640,634
DE-BW,05-06-2020,RKI,1,1,0,1591315200000,08115,Böblingen,1323,47,1275,391640,634
DE-BW,06-06-2020,RKI,4,4,0,1591401600000,08115,Böblingen,1327,47,1279,391640,634
DE-BW,10-06-2020,RKI,2,2,0,1591747200000,08115,Böblingen,1329,47,1281,391640,634
DE-BW,12-06-2020,RKI,0,0,0,1591920000000,08115,Böblingen,1329,47,1281,391640,634
DE-BW,16-06-2020,RKI,2,2,0,1592265600000,08115,Böblingen,1331,47,1283,391640,634
DE-BW,17-06-2020,RKI,1,1,0,1592352000000,08115,Böblingen,1332,47,1284,391640,634
DE-BW,18-06-2020,RKI,0,0,0,1592438400000,08115,Böblingen,1332,47,1284,391640,634
DE-BW,19-06-2020,RKI,2,2,0,1592524800000,08115,Böblingen,1334,47,1286,391640,634
DE-BW,22-06-2020,RKI,0,0,0,1592784000000,08115,Böblingen,1334,47,1286,391640,634
DE-BW,23-06-2020,RKI,3,3,0,1592870400000,08115,Böblingen,1337,47,1289,391640,634
DE-BW,24-06-2020,RKI,0,0,0,1592956800000,08115,Böblingen,1337,47,1289,391640,634
DE-BW,25-06-2020,RKI,3,3,0,1593043200000,08115,Böblingen,1340,47,1292,391640,634
DE-BW,26-06-2020,RKI,3,1,0,1593129600000,08115,Böblingen,1343,47,1293,391640,634
DE-BW,27-06-2020,RKI,0,0,0,1593216000000,08115,Böblingen,1343,47,1293,391640,634
DE-BW,30-06-2020,RKI,1,1,0,1593475200000,08115,Böblingen,1344,47,1294,391640,634
DE-BW,02-07-2020,RKI,0,0,0,1593648000000,08115,Böblingen,1344,47,1294,391640,634
DE-BW,03-07-2020,RKI,1,0,0,1593734400000,08115,Böblingen,1345,47,1294,391640,634
DE-BW,04-07-2020,RKI,0,0,0,1593820800000,08115,Böblingen,1345,47,1294,391640,634
DE-BW,06-07-2020,RKI,2,1,0,1593993600000,08115,Böblingen,1347,47,1295,391640,634
DE-BW,07-07-2020,RKI,1,0,0,1594080000000,08115,Böblingen,1348,47,1295,391640,634
DE-BW,08-07-2020,RKI,1,0,0,1594166400000,08115,Böblingen,1349,47,1295,391640,634
DE-BW,09-07-2020,RKI,2,0,0,1594252800000,08115,Böblingen,1351,47,1295,391640,634
DE-BW,10-07-2020,RKI,0,0,0,1594339200000,08115,Böblingen,1351,47,1295,391640,634
DE-BW,12-07-2020,RKI,0,0,0,1594512000000,08115,Böblingen,1351,47,1295,391640,634
DE-BW,14-07-2020,RKI,2,0,0,1594684800000,08115,Böblingen,1353,47,1295,391640,634
DE-BW,16-07-2020,RKI,2,0,0,1594857600000,08115,Böblingen,1355,47,1295,391640,634
DE-BW,04-03-2020,RKI,3,3,0,1583280000000,08116,Esslingen,8,0,8,533859,832
DE-BW,05-03-2020,RKI,4,4,0,1583366400000,08116,Esslingen,12,0,12,533859,832
DE-BW,06-03-2020,RKI,2,2,0,1583452800000,08116,Esslingen,14,0,14,533859,832
DE-BW,07-03-2020,RKI,1,1,0,1583539200000,08116,Esslingen,15,0,15,533859,832
DE-BW,08-03-2020,RKI,0,0,0,1583625600000,08116,Esslingen,15,0,15,533859,832
DE-BW,10-03-2020,RKI,15,15,0,1583798400000,08116,Esslingen,30,0,30,533859,832
DE-BW,11-03-2020,RKI,12,12,0,1583884800000,08116,Esslingen,42,0,42,533859,832
DE-BW,12-03-2020,RKI,15,12,3,1583971200000,08116,Esslingen,57,3,54,533859,832
DE-BW,13-03-2020,RKI,15,15,0,1584057600000,08116,Esslingen,72,3,69,533859,832
DE-BW,14-03-2020,RKI,37,34,3,1584144000000,08116,Esslingen,109,6,103,533859,832
DE-BW,15-03-2020,RKI,4,4,0,1584230400000,08116,Esslingen,113,6,107,533859,832
DE-BW,16-03-2020,RKI,76,75,1,1584316800000,08116,Esslingen,189,7,182,533859,832
DE-BW,17-03-2020,RKI,49,48,1,1584403200000,08116,Esslingen,238,8,230,533859,832
DE-BW,18-03-2020,RKI,49,48,1,1584489600000,08116,Esslingen,287,9,278,533859,832
DE-BW,19-03-2020,RKI,35,35,0,1584576000000,08116,Esslingen,322,9,313,533859,832
DE-BW,20-03-2020,RKI,76,75,1,1584662400000,08116,Esslingen,398,10,388,533859,832
DE-BW,21-03-2020,RKI,10,8,2,1584748800000,08116,Esslingen,408,12,396,533859,832
DE-BW,22-03-2020,RKI,49,44,5,1584835200000,08116,Esslingen,457,17,440,533859,832
DE-BW,23-03-2020,RKI,13,13,0,1584921600000,08116,Esslingen,470,17,453,533859,832
DE-BW,24-03-2020,RKI,68,67,1,1585008000000,08116,Esslingen,538,18,520,533859,832
DE-BW,25-03-2020,RKI,40,33,7,1585094400000,08116,Esslingen,578,25,553,533859,832
DE-BW,26-03-2020,RKI,61,57,4,1585180800000,08116,Esslingen,639,29,610,533859,832
DE-BW,27-03-2020,RKI,60,56,4,1585267200000,08116,Esslingen,699,33,666,533859,832
DE-BW,28-03-2020,RKI,38,34,4,1585353600000,08116,Esslingen,737,37,700,533859,832
DE-BW,29-03-2020,RKI,11,9,2,1585440000000,08116,Esslingen,748,39,709,533859,832
DE-BW,30-03-2020,RKI,67,64,3,1585526400000,08116,Esslingen,815,42,773,533859,832
DE-BW,31-03-2020,RKI,71,66,5,1585612800000,08116,Esslingen,886,47,839,533859,832
DE-BW,01-04-2020,RKI,55,51,4,1585699200000,08116,Esslingen,941,51,890,533859,832
DE-BW,02-04-2020,RKI,62,54,8,1585785600000,08116,Esslingen,1003,59,944,533859,832
DE-BW,03-04-2020,RKI,50,43,7,1585872000000,08116,Esslingen,1053,66,987,533859,832
DE-BW,04-04-2020,RKI,39,38,1,1585958400000,08116,Esslingen,1092,67,1025,533859,832
DE-BW,05-04-2020,RKI,9,9,0,1586044800000,08116,Esslingen,1101,67,1034,533859,832
DE-BW,06-04-2020,RKI,25,21,4,1586131200000,08116,Esslingen,1126,71,1055,533859,832
DE-BW,07-04-2020,RKI,55,53,2,1586217600000,08116,Esslingen,1181,73,1108,533859,832
DE-BW,08-04-2020,RKI,43,41,2,1586304000000,08116,Esslingen,1224,75,1149,533859,832
DE-BW,09-04-2020,RKI,49,45,4,1586390400000,08116,Esslingen,1273,79,1194,533859,832
DE-BW,10-04-2020,RKI,45,38,7,1586476800000,08116,Esslingen,1318,86,1232,533859,832
DE-BW,11-04-2020,RKI,18,18,0,1586563200000,08116,Esslingen,1336,86,1250,533859,832
DE-BW,12-04-2020,RKI,43,36,7,1586649600000,08116,Esslingen,1379,93,1286,533859,832
DE-BW,13-04-2020,RKI,13,11,2,1586736000000,08116,Esslingen,1392,95,1297,533859,832
DE-BW,14-04-2020,RKI,8,8,0,1586822400000,08116,Esslingen,1400,95,1305,533859,832
DE-BW,15-04-2020,RKI,27,26,1,1586908800000,08116,Esslingen,1427,96,1331,533859,832
DE-BW,16-04-2020,RKI,24,23,1,1586995200000,08116,Esslingen,1451,97,1354,533859,832
DE-BW,17-04-2020,RKI,20,19,1,1587081600000,08116,Esslingen,1471,98,1373,533859,832
DE-BW,18-04-2020,RKI,18,17,1,1587168000000,08116,Esslingen,1489,99,1390,533859,832
DE-BW,19-04-2020,RKI,1,0,1,1587254400000,08116,Esslingen,1490,100,1390,533859,832
DE-BW,20-04-2020,RKI,5,4,1,1587340800000,08116,Esslingen,1495,101,1394,533859,832
DE-BW,21-04-2020,RKI,45,45,0,1587427200000,08116,Esslingen,1540,101,1439,533859,832
DE-BW,22-04-2020,RKI,14,14,0,1587513600000,08116,Esslingen,1554,101,1453,533859,832
DE-BW,23-04-2020,RKI,16,14,2,1587600000000,08116,Esslingen,1570,103,1467,533859,832
DE-BW,24-04-2020,RKI,11,11,0,1587686400000,08116,Esslingen,1581,103,1478,533859,832
DE-BW,25-04-2020,RKI,9,9,0,1587772800000,08116,Esslingen,1590,103,1487,533859,832
DE-BW,26-04-2020,RKI,0,0,0,1587859200000,08116,Esslingen,1590,103,1487,533859,832
DE-BW,27-04-2020,RKI,2,2,0,1587945600000,08116,Esslingen,1592,103,1489,533859,832
DE-BW,28-04-2020,RKI,12,12,0,1588032000000,08116,Esslingen,1604,103,1501,533859,832
DE-BW,29-04-2020,RKI,8,7,1,1588118400000,08116,Esslingen,1612,104,1508,533859,832
DE-BW,30-04-2020,RKI,18,17,1,1588204800000,08116,Esslingen,1630,105,1525,533859,832
DE-BW,01-05-2020,RKI,0,0,0,1588291200000,08116,Esslingen,1630,105,1525,533859,832
DE-BW,02-05-2020,RKI,4,3,1,1588377600000,08116,Esslingen,1634,106,1528,533859,832
DE-BW,05-05-2020,RKI,8,7,1,1588636800000,08116,Esslingen,1642,107,1535,533859,832
DE-BW,06-05-2020,RKI,2,1,1,1588723200000,08116,Esslingen,1644,108,1536,533859,832
DE-BW,07-05-2020,RKI,2,2,0,1588809600000,08116,Esslingen,1646,108,1538,533859,832
DE-BW,08-05-2020,RKI,6,6,0,1588896000000,08116,Esslingen,1652,108,1544,533859,832
DE-BW,09-05-2020,RKI,10,9,1,1588982400000,08116,Esslingen,1662,109,1553,533859,832
DE-BW,10-05-2020,RKI,1,1,0,1589068800000,08116,Esslingen,1663,109,1554,533859,832
DE-BW,11-05-2020,RKI,3,3,0,1589155200000,08116,Esslingen,1666,109,1557,533859,832
DE-BW,12-05-2020,RKI,4,4,0,1589241600000,08116,Esslingen,1670,109,1561,533859,832
DE-BW,13-05-2020,RKI,6,6,0,1589328000000,08116,Esslingen,1676,109,1567,533859,832
DE-BW,14-05-2020,RKI,1,0,1,1589414400000,08116,Esslingen,1677,110,1567,533859,832
DE-BW,15-05-2020,RKI,17,14,3,1589500800000,08116,Esslingen,1694,113,1581,533859,832
DE-BW,16-05-2020,RKI,4,4,0,1589587200000,08116,Esslingen,1698,113,1585,533859,832
DE-BW,18-05-2020,RKI,2,1,1,1589760000000,08116,Esslingen,1700,114,1586,533859,832
DE-BW,19-05-2020,RKI,8,7,1,1589846400000,08116,Esslingen,1708,115,1593,533859,832
DE-BW,20-05-2020,RKI,6,5,1,1589932800000,08116,Esslingen,1714,116,1598,533859,832
DE-BW,21-05-2020,RKI,0,0,0,1590019200000,08116,Esslingen,1714,116,1598,533859,832
DE-BW,22-05-2020,RKI,1,1,0,1590105600000,08116,Esslingen,1715,116,1599,533859,832
DE-BW,23-05-2020,RKI,2,2,0,1590192000000,08116,Esslingen,1717,116,1601,533859,832
DE-BW,24-05-2020,RKI,0,0,0,1590278400000,08116,Esslingen,1717,116,1601,533859,832
DE-BW,26-05-2020,RKI,0,0,0,1590451200000,08116,Esslingen,1717,116,1601,533859,832
DE-BW,27-05-2020,RKI,2,2,0,1590537600000,08116,Esslingen,1719,116,1603,533859,832
DE-BW,28-05-2020,RKI,4,3,1,1590624000000,08116,Esslingen,1723,117,1606,533859,832
DE-BW,30-05-2020,RKI,2,2,0,1590796800000,08116,Esslingen,1725,117,1608,533859,832
DE-BW,02-06-2020,RKI,1,1,0,1591056000000,08116,Esslingen,1726,117,1609,533859,832
DE-BW,03-06-2020,RKI,2,1,1,1591142400000,08116,Esslingen,1728,118,1610,533859,832
DE-BW,04-06-2020,RKI,4,4,0,1591228800000,08116,Esslingen,1732,118,1614,533859,832
DE-BW,05-06-2020,RKI,8,8,0,1591315200000,08116,Esslingen,1740,118,1622,533859,832
DE-BW,06-06-2020,RKI,3,3,0,1591401600000,08116,Esslingen,1743,118,1625,533859,832
DE-BW,09-06-2020,RKI,1,1,0,1591660800000,08116,Esslingen,1744,118,1626,533859,832
DE-BW,10-06-2020,RKI,1,1,0,1591747200000,08116,Esslingen,1745,118,1627,533859,832
DE-BW,11-06-2020,RKI,0,0,0,1591833600000,08116,Esslingen,1745,118,1627,533859,832
DE-BW,12-06-2020,RKI,0,0,0,1591920000000,08116,Esslingen,1745,118,1627,533859,832
DE-BW,14-06-2020,RKI,0,0,0,1592092800000,08116,Esslingen,1745,118,1627,533859,832
DE-BW,15-06-2020,RKI,0,0,0,1592179200000,08116,Esslingen,1745,118,1627,533859,832
DE-BW,16-06-2020,RKI,1,1,0,1592265600000,08116,Esslingen,1746,118,1628,533859,832
DE-BW,17-06-2020,RKI,0,0,0,1592352000000,08116,Esslingen,1746,118,1628,533859,832
DE-BW,19-06-2020,RKI,0,0,0,1592524800000,08116,Esslingen,1746,118,1628,533859,832
DE-BW,20-06-2020,RKI,2,1,0,1592611200000,08116,Esslingen,1748,118,1629,533859,832
DE-BW,23-06-2020,RKI,3,2,0,1592870400000,08116,Esslingen,1751,118,1631,533859,832
DE-BW,24-06-2020,RKI,1,1,0,1592956800000,08116,Esslingen,1752,118,1632,533859,832
DE-BW,25-06-2020,RKI,0,0,0,1593043200000,08116,Esslingen,1752,118,1632,533859,832
DE-BW,26-06-2020,RKI,0,0,0,1593129600000,08116,Esslingen,1752,118,1632,533859,832
DE-BW,27-06-2020,RKI,2,2,0,1593216000000,08116,Esslingen,1754,118,1634,533859,832
DE-BW,30-06-2020,RKI,3,2,0,1593475200000,08116,Esslingen,1757,118,1636,533859,832
DE-BW,01-07-2020,RKI,2,2,0,1593561600000,08116,Esslingen,1759,118,1638,533859,832
DE-BW,02-07-2020,RKI,1,1,0,1593648000000,08116,Esslingen,1760,118,1639,533859,832
DE-BW,03-07-2020,RKI,2,0,0,1593734400000,08116,Esslingen,1762,118,1639,533859,832
DE-BW,04-07-2020,RKI,0,0,0,1593820800000,08116,Esslingen,1762,118,1639,533859,832
DE-BW,06-07-2020,RKI,2,1,0,1593993600000,08116,Esslingen,1764,118,1640,533859,832
DE-BW,07-07-2020,RKI,5,0,0,1594080000000,08116,Esslingen,1769,118,1640,533859,832
DE-BW,08-07-2020,RKI,2,0,0,1594166400000,08116,Esslingen,1771,118,1640,533859,832
DE-BW,10-07-2020,RKI,2,0,0,1594339200000,08116,Esslingen,1773,118,1640,533859,832
DE-BW,13-07-2020,RKI,3,0,0,1594598400000,08116,Esslingen,1776,118,1640,533859,832
DE-BW,15-07-2020,RKI,0,0,0,1594771200000,08116,Esslingen,1776,118,1640,533859,832
DE-BW,02-03-2020,RKI,0,0,0,1583107200000,08117,Göppingen,0,0,0,257253,400
DE-BW,04-03-2020,RKI,0,0,0,1583280000000,08117,Göppingen,0,0,0,257253,400
DE-BW,10-03-2020,RKI,4,4,0,1583798400000,08117,Göppingen,4,0,4,257253,400
DE-BW,11-03-2020,RKI,6,6,0,1583884800000,08117,Göppingen,10,0,10,257253,400
DE-BW,12-03-2020,RKI,16,15,1,1583971200000,08117,Göppingen,26,1,25,257253,400
DE-BW,13-03-2020,RKI,3,3,0,1584057600000,08117,Göppingen,29,1,28,257253,400
DE-BW,14-03-2020,RKI,7,7,0,1584144000000,08117,Göppingen,36,1,35,257253,400
DE-BW,15-03-2020,RKI,8,8,0,1584230400000,08117,Göppingen,44,1,43,257253,400
DE-BW,16-03-2020,RKI,2,2,0,1584316800000,08117,Göppingen,46,1,45,257253,400
DE-BW,17-03-2020,RKI,17,17,0,1584403200000,08117,Göppingen,63,1,62,257253,400
DE-BW,18-03-2020,RKI,24,24,0,1584489600000,08117,Göppingen,87,1,86,257253,400
DE-BW,19-03-2020,RKI,36,36,0,1584576000000,08117,Göppingen,123,1,122,257253,400
DE-BW,20-03-2020,RKI,32,30,2,1584662400000,08117,Göppingen,155,3,152,257253,400
DE-BW,21-03-2020,RKI,18,17,1,1584748800000,08117,Göppingen,173,4,169,257253,400
DE-BW,22-03-2020,RKI,4,4,0,1584835200000,08117,Göppingen,177,4,173,257253,400
DE-BW,23-03-2020,RKI,10,8,2,1584921600000,08117,Göppingen,187,6,181,257253,400
DE-BW,24-03-2020,RKI,28,24,4,1585008000000,08117,Göppingen,215,10,205,257253,400
DE-BW,25-03-2020,RKI,31,31,0,1585094400000,08117,Göppingen,246,10,236,257253,400
DE-BW,26-03-2020,RKI,28,26,2,1585180800000,08117,Göppingen,274,12,262,257253,400
DE-BW,27-03-2020,RKI,41,41,0,1585267200000,08117,Göppingen,315,12,303,257253,400
DE-BW,28-03-2020,RKI,28,28,0,1585353600000,08117,Göppingen,343,12,331,257253,400
DE-BW,29-03-2020,RKI,18,18,0,1585440000000,08117,Göppingen,361,12,349,257253,400
DE-BW,30-03-2020,RKI,10,9,1,1585526400000,08117,Göppingen,371,13,358,257253,400
DE-BW,31-03-2020,RKI,51,48,3,1585612800000,08117,Göppingen,422,16,406,257253,400
DE-BW,01-04-2020,RKI,27,25,2,1585699200000,08117,Göppingen,449,18,431,257253,400
DE-BW,02-04-2020,RKI,23,19,4,1585785600000,08117,Göppingen,472,22,450,257253,400
DE-BW,03-04-2020,RKI,22,21,1,1585872000000,08117,Göppingen,494,23,471,257253,400
DE-BW,04-04-2020,RKI,26,25,1,1585958400000,08117,Göppingen,520,24,496,257253,400
DE-BW,05-04-2020,RKI,2,2,0,1586044800000,08117,Göppingen,522,24,498,257253,400
DE-BW,06-04-2020,RKI,7,5,2,1586131200000,08117,Göppingen,529,26,503,257253,400
DE-BW,07-04-2020,RKI,28,28,0,1586217600000,08117,Göppingen,557,26,531,257253,400
DE-BW,08-04-2020,RKI,20,17,3,1586304000000,08117,Göppingen,577,29,548,257253,400
DE-BW,09-04-2020,RKI,28,26,2,1586390400000,08117,Göppingen,605,31,574,257253,400
DE-BW,10-04-2020,RKI,5,5,0,1586476800000,08117,Göppingen,610,31,579,257253,400
DE-BW,12-04-2020,RKI,19,17,2,1586649600000,08117,Göppingen,629,33,596,257253,400
DE-BW,13-04-2020,RKI,5,3,2,1586736000000,08117,Göppingen,634,35,599,257253,400
DE-BW,14-04-2020,RKI,4,4,0,1586822400000,08117,Göppingen,638,35,603,257253,400
DE-BW,15-04-2020,RKI,23,22,1,1586908800000,08117,Göppingen,661,36,625,257253,400
DE-BW,16-04-2020,RKI,4,4,0,1586995200000,08117,Göppingen,665,36,629,257253,400
DE-BW,17-04-2020,RKI,5,4,1,1587081600000,08117,Göppingen,670,37,633,257253,400
DE-BW,18-04-2020,RKI,3,3,0,1587168000000,08117,Göppingen,673,37,636,257253,400
DE-BW,19-04-2020,RKI,3,3,0,1587254400000,08117,Göppingen,676,37,639,257253,400
DE-BW,21-04-2020,RKI,1,1,0,1587427200000,08117,Göppingen,677,37,640,257253,400
DE-BW,22-04-2020,RKI,7,6,1,1587513600000,08117,Göppingen,684,38,646,257253,400
DE-BW,23-04-2020,RKI,2,2,0,1587600000000,08117,Göppingen,686,38,648,257253,400
DE-BW,24-04-2020,RKI,0,0,0,1587686400000,08117,Göppingen,686,38,648,257253,400
DE-BW,25-04-2020,RKI,2,2,0,1587772800000,08117,Göppingen,688,38,650,257253,400
DE-BW,26-04-2020,RKI,1,1,0,1587859200000,08117,Göppingen,689,38,651,257253,400
DE-BW,27-04-2020,RKI,0,0,0,1587945600000,08117,Göppingen,689,38,651,257253,400
DE-BW,28-04-2020,RKI,1,1,0,1588032000000,08117,Göppingen,690,38,652,257253,400
DE-BW,29-04-2020,RKI,1,1,0,1588118400000,08117,Göppingen,691,38,653,257253,400
DE-BW,30-04-2020,RKI,7,7,0,1588204800000,08117,Göppingen,698,38,660,257253,400
DE-BW,01-05-2020,RKI,3,3,0,1588291200000,08117,Göppingen,701,38,663,257253,400
DE-BW,02-05-2020,RKI,1,1,0,1588377600000,08117,Göppingen,702,38,664,257253,400
DE-BW,03-05-2020,RKI,0,0,0,1588464000000,08117,Göppingen,702,38,664,257253,400
DE-BW,05-05-2020,RKI,3,3,0,1588636800000,08117,Göppingen,705,38,667,257253,400
DE-BW,07-05-2020,RKI,0,0,0,1588809600000,08117,Göppingen,705,38,667,257253,400
DE-BW,08-05-2020,RKI,2,2,0,1588896000000,08117,Göppingen,707,38,669,257253,400
DE-BW,09-05-2020,RKI,0,0,0,1588982400000,08117,Göppingen,707,38,669,257253,400
DE-BW,14-05-2020,RKI,0,0,0,1589414400000,08117,Göppingen,707,38,669,257253,400
DE-BW,22-05-2020,RKI,2,2,0,1590105600000,08117,Göppingen,709,38,671,257253,400
DE-BW,23-05-2020,RKI,0,0,0,1590192000000,08117,Göppingen,709,38,671,257253,400
DE-BW,28-05-2020,RKI,2,2,0,1590624000000,08117,Göppingen,711,38,673,257253,400
DE-BW,06-06-2020,RKI,0,0,0,1591401600000,08117,Göppingen,711,38,673,257253,400
DE-BW,08-06-2020,RKI,0,0,0,1591574400000,08117,Göppingen,711,38,673,257253,400
DE-BW,09-06-2020,RKI,0,0,0,1591660800000,08117,Göppingen,711,38,673,257253,400
DE-BW,11-06-2020,RKI,0,0,0,1591833600000,08117,Göppingen,711,38,673,257253,400
DE-BW,12-06-2020,RKI,0,0,0,1591920000000,08117,Göppingen,711,38,673,257253,400
DE-BW,18-06-2020,RKI,1,1,0,1592438400000,08117,Göppingen,712,38,674,257253,400
DE-BW,20-06-2020,RKI,0,0,0,1592611200000,08117,Göppingen,712,38,674,257253,400
DE-BW,22-06-2020,RKI,1,1,0,1592784000000,08117,Göppingen,713,38,675,257253,400
DE-BW,23-06-2020,RKI,1,1,0,1592870400000,08117,Göppingen,714,38,676,257253,400
DE-BW,24-06-2020,RKI,5,1,0,1592956800000,08117,Göppingen,719,38,677,257253,400
DE-BW,25-06-2020,RKI,0,0,0,1593043200000,08117,Göppingen,719,38,677,257253,400
DE-BW,26-06-2020,RKI,5,5,0,1593129600000,08117,Göppingen,724,38,682,257253,400
DE-BW,28-06-2020,RKI,0,0,0,1593302400000,08117,Göppingen,724,38,682,257253,400
DE-BW,30-06-2020,RKI,2,0,0,1593475200000,08117,Göppingen,726,38,682,257253,400
DE-BW,02-07-2020,RKI,3,3,0,1593648000000,08117,Göppingen,729,38,685,257253,400
DE-BW,06-07-2020,RKI,0,0,0,1593993600000,08117,Göppingen,729,38,685,257253,400
DE-BW,09-07-2020,RKI,0,0,0,1594252800000,08117,Göppingen,729,38,685,257253,400
DE-BW,11-07-2020,RKI,0,0,0,1594425600000,08117,Göppingen,729,38,685,257253,400
DE-BW,14-07-2020,RKI,2,0,0,1594684800000,08117,Göppingen,731,38,685,257253,400
DE-BW,15-07-2020,RKI,0,0,0,1594771200000,08117,Göppingen,731,38,685,257253,400
DE-BW,04-03-2020,RKI,0,0,0,1583280000000,08118,Ludwigsburg,0,0,0,543984,792
DE-BW,05-03-2020,RKI,1,1,0,1583366400000,08118,Ludwigsburg,1,0,1,543984,792
DE-BW,07-03-2020,RKI,0,0,0,1583539200000,08118,Ludwigsburg,1,0,1,543984,792
DE-BW,09-03-2020,RKI,2,2,0,1583712000000,08118,Ludwigsburg,3,0,3,543984,792
DE-BW,10-03-2020,RKI,1,1,0,1583798400000,08118,Ludwigsburg,4,0,4,543984,792
DE-BW,11-03-2020,RKI,7,7,0,1583884800000,08118,Ludwigsburg,11,0,11,543984,792
DE-BW,12-03-2020,RKI,12,12,0,1583971200000,08118,Ludwigsburg,23,0,23,543984,792
DE-BW,13-03-2020,RKI,12,12,0,1584057600000,08118,Ludwigsburg,35,0,35,543984,792
DE-BW,14-03-2020,RKI,25,25,0,1584144000000,08118,Ludwigsburg,60,0,60,543984,792
DE-BW,15-03-2020,RKI,1,1,0,1584230400000,08118,Ludwigsburg,61,0,61,543984,792
DE-BW,16-03-2020,RKI,13,13,0,1584316800000,08118,Ludwigsburg,74,0,74,543984,792
DE-BW,17-03-2020,RKI,22,22,0,1584403200000,08118,Ludwigsburg,96,0,96,543984,792
DE-BW,18-03-2020,RKI,32,32,0,1584489600000,08118,Ludwigsburg,128,0,128,543984,792
DE-BW,19-03-2020,RKI,26,26,0,1584576000000,08118,Ludwigsburg,154,0,154,543984,792
DE-BW,20-03-2020,RKI,35,35,0,1584662400000,08118,Ludwigsburg,189,0,189,543984,792
DE-BW,21-03-2020,RKI,19,19,0,1584748800000,08118,Ludwigsburg,208,0,208,543984,792
DE-BW,22-03-2020,RKI,5,5,0,1584835200000,08118,Ludwigsburg,213,0,213,543984,792
DE-BW,23-03-2020,RKI,44,44,0,1584921600000,08118,Ludwigsburg,257,0,257,543984,792
DE-BW,24-03-2020,RKI,32,32,0,1585008000000,08118,Ludwigsburg,289,0,289,543984,792
DE-BW,25-03-2020,RKI,43,43,0,1585094400000,08118,Ludwigsburg,332,0,332,543984,792
DE-BW,26-03-2020,RKI,62,62,0,1585180800000,08118,Ludwigsburg,394,0,394,543984,792
DE-BW,27-03-2020,RKI,72,72,0,1585267200000,08118,Ludwigsburg,466,0,466,543984,792
DE-BW,28-03-2020,RKI,37,37,0,1585353600000,08118,Ludwigsburg,503,0,503,543984,792
DE-BW,29-03-2020,RKI,6,6,0,1585440000000,08118,Ludwigsburg,509,0,509,543984,792
DE-BW,30-03-2020,RKI,26,26,0,1585526400000,08118,Ludwigsburg,535,0,535,543984,792
DE-BW,31-03-2020,RKI,47,47,0,1585612800000,08118,Ludwigsburg,582,0,582,543984,792
DE-BW,01-04-2020,RKI,42,42,0,1585699200000,08118,Ludwigsburg,624,0,624,543984,792
DE-BW,02-04-2020,RKI,56,56,0,1585785600000,08118,Ludwigsburg,680,0,680,543984,792
DE-BW,03-04-2020,RKI,59,59,0,1585872000000,08118,Ludwigsburg,739,0,739,543984,792
DE-BW,04-04-2020,RKI,19,19,0,1585958400000,08118,Ludwigsburg,758,0,758,543984,792
DE-BW,05-04-2020,RKI,8,8,0,1586044800000,08118,Ludwigsburg,766,0,766,543984,792
DE-BW,06-04-2020,RKI,6,6,0,1586131200000,08118,Ludwigsburg,772,0,772,543984,792
DE-BW,07-04-2020,RKI,18,18,0,1586217600000,08118,Ludwigsburg,790,0,790,543984,792
DE-BW,08-04-2020,RKI,14,12,2,1586304000000,08118,Ludwigsburg,804,2,802,543984,792
DE-BW,09-04-2020,RKI,11,11,0,1586390400000,08118,Ludwigsburg,815,2,813,543984,792
DE-BW,10-04-2020,RKI,3,3,0,1586476800000,08118,Ludwigsburg,818,2,816,543984,792
DE-BW,11-04-2020,RKI,11,11,0,1586563200000,08118,Ludwigsburg,829,2,827,543984,792
DE-BW,12-04-2020,RKI,4,4,0,1586649600000,08118,Ludwigsburg,833,2,831,543984,792
DE-BW,13-04-2020,RKI,0,0,0,1586736000000,08118,Ludwigsburg,833,2,831,543984,792
DE-BW,14-04-2020,RKI,6,6,0,1586822400000,08118,Ludwigsburg,839,2,837,543984,792
DE-BW,15-04-2020,RKI,7,7,0,1586908800000,08118,Ludwigsburg,846,2,844,543984,792
DE-BW,16-04-2020,RKI,17,17,0,1586995200000,08118,Ludwigsburg,863,2,861,543984,792
DE-BW,17-04-2020,RKI,2,2,0,1587081600000,08118,Ludwigsburg,865,2,863,543984,792
DE-BW,18-04-2020,RKI,6,6,0,1587168000000,08118,Ludwigsburg,871,2,869,543984,792
DE-BW,19-04-2020,RKI,3,3,0,1587254400000,08118,Ludwigsburg,874,2,872,543984,792
DE-BW,20-04-2020,RKI,5,5,0,1587340800000,08118,Ludwigsburg,879,2,877,543984,792
DE-BW,21-04-2020,RKI,2,2,0,1587427200000,08118,Ludwigsburg,881,2,879,543984,792
DE-BW,22-04-2020,RKI,20,20,0,1587513600000,08118,Ludwigsburg,901,2,899,543984,792
DE-BW,23-04-2020,RKI,6,6,0,1587600000000,08118,Ludwigsburg,907,2,905,543984,792
DE-BW,24-04-2020,RKI,11,11,0,1587686400000,08118,Ludwigsburg,918,2,916,543984,792
DE-BW,25-04-2020,RKI,5,5,0,1587772800000,08118,Ludwigsburg,923,2,921,543984,792
DE-BW,27-04-2020,RKI,2,2,0,1587945600000,08118,Ludwigsburg,925,2,923,543984,792
DE-BW,28-04-2020,RKI,6,6,0,1588032000000,08118,Ludwigsburg,931,2,929,543984,792
DE-BW,29-04-2020,RKI,2,2,0,1588118400000,08118,Ludwigsburg,933,2,931,543984,792
DE-BW,30-04-2020,RKI,2,2,0,1588204800000,08118,Ludwigsburg,935,2,933,543984,792
DE-BW,01-05-2020,RKI,0,0,0,1588291200000,08118,Ludwigsburg,935,2,933,543984,792
DE-BW,02-05-2020,RKI,1,1,0,1588377600000,08118,Ludwigsburg,936,2,934,543984,792
DE-BW,05-05-2020,RKI,2,2,0,1588636800000,08118,Ludwigsburg,938,2,936,543984,792
DE-BW,06-05-2020,RKI,5,5,0,1588723200000,08118,Ludwigsburg,943,2,941,543984,792
DE-BW,07-05-2020,RKI,8,8,0,1588809600000,08118,Ludwigsburg,951,2,949,543984,792
DE-BW,08-05-2020,RKI,4,4,0,1588896000000,08118,Ludwigsburg,955,2,953,543984,792
DE-BW,09-05-2020,RKI,2,2,0,1588982400000,08118,Ludwigsburg,957,2,955,543984,792
DE-BW,11-05-2020,RKI,0,0,0,1589155200000,08118,Ludwigsburg,957,2,955,543984,792
DE-BW,12-05-2020,RKI,2,2,0,1589241600000,08118,Ludwigsburg,959,2,957,543984,792
DE-BW,13-05-2020,RKI,4,4,0,1589328000000,08118,Ludwigsburg,963,2,961,543984,792
DE-BW,14-05-2020,RKI,1,1,0,1589414400000,08118,Ludwigsburg,964,2,962,543984,792
DE-BW,15-05-2020,RKI,1,1,0,1589500800000,08118,Ludwigsburg,965,2,963,543984,792
DE-BW,16-05-2020,RKI,2,2,0,1589587200000,08118,Ludwigsburg,967,2,965,543984,792
DE-BW,18-05-2020,RKI,1,1,0,1589760000000,08118,Ludwigsburg,968,2,966,543984,792
DE-BW,20-05-2020,RKI,1,1,0,1589932800000,08118,Ludwigsburg,969,2,967,543984,792
DE-BW,23-05-2020,RKI,0,0,0,1590192000000,08118,Ludwigsburg,969,2,967,543984,792
DE-BW,25-05-2020,RKI,2,2,0,1590364800000,08118,Ludwigsburg,971,2,969,543984,792
DE-BW,27-05-2020,RKI,0,0,0,1590537600000,08118,Ludwigsburg,971,2,969,543984,792
DE-BW,28-05-2020,RKI,0,0,0,1590624000000,08118,Ludwigsburg,971,2,969,543984,792
DE-BW,29-05-2020,RKI,0,0,0,1590710400000,08118,Ludwigsburg,971,2,969,543984,792
DE-BW,30-05-2020,RKI,0,0,0,1590796800000,08118,Ludwigsburg,971,2,969,543984,792
DE-BW,02-06-2020,RKI,0,0,0,1591056000000,08118,Ludwigsburg,971,2,969,543984,792
DE-BW,04-06-2020,RKI,2,2,0,1591228800000,08118,Ludwigsburg,973,2,971,543984,792
DE-BW,06-06-2020,RKI,0,0,0,1591401600000,08118,Ludwigsburg,973,2,971,543984,792
DE-BW,09-06-2020,RKI,0,0,0,1591660800000,08118,Ludwigsburg,973,2,971,543984,792
DE-BW,10-06-2020,RKI,3,3,0,1591747200000,08118,Ludwigsburg,976,2,974,543984,792
DE-BW,12-06-2020,RKI,0,0,0,1591920000000,08118,Ludwigsburg,976,2,974,543984,792
DE-BW,16-06-2020,RKI,0,0,0,1592265600000,08118,Ludwigsburg,976,2,974,543984,792
DE-BW,17-06-2020,RKI,1,1,0,1592352000000,08118,Ludwigsburg,977,2,975,543984,792
DE-BW,18-06-2020,RKI,0,0,0,1592438400000,08118,Ludwigsburg,977,2,975,543984,792
DE-BW,20-06-2020,RKI,0,0,0,1592611200000,08118,Ludwigsburg,977,2,975,543984,792
DE-BW,22-06-2020,RKI,0,0,0,1592784000000,08118,Ludwigsburg,977,2,975,543984,792
DE-BW,24-06-2020,RKI,0,0,0,1592956800000,08118,Ludwigsburg,977,2,975,543984,792
DE-BW,26-06-2020,RKI,0,0,0,1593129600000,08118,Ludwigsburg,977,2,975,543984,792
DE-BW,30-06-2020,RKI,2,2,0,1593475200000,08118,Ludwigsburg,979,2,977,543984,792
DE-BW,01-07-2020,RKI,2,0,0,1593561600000,08118,Ludwigsburg,981,2,977,543984,792
DE-BW,02-07-2020,RKI,1,1,0,1593648000000,08118,Ludwigsburg,982,2,978,543984,792
DE-BW,03-07-2020,RKI,5,2,0,1593734400000,08118,Ludwigsburg,987,2,980,543984,792
DE-BW,04-07-2020,RKI,0,0,0,1593820800000,08118,Ludwigsburg,987,2,980,543984,792
DE-BW,05-07-2020,RKI,0,0,0,1593907200000,08118,Ludwigsburg,987,2,980,543984,792
DE-BW,06-07-2020,RKI,0,0,0,1593993600000,08118,Ludwigsburg,987,2,980,543984,792
DE-BW,07-07-2020,RKI,0,0,0,1594080000000,08118,Ludwigsburg,987,2,980,543984,792
DE-BW,10-07-2020,RKI,3,0,0,1594339200000,08118,Ludwigsburg,990,2,980,543984,792
DE-BW,11-07-2020,RKI,0,0,0,1594425600000,08118,Ludwigsburg,990,2,980,543984,792
DE-BW,14-07-2020,RKI,0,0,0,1594684800000,08118,Ludwigsburg,990,2,980,543984,792
DE-BY,17-03-2020,RKI,0,0,0,1584403200000,09161,Ingolstadt,0,0,0,136981,1027
DE-BY,18-03-2020,RKI,3,3,0,1584489600000,09161,Ingolstadt,3,0,3,136981,1027
DE-BY,19-03-2020,RKI,0,0,0,1584576000000,09161,Ingolstadt,3,0,3,136981,1027
DE-BY,20-03-2020,RKI,0,0,0,1584662400000,09161,Ingolstadt,3,0,3,136981,1027
DE-BY,23-03-2020,RKI,7,5,2,1584921600000,09161,Ingolstadt,10,2,8,136981,1027
DE-BY,24-03-2020,RKI,1,1,0,1585008000000,09161,Ingolstadt,11,2,9,136981,1027
DE-BY,25-03-2020,RKI,12,12,0,1585094400000,09161,Ingolstadt,23,2,21,136981,1027
DE-BY,26-03-2020,RKI,3,3,0,1585180800000,09161,Ingolstadt,26,2,24,136981,1027
DE-BY,27-03-2020,RKI,23,22,1,1585267200000,09161,Ingolstadt,49,3,46,136981,1027
DE-BY,28-03-2020,RKI,16,16,0,1585353600000,09161,Ingolstadt,65,3,62,136981,1027
DE-BY,29-03-2020,RKI,0,0,0,1585440000000,09161,Ingolstadt,65,3,62,136981,1027
DE-BY,30-03-2020,RKI,0,0,0,1585526400000,09161,Ingolstadt,65,3,62,136981,1027
DE-BY,31-03-2020,RKI,13,12,1,1585612800000,09161,Ingolstadt,78,4,74,136981,1027
DE-BY,01-04-2020,RKI,16,15,1,1585699200000,09161,Ingolstadt,94,5,89,136981,1027
DE-BY,02-04-2020,RKI,26,26,0,1585785600000,09161,Ingolstadt,120,5,115,136981,1027
DE-BY,03-04-2020,RKI,32,30,2,1585872000000,09161,Ingolstadt,152,7,145,136981,1027
DE-BY,04-04-2020,RKI,14,12,2,1585958400000,09161,Ingolstadt,166,9,157,136981,1027
DE-BY,05-04-2020,RKI,6,4,2,1586044800000,09161,Ingolstadt,172,11,161,136981,1027
DE-BY,06-04-2020,RKI,19,18,1,1586131200000,09161,Ingolstadt,191,12,179,136981,1027
DE-BY,07-04-2020,RKI,40,37,3,1586217600000,09161,Ingolstadt,231,15,216,136981,1027
DE-BY,08-04-2020,RKI,15,15,0,1586304000000,09161,Ingolstadt,246,15,231,136981,1027
DE-BY,09-04-2020,RKI,3,2,1,1586390400000,09161,Ingolstadt,249,16,233,136981,1027
DE-BY,11-04-2020,RKI,26,22,4,1586563200000,09161,Ingolstadt,275,20,255,136981,1027
DE-BY,13-04-2020,RKI,21,16,5,1586736000000,09161,Ingolstadt,296,25,271,136981,1027
DE-BY,14-04-2020,RKI,5,4,1,1586822400000,09161,Ingolstadt,301,26,275,136981,1027
DE-BY,15-04-2020,RKI,1,1,0,1586908800000,09161,Ingolstadt,302,26,276,136981,1027
DE-BY,16-04-2020,RKI,17,15,2,1586995200000,09161,Ingolstadt,319,28,291,136981,1027
DE-BY,17-04-2020,RKI,10,8,2,1587081600000,09161,Ingolstadt,329,30,299,136981,1027
DE-BY,18-04-2020,RKI,0,0,0,1587168000000,09161,Ingolstadt,329,30,299,136981,1027
DE-BY,20-04-2020,RKI,12,10,2,1587340800000,09161,Ingolstadt,341,32,309,136981,1027
DE-BY,21-04-2020,RKI,3,2,1,1587427200000,09161,Ingolstadt,344,33,311,136981,1027
DE-BY,22-04-2020,RKI,1,1,0,1587513600000,09161,Ingolstadt,345,33,312,136981,1027
DE-BY,23-04-2020,RKI,14,14,0,1587600000000,09161,Ingolstadt,359,33,326,136981,1027
DE-BY,24-04-2020,RKI,3,2,1,1587686400000,09161,Ingolstadt,362,34,328,136981,1027
DE-BY,25-04-2020,RKI,3,3,0,1587772800000,09161,Ingolstadt,365,34,331,136981,1027
DE-BY,26-04-2020,RKI,1,1,0,1587859200000,09161,Ingolstadt,366,34,332,136981,1027
DE-BY,27-04-2020,RKI,1,1,0,1587945600000,09161,Ingolstadt,367,34,333,136981,1027
DE-BY,28-04-2020,RKI,2,2,0,1588032000000,09161,Ingolstadt,369,34,335,136981,1027
DE-BY,29-04-2020,RKI,0,0,0,1588118400000,09161,Ingolstadt,369,34,335,136981,1027
DE-BY,30-04-2020,RKI,0,0,0,1588204800000,09161,Ingolstadt,369,34,335,136981,1027
DE-BY,02-05-2020,RKI,1,1,0,1588377600000,09161,Ingolstadt,370,34,336,136981,1027
DE-BY,04-05-2020,RKI,1,1,0,1588550400000,09161,Ingolstadt,371,34,337,136981,1027
DE-BY,05-05-2020,RKI,1,1,0,1588636800000,09161,Ingolstadt,372,34,338,136981,1027
DE-BY,07-05-2020,RKI,2,1,1,1588809600000,09161,Ingolstadt,374,35,339,136981,1027
DE-BY,08-05-2020,RKI,1,1,0,1588896000000,09161,Ingolstadt,375,35,340,136981,1027
DE-BY,09-05-2020,RKI,1,1,0,1588982400000,09161,Ingolstadt,376,35,341,136981,1027
DE-BY,10-05-2020,RKI,1,1,0,1589068800000,09161,Ingolstadt,377,35,342,136981,1027
DE-BY,11-05-2020,RKI,0,0,0,1589155200000,09161,Ingolstadt,377,35,342,136981,1027
DE-BY,12-05-2020,RKI,3,3,0,1589241600000,09161,Ingolstadt,380,35,345,136981,1027
DE-BY,13-05-2020,RKI,3,3,0,1589328000000,09161,Ingolstadt,383,35,348,136981,1027
DE-BY,14-05-2020,RKI,0,0,0,1589414400000,09161,Ingolstadt,383,35,348,136981,1027
DE-BY,16-05-2020,RKI,3,3,0,1589587200000,09161,Ingolstadt,386,35,351,136981,1027
DE-BY,17-05-2020,RKI,1,0,1,1589673600000,09161,Ingolstadt,387,36,351,136981,1027
DE-BY,19-05-2020,RKI,0,0,0,1589846400000,09161,Ingolstadt,387,36,351,136981,1027
DE-BY,20-05-2020,RKI,1,1,0,1589932800000,09161,Ingolstadt,388,36,352,136981,1027
DE-BY,21-05-2020,RKI,5,5,0,1590019200000,09161,Ingolstadt,393,36,357,136981,1027
DE-BY,22-05-2020,RKI,0,0,0,1590105600000,09161,Ingolstadt,393,36,357,136981,1027
DE-BY,23-05-2020,RKI,3,3,0,1590192000000,09161,Ingolstadt,396,36,360,136981,1027
DE-BY,26-05-2020,RKI,0,0,0,1590451200000,09161,Ingolstadt,396,36,360,136981,1027
DE-BY,27-05-2020,RKI,1,1,0,1590537600000,09161,Ingolstadt,397,36,361,136981,1027
DE-BY,28-05-2020,RKI,1,1,0,1590624000000,09161,Ingolstadt,398,36,362,136981,1027
DE-BY,29-05-2020,RKI,3,3,0,1590710400000,09161,Ingolstadt,401,36,365,136981,1027
DE-BY,01-06-2020,RKI,0,0,0,1590969600000,09161,Ingolstadt,401,36,365,136981,1027
DE-BY,02-06-2020,RKI,0,0,0,1591056000000,09161,Ingolstadt,401,36,365,136981,1027
DE-BY,03-06-2020,RKI,0,0,0,1591142400000,09161,Ingolstadt,401,36,365,136981,1027
DE-BY,06-06-2020,RKI,1,0,1,1591401600000,09161,Ingolstadt,402,37,365,136981,1027
DE-BY,08-06-2020,RKI,0,0,0,1591574400000,09161,Ingolstadt,402,37,365,136981,1027
DE-BY,12-06-2020,RKI,0,0,0,1591920000000,09161,Ingolstadt,402,37,365,136981,1027
DE-BY,16-06-2020,RKI,0,0,0,1592265600000,09161,Ingolstadt,402,37,365,136981,1027
DE-BY,18-06-2020,RKI,1,1,0,1592438400000,09161,Ingolstadt,403,37,366,136981,1027
DE-BY,19-06-2020,RKI,0,0,0,1592524800000,09161,Ingolstadt,403,37,366,136981,1027
DE-BY,21-06-2020,RKI,2,0,1,1592697600000,09161,Ingolstadt,405,38,366,136981,1027
DE-BY,23-06-2020,RKI,1,1,0,1592870400000,09161,Ingolstadt,406,38,367,136981,1027
DE-BY,25-06-2020,RKI,0,0,0,1593043200000,09161,Ingolstadt,406,38,367,136981,1027
DE-BY,26-06-2020,RKI,3,3,0,1593129600000,09161,Ingolstadt,409,38,370,136981,1027
DE-BY,28-06-2020,RKI,0,0,0,1593302400000,09161,Ingolstadt,409,38,370,136981,1027
DE-BY,30-06-2020,RKI,0,0,0,1593475200000,09161,Ingolstadt,409,38,370,136981,1027
DE-BY,01-07-2020,RKI,0,0,0,1593561600000,09161,Ingolstadt,409,38,370,136981,1027
DE-BY,03-07-2020,RKI,0,0,0,1593734400000,09161,Ingolstadt,409,38,370,136981,1027
DE-BY,07-07-2020,RKI,0,0,0,1594080000000,09161,Ingolstadt,409,38,370,136981,1027
DE-BY,13-07-2020,RKI,0,0,0,1594598400000,09161,Ingolstadt,409,38,370,136981,1027
DE-BY,14-07-2020,RKI,0,0,0,1594684800000,09161,Ingolstadt,409,38,370,136981,1027
DE-BY,16-07-2020,RKI,1,0,0,1594857600000,09161,Ingolstadt,410,38,370,136981,1027
DE-BY,03-02-2020,RKI,0,0,0,1580688000000,09162,München,0,0,0,1471508,4736
DE-BY,11-02-2020,RKI,0,0,0,1581379200000,09162,München,0,0,0,1471508,4736
DE-BY,28-02-2020,RKI,1,1,0,1582848000000,09162,München,1,0,1,1471508,4736
DE-BY,02-03-2020,RKI,2,2,0,1583107200000,09162,München,3,0,3,1471508,4736
DE-BY,03-03-2020,RKI,0,0,0,1583193600000,09162,München,3,0,3,1471508,4736
DE-BY,04-03-2020,RKI,2,2,0,1583280000000,09162,München,5,0,5,1471508,4736
DE-BY,05-03-2020,RKI,1,1,0,1583366400000,09162,München,6,0,6,1471508,4736
DE-BY,06-03-2020,RKI,11,11,0,1583452800000,09162,München,17,0,17,1471508,4736
DE-BY,09-03-2020,RKI,22,22,0,1583712000000,09162,München,39,0,39,1471508,4736
DE-BY,10-03-2020,RKI,30,30,0,1583798400000,09162,München,69,0,69,1471508,4736
DE-BY,11-03-2020,RKI,21,21,0,1583884800000,09162,München,90,0,90,1471508,4736
DE-BY,12-03-2020,RKI,17,16,1,1583971200000,09162,München,107,1,106,1471508,4736
DE-BY,13-03-2020,RKI,46,46,0,1584057600000,09162,München,153,1,152,1471508,4736
DE-BY,14-03-2020,RKI,62,62,0,1584144000000,09162,München,215,1,214,1471508,4736
DE-BY,15-03-2020,RKI,17,17,0,1584230400000,09162,München,232,1,231,1471508,4736
DE-BY,16-03-2020,RKI,66,65,1,1584316800000,09162,München,298,2,296,1471508,4736
DE-BY,17-03-2020,RKI,143,142,1,1584403200000,09162,München,441,3,438,1471508,4736
DE-BY,18-03-2020,RKI,211,208,3,1584489600000,09162,München,652,6,646,1471508,4736
DE-BY,19-03-2020,RKI,171,171,0,1584576000000,09162,München,823,6,817,1471508,4736
DE-BY,20-03-2020,RKI,194,193,1,1584662400000,09162,München,1017,7,1010,1471508,4736
DE-BY,21-03-2020,RKI,175,172,3,1584748800000,09162,München,1192,10,1182,1471508,4736
DE-BY,22-03-2020,RKI,87,84,3,1584835200000,09162,München,1279,13,1266,1471508,4736
DE-BY,23-03-2020,RKI,93,89,4,1584921600000,09162,München,1372,17,1355,1471508,4736
DE-BY,24-03-2020,RKI,168,161,7,1585008000000,09162,München,1540,24,1516,1471508,4736
DE-BY,25-03-2020,RKI,239,234,5,1585094400000,09162,München,1779,29,1750,1471508,4736
DE-BY,26-03-2020,RKI,256,250,6,1585180800000,09162,München,2035,35,2000,1471508,4736
DE-BY,27-03-2020,RKI,257,254,3,1585267200000,09162,München,2292,38,2254,1471508,4736
DE-BY,28-03-2020,RKI,139,134,5,1585353600000,09162,München,2431,43,2388,1471508,4736
DE-BY,29-03-2020,RKI,177,173,4,1585440000000,09162,München,2608,47,2561,1471508,4736
DE-BY,30-03-2020,RKI,113,110,3,1585526400000,09162,München,2721,50,2671,1471508,4736
DE-BY,31-03-2020,RKI,308,293,15,1585612800000,09162,München,3029,65,2964,1471508,4736
DE-BY,01-04-2020,RKI,229,219,10,1585699200000,09162,München,3258,75,3183,1471508,4736
DE-BY,02-04-2020,RKI,142,136,6,1585785600000,09162,München,3400,81,3319,1471508,4736
DE-BY,03-04-2020,RKI,174,163,11,1585872000000,09162,München,3574,92,3482,1471508,4736
DE-BY,04-04-2020,RKI,133,129,4,1585958400000,09162,München,3707,96,3611,1471508,4736
DE-BY,05-04-2020,RKI,83,78,5,1586044800000,09162,München,3790,101,3689,1471508,4736
DE-BY,06-04-2020,RKI,117,116,1,1586131200000,09162,München,3907,102,3805,1471508,4736
DE-BY,07-04-2020,RKI,140,133,7,1586217600000,09162,München,4047,109,3938,1471508,4736
DE-BY,08-04-2020,RKI,151,141,10,1586304000000,09162,München,4198,119,4079,1471508,4736
DE-BY,09-04-2020,RKI,111,105,6,1586390400000,09162,München,4309,125,4184,1471508,4736
DE-BY,10-04-2020,RKI,97,93,4,1586476800000,09162,München,4406,129,4277,1471508,4736
DE-BY,11-04-2020,RKI,102,99,3,1586563200000,09162,München,4508,132,4376,1471508,4736
DE-BY,12-04-2020,RKI,71,67,4,1586649600000,09162,München,4579,136,4443,1471508,4736
DE-BY,13-04-2020,RKI,60,58,2,1586736000000,09162,München,4639,138,4501,1471508,4736
DE-BY,14-04-2020,RKI,87,82,5,1586822400000,09162,München,4726,143,4583,1471508,4736
DE-BY,15-04-2020,RKI,107,103,4,1586908800000,09162,München,4833,147,4686,1471508,4736
DE-BY,16-04-2020,RKI,93,84,9,1586995200000,09162,München,4926,156,4770,1471508,4736
DE-BY,17-04-2020,RKI,91,87,4,1587081600000,09162,München,5017,160,4857,1471508,4736
DE-BY,18-04-2020,RKI,45,43,2,1587168000000,09162,München,5062,162,4900,1471508,4736
DE-BY,19-04-2020,RKI,48,42,6,1587254400000,09162,München,5110,168,4942,1471508,4736
DE-BY,20-04-2020,RKI,30,30,0,1587340800000,09162,München,5140,168,4972,1471508,4736
DE-BY,21-04-2020,RKI,54,52,2,1587427200000,09162,München,5194,170,5024,1471508,4736
DE-BY,22-04-2020,RKI,57,54,3,1587513600000,09162,München,5251,173,5078,1471508,4736
DE-BY,23-04-2020,RKI,76,69,7,1587600000000,09162,München,5327,180,5147,1471508,4736
DE-BY,24-04-2020,RKI,55,53,2,1587686400000,09162,München,5382,182,5200,1471508,4736
DE-BY,25-04-2020,RKI,46,43,3,1587772800000,09162,München,5428,185,5243,1471508,4736
DE-BY,26-04-2020,RKI,32,31,1,1587859200000,09162,München,5460,186,5274,1471508,4736
DE-BY,27-04-2020,RKI,79,77,2,1587945600000,09162,München,5539,188,5351,1471508,4736
DE-BY,28-04-2020,RKI,49,48,1,1588032000000,09162,München,5588,189,5399,1471508,4736
DE-BY,29-04-2020,RKI,38,37,1,1588118400000,09162,München,5626,190,5436,1471508,4736
DE-BY,30-04-2020,RKI,43,42,1,1588204800000,09162,München,5669,191,5478,1471508,4736
DE-BY,01-05-2020,RKI,58,52,6,1588291200000,09162,München,5727,197,5530,1471508,4736
DE-BY,02-05-2020,RKI,31,29,2,1588377600000,09162,München,5758,199,5559,1471508,4736
DE-BY,03-05-2020,RKI,24,24,0,1588464000000,09162,München,5782,199,5583,1471508,4736
DE-BY,04-05-2020,RKI,33,32,1,1588550400000,09162,München,5815,200,5615,1471508,4736
DE-BY,05-05-2020,RKI,29,27,2,1588636800000,09162,München,5844,202,5642,1471508,4736
DE-BY,06-05-2020,RKI,18,17,1,1588723200000,09162,München,5862,203,5659,1471508,4736
DE-BY,07-05-2020,RKI,29,27,2,1588809600000,09162,München,5891,205,5686,1471508,4736
DE-BY,08-05-2020,RKI,44,42,2,1588896000000,09162,München,5935,207,5728,1471508,4736
DE-BY,09-05-2020,RKI,23,22,1,1588982400000,09162,München,5958,208,5750,1471508,4736
DE-BY,10-05-2020,RKI,21,20,1,1589068800000,09162,München,5979,209,5770,1471508,4736
DE-BY,11-05-2020,RKI,60,60,0,1589155200000,09162,München,6039,209,5830,1471508,4736
DE-BY,12-05-2020,RKI,26,26,0,1589241600000,09162,München,6065,209,5856,1471508,4736
DE-BY,13-05-2020,RKI,34,34,0,1589328000000,09162,München,6099,209,5890,1471508,4736
DE-BY,14-05-2020,RKI,22,21,1,1589414400000,09162,München,6121,210,5911,1471508,4736
DE-BY,15-05-2020,RKI,17,17,0,1589500800000,09162,München,6138,210,5928,1471508,4736
DE-BY,16-05-2020,RKI,8,8,0,1589587200000,09162,München,6146,210,5936,1471508,4736
DE-BY,17-05-2020,RKI,10,9,1,1589673600000,09162,München,6156,211,5945,1471508,4736
DE-BY,18-05-2020,RKI,6,5,1,1589760000000,09162,München,6162,212,5950,1471508,4736
DE-BY,19-05-2020,RKI,10,10,0,1589846400000,09162,München,6172,212,5960,1471508,4736
DE-BY,20-05-2020,RKI,19,19,0,1589932800000,09162,München,6191,212,5979,1471508,4736
DE-BY,21-05-2020,RKI,18,17,1,1590019200000,09162,München,6209,213,5996,1471508,4736
DE-BY,22-05-2020,RKI,18,18,0,1590105600000,09162,München,6227,213,6014,1471508,4736
DE-BY,23-05-2020,RKI,1,0,1,1590192000000,09162,München,6228,214,6014,1471508,4736
DE-BY,24-05-2020,RKI,5,5,0,1590278400000,09162,München,6233,214,6019,1471508,4736
DE-BY,25-05-2020,RKI,12,11,1,1590364800000,09162,München,6245,215,6030,1471508,4736
DE-BY,26-05-2020,RKI,45,44,1,1590451200000,09162,München,6290,216,6074,1471508,4736
DE-BY,27-05-2020,RKI,33,33,0,1590537600000,09162,München,6323,216,6107,1471508,4736
DE-BY,28-05-2020,RKI,5,5,0,1590624000000,09162,München,6328,216,6112,1471508,4736
DE-BY,29-05-2020,RKI,11,11,0,1590710400000,09162,München,6339,216,6123,1471508,4736
DE-BY,30-05-2020,RKI,32,32,0,1590796800000,09162,München,6371,216,6155,1471508,4736
DE-BY,31-05-2020,RKI,4,4,0,1590883200000,09162,München,6375,216,6159,1471508,4736
DE-BY,02-06-2020,RKI,4,3,1,1591056000000,09162,München,6379,217,6162,1471508,4736
DE-BY,03-06-2020,RKI,11,11,0,1591142400000,09162,München,6390,217,6173,1471508,4736
DE-BY,04-06-2020,RKI,7,7,0,1591228800000,09162,München,6397,217,6180,1471508,4736
DE-BY,05-06-2020,RKI,13,13,0,1591315200000,09162,München,6410,217,6193,1471508,4736
DE-BY,06-06-2020,RKI,3,3,0,1591401600000,09162,München,6413,217,6196,1471508,4736
DE-BY,07-06-2020,RKI,8,7,0,1591488000000,09162,München,6421,217,6203,1471508,4736
DE-BY,08-06-2020,RKI,9,9,0,1591574400000,09162,München,6430,217,6212,1471508,4736
DE-BY,09-06-2020,RKI,7,7,0,1591660800000,09162,München,6437,217,6219,1471508,4736
DE-BY,10-06-2020,RKI,8,7,1,1591747200000,09162,München,6445,218,6226,1471508,4736
DE-BY,11-06-2020,RKI,1,1,0,1591833600000,09162,München,6446,218,6227,1471508,4736
DE-BY,12-06-2020,RKI,10,10,0,1591920000000,09162,München,6456,218,6237,1471508,4736
DE-BY,13-06-2020,RKI,4,4,0,1592006400000,09162,München,6460,218,6241,1471508,4736
DE-BY,14-06-2020,RKI,10,10,0,1592092800000,09162,München,6470,218,6251,1471508,4736
DE-BY,15-06-2020,RKI,3,3,0,1592179200000,09162,München,6473,218,6254,1471508,4736
DE-BY,16-06-2020,RKI,8,8,0,1592265600000,09162,München,6481,218,6262,1471508,4736
DE-BY,17-06-2020,RKI,12,12,0,1592352000000,09162,München,6493,218,6274,1471508,4736
DE-BY,18-06-2020,RKI,3,3,0,1592438400000,09162,München,6496,218,6277,1471508,4736
DE-BY,19-06-2020,RKI,9,9,0,1592524800000,09162,München,6505,218,6286,1471508,4736
DE-BY,20-06-2020,RKI,22,6,0,1592611200000,09162,München,6527,218,6292,1471508,4736
DE-BY,21-06-2020,RKI,13,13,0,1592697600000,09162,München,6540,218,6305,1471508,4736
DE-BY,22-06-2020,RKI,3,2,0,1592784000000,09162,München,6543,218,6307,1471508,4736
DE-BY,23-06-2020,RKI,15,10,0,1592870400000,09162,München,6558,218,6317,1471508,4736
DE-BY,24-06-2020,RKI,12,10,1,1592956800000,09162,München,6570,219,6327,1471508,4736
DE-BY,25-06-2020,RKI,17,9,1,1593043200000,09162,München,6587,220,6336,1471508,4736
DE-BY,26-06-2020,RKI,15,8,0,1593129600000,09162,München,6602,220,6344,1471508,4736
DE-BY,27-06-2020,RKI,11,6,0,1593216000000,09162,München,6613,220,6350,1471508,4736
DE-BY,28-06-2020,RKI,10,3,0,1593302400000,09162,München,6623,220,6353,1471508,4736
DE-BY,29-06-2020,RKI,20,16,0,1593388800000,09162,München,6643,220,6369,1471508,4736
DE-BY,30-06-2020,RKI,36,24,0,1593475200000,09162,München,6679,220,6393,1471508,4736
DE-BY,01-07-2020,RKI,9,3,1,1593561600000,09162,München,6688,221,6396,1471508,4736
DE-BY,02-07-2020,RKI,22,9,0,1593648000000,09162,München,6710,221,6405,1471508,4736
DE-BY,03-07-2020,RKI,19,12,0,1593734400000,09162,München,6729,221,6417,1471508,4736
DE-BY,04-07-2020,RKI,14,1,0,1593820800000,09162,München,6743,221,6418,1471508,4736
DE-BY,05-07-2020,RKI,3,0,0,1593907200000,09162,München,6746,221,6418,1471508,4736
DE-BY,06-07-2020,RKI,20,4,0,1593993600000,09162,München,6766,221,6422,1471508,4736
DE-BY,07-07-2020,RKI,29,6,0,1594080000000,09162,München,6795,221,6428,1471508,4736
DE-BY,08-07-2020,RKI,19,7,0,1594166400000,09162,München,6814,221,6435,1471508,4736
DE-BY,09-07-2020,RKI,11,0,0,1594252800000,09162,München,6825,221,6435,1471508,4736
DE-BY,10-07-2020,RKI,18,2,0,1594339200000,09162,München,6843,221,6437,1471508,4736
DE-BY,11-07-2020,RKI,1,0,0,1594425600000,09162,München,6844,221,6437,1471508,4736
DE-BY,12-07-2020,RKI,6,0,0,1594512000000,09162,München,6850,221,6437,1471508,4736
DE-BY,13-07-2020,RKI,15,0,0,1594598400000,09162,München,6865,221,6437,1471508,4736
DE-BY,14-07-2020,RKI,9,0,0,1594684800000,09162,München,6874,221,6437,1471508,4736
DE-BY,15-07-2020,RKI,18,0,0,1594771200000,09162,München,6892,221,6437,1471508,4736
DE-BY,16-07-2020,RKI,13,0,0,1594857600000,09162,München,6905,221,6437,1471508,4736
DE-BY,15-03-2020,RKI,1,1,0,1584230400000,09163,Rosenheim,1,0,1,63324,1701
DE-BY,18-03-2020,RKI,8,8,0,1584489600000,09163,Rosenheim,9,0,9,63324,1701
DE-BY,19-03-2020,RKI,6,6,0,1584576000000,09163,Rosenheim,15,0,15,63324,1701
DE-BY,20-03-2020,RKI,7,7,0,1584662400000,09163,Rosenheim,22,0,22,63324,1701
DE-BY,21-03-2020,RKI,18,16,2,1584748800000,09163,Rosenheim,40,2,38,63324,1701
DE-BY,22-03-2020,RKI,2,2,0,1584835200000,09163,Rosenheim,42,2,40,63324,1701
DE-BY,23-03-2020,RKI,3,3,0,1584921600000,09163,Rosenheim,45,2,43,63324,1701
DE-BY,24-03-2020,RKI,19,18,1,1585008000000,09163,Rosenheim,64,3,61,63324,1701
DE-BY,25-03-2020,RKI,25,23,2,1585094400000,09163,Rosenheim,89,5,84,63324,1701
DE-BY,26-03-2020,RKI,13,13,0,1585180800000,09163,Rosenheim,102,5,97,63324,1701
DE-BY,27-03-2020,RKI,10,10,0,1585267200000,09163,Rosenheim,112,5,107,63324,1701
DE-BY,28-03-2020,RKI,6,6,0,1585353600000,09163,Rosenheim,118,5,113,63324,1701
DE-BY,29-03-2020,RKI,2,2,0,1585440000000,09163,Rosenheim,120,5,115,63324,1701
DE-BY,30-03-2020,RKI,0,0,0,1585526400000,09163,Rosenheim,120,5,115,63324,1701
DE-BY,31-03-2020,RKI,13,11,2,1585612800000,09163,Rosenheim,133,7,126,63324,1701
DE-BY,01-04-2020,RKI,17,16,1,1585699200000,09163,Rosenheim,150,8,142,63324,1701
DE-BY,02-04-2020,RKI,14,12,2,1585785600000,09163,Rosenheim,164,10,154,63324,1701
DE-BY,03-04-2020,RKI,15,14,1,1585872000000,09163,Rosenheim,179,11,168,63324,1701
DE-BY,04-04-2020,RKI,3,2,1,1585958400000,09163,Rosenheim,182,12,170,63324,1701
DE-BY,05-04-2020,RKI,5,5,0,1586044800000,09163,Rosenheim,187,12,175,63324,1701
DE-BY,06-04-2020,RKI,11,11,0,1586131200000,09163,Rosenheim,198,12,186,63324,1701
DE-BY,07-04-2020,RKI,19,17,2,1586217600000,09163,Rosenheim,217,14,203,63324,1701
DE-BY,08-04-2020,RKI,6,6,0,1586304000000,09163,Rosenheim,223,14,209,63324,1701
DE-BY,09-04-2020,RKI,13,12,1,1586390400000,09163,Rosenheim,236,15,221,63324,1701
DE-BY,10-04-2020,RKI,15,14,1,1586476800000,09163,Rosenheim,251,16,235,63324,1701
DE-BY,11-04-2020,RKI,5,5,0,1586563200000,09163,Rosenheim,256,16,240,63324,1701
DE-BY,12-04-2020,RKI,2,2,0,1586649600000,09163,Rosenheim,258,16,242,63324,1701
DE-BY,14-04-2020,RKI,9,7,2,1586822400000,09163,Rosenheim,267,18,249,63324,1701
DE-BY,15-04-2020,RKI,19,18,1,1586908800000,09163,Rosenheim,286,19,267,63324,1701
DE-BY,16-04-2020,RKI,15,13,2,1586995200000,09163,Rosenheim,301,21,280,63324,1701
DE-BY,17-04-2020,RKI,1,1,0,1587081600000,09163,Rosenheim,302,21,281,63324,1701
DE-BY,18-04-2020,RKI,7,6,1,1587168000000,09163,Rosenheim,309,22,287,63324,1701
DE-BY,19-04-2020,RKI,8,8,0,1587254400000,09163,Rosenheim,317,22,295,63324,1701
DE-BY,20-04-2020,RKI,4,4,0,1587340800000,09163,Rosenheim,321,22,299,63324,1701
DE-BY,21-04-2020,RKI,8,8,0,1587427200000,09163,Rosenheim,329,22,307,63324,1701
DE-BY,22-04-2020,RKI,13,13,0,1587513600000,09163,Rosenheim,342,22,320,63324,1701
DE-BY,23-04-2020,RKI,32,32,0,1587600000000,09163,Rosenheim,374,22,352,63324,1701
DE-BY,24-04-2020,RKI,0,0,0,1587686400000,09163,Rosenheim,374,22,352,63324,1701
DE-BY,25-04-2020,RKI,4,4,0,1587772800000,09163,Rosenheim,378,22,356,63324,1701
DE-BY,26-04-2020,RKI,3,3,0,1587859200000,09163,Rosenheim,381,22,359,63324,1701
DE-BY,28-04-2020,RKI,6,5,1,1588032000000,09163,Rosenheim,387,23,364,63324,1701
DE-BY,29-04-2020,RKI,6,6,0,1588118400000,09163,Rosenheim,393,23,370,63324,1701
DE-BY,30-04-2020,RKI,6,6,0,1588204800000,09163,Rosenheim,399,23,376,63324,1701
DE-BY,01-05-2020,RKI,8,8,0,1588291200000,09163,Rosenheim,407,23,384,63324,1701
DE-BY,03-05-2020,RKI,0,0,0,1588464000000,09163,Rosenheim,407,23,384,63324,1701
DE-BY,04-05-2020,RKI,2,2,0,1588550400000,09163,Rosenheim,409,23,386,63324,1701
DE-BY,07-05-2020,RKI,19,19,0,1588809600000,09163,Rosenheim,428,23,405,63324,1701
DE-BY,08-05-2020,RKI,5,5,0,1588896000000,09163,Rosenheim,433,23,410,63324,1701
DE-BY,09-05-2020,RKI,1,1,0,1588982400000,09163,Rosenheim,434,23,411,63324,1701
DE-BY,10-05-2020,RKI,0,0,0,1589068800000,09163,Rosenheim,434,23,411,63324,1701
DE-BY,11-05-2020,RKI,0,0,0,1589155200000,09163,Rosenheim,434,23,411,63324,1701
DE-BY,12-05-2020,RKI,2,2,0,1589241600000,09163,Rosenheim,436,23,413,63324,1701
DE-BY,13-05-2020,RKI,0,0,0,1589328000000,09163,Rosenheim,436,23,413,63324,1701
DE-BY,14-05-2020,RKI,0,0,0,1589414400000,09163,Rosenheim,436,23,413,63324,1701
DE-BY,15-05-2020,RKI,0,0,0,1589500800000,09163,Rosenheim,436,23,413,63324,1701
DE-BY,16-05-2020,RKI,0,0,0,1589587200000,09163,Rosenheim,436,23,413,63324,1701
DE-BY,17-05-2020,RKI,3,3,0,1589673600000,09163,Rosenheim,439,23,416,63324,1701
DE-BY,20-05-2020,RKI,1,1,0,1589932800000,09163,Rosenheim,440,23,417,63324,1701
DE-BY,21-05-2020,RKI,0,0,0,1590019200000,09163,Rosenheim,440,23,417,63324,1701
DE-BY,27-05-2020,RKI,1,1,0,1590537600000,09163,Rosenheim,441,23,418,63324,1701
DE-BY,28-05-2020,RKI,0,0,0,1590624000000,09163,Rosenheim,441,23,418,63324,1701
DE-BY,29-05-2020,RKI,0,0,0,1590710400000,09163,Rosenheim,441,23,418,63324,1701
DE-BY,07-06-2020,RKI,0,0,0,1591488000000,09163,Rosenheim,441,23,418,63324,1701
DE-BY,09-06-2020,RKI,0,0,0,1591660800000,09163,Rosenheim,441,23,418,63324,1701
DE-BY,13-06-2020,RKI,0,0,0,1592006400000,09163,Rosenheim,441,23,418,63324,1701
DE-BY,18-06-2020,RKI,0,0,0,1592438400000,09163,Rosenheim,441,23,418,63324,1701
DE-BY,21-06-2020,RKI,0,0,0,1592697600000,09163,Rosenheim,441,23,418,63324,1701
DE-BY,24-06-2020,RKI,0,0,0,1592956800000,09163,Rosenheim,441,23,418,63324,1701
DE-BY,25-06-2020,RKI,1,1,0,1593043200000,09163,Rosenheim,442,23,419,63324,1701
DE-BY,29-06-2020,RKI,0,0,0,1593388800000,09163,Rosenheim,442,23,419,63324,1701
DE-BY,01-07-2020,RKI,0,0,0,1593561600000,09163,Rosenheim,442,23,419,63324,1701
DE-BY,02-07-2020,RKI,3,3,0,1593648000000,09163,Rosenheim,445,23,422,63324,1701
DE-BY,15-07-2020,RKI,0,0,0,1594771200000,09163,Rosenheim,445,23,422,63324,1701
DE-BY,18-03-2020,RKI,5,5,0,1584489600000,09171,Altötting,5,0,5,111210,195
DE-BY,19-03-2020,RKI,4,4,0,1584576000000,09171,Altötting,9,0,9,111210,195
DE-BY,20-03-2020,RKI,2,2,0,1584662400000,09171,Altötting,11,0,11,111210,195
DE-BY,21-03-2020,RKI,5,5,0,1584748800000,09171,Altötting,16,0,16,111210,195
DE-BY,22-03-2020,RKI,7,7,0,1584835200000,09171,Altötting,23,0,23,111210,195
DE-BY,23-03-2020,RKI,1,1,0,1584921600000,09171,Altötting,24,0,24,111210,195
DE-BY,24-03-2020,RKI,8,8,0,1585008000000,09171,Altötting,32,0,32,111210,195
DE-BY,25-03-2020,RKI,19,16,3,1585094400000,09171,Altötting,51,3,48,111210,195
DE-BY,26-03-2020,RKI,4,4,0,1585180800000,09171,Altötting,55,3,52,111210,195
DE-BY,27-03-2020,RKI,12,12,0,1585267200000,09171,Altötting,67,3,64,111210,195
DE-BY,28-03-2020,RKI,6,5,1,1585353600000,09171,Altötting,73,4,69,111210,195
DE-BY,29-03-2020,RKI,8,8,0,1585440000000,09171,Altötting,81,4,77,111210,195
DE-BY,30-03-2020,RKI,11,11,0,1585526400000,09171,Altötting,92,4,88,111210,195
DE-BY,31-03-2020,RKI,14,14,0,1585612800000,09171,Altötting,106,4,102,111210,195
DE-BY,01-04-2020,RKI,28,25,3,1585699200000,09171,Altötting,134,7,127,111210,195
DE-BY,02-04-2020,RKI,10,10,0,1585785600000,09171,Altötting,144,7,137,111210,195
DE-BY,03-04-2020,RKI,18,18,0,1585872000000,09171,Altötting,162,7,155,111210,195
DE-BY,04-04-2020,RKI,10,10,0,1585958400000,09171,Altötting,172,7,165,111210,195
DE-BY,05-04-2020,RKI,16,16,0,1586044800000,09171,Altötting,188,7,181,111210,195
DE-BY,06-04-2020,RKI,15,15,0,1586131200000,09171,Altötting,203,7,196,111210,195
DE-BY,07-04-2020,RKI,8,8,0,1586217600000,09171,Altötting,211,7,204,111210,195
DE-BY,08-04-2020,RKI,29,29,0,1586304000000,09171,Altötting,240,7,233,111210,195
DE-BY,09-04-2020,RKI,10,10,0,1586390400000,09171,Altötting,250,7,243,111210,195
DE-BY,10-04-2020,RKI,20,20,0,1586476800000,09171,Altötting,270,7,263,111210,195
DE-BY,11-04-2020,RKI,2,2,0,1586563200000,09171,Altötting,272,7,265,111210,195
DE-BY,12-04-2020,RKI,0,0,0,1586649600000,09171,Altötting,272,7,265,111210,195
DE-BY,14-04-2020,RKI,3,3,0,1586822400000,09171,Altötting,275,7,268,111210,195
DE-BY,15-04-2020,RKI,13,13,0,1586908800000,09171,Altötting,288,7,281,111210,195
DE-BY,16-04-2020,RKI,25,25,0,1586995200000,09171,Altötting,313,7,306,111210,195
DE-BY,17-04-2020,RKI,6,6,0,1587081600000,09171,Altötting,319,7,312,111210,195
DE-BY,18-04-2020,RKI,0,0,0,1587168000000,09171,Altötting,319,7,312,111210,195
DE-BY,19-04-2020,RKI,5,5,0,1587254400000,09171,Altötting,324,7,317,111210,195
DE-BY,20-04-2020,RKI,0,0,0,1587340800000,09171,Altötting,324,7,317,111210,195
DE-BY,21-04-2020,RKI,4,4,0,1587427200000,09171,Altötting,328,7,321,111210,195
DE-BY,22-04-2020,RKI,1,1,0,1587513600000,09171,Altötting,329,7,322,111210,195
DE-BY,23-04-2020,RKI,3,3,0,1587600000000,09171,Altötting,332,7,325,111210,195
DE-BY,24-04-2020,RKI,3,3,0,1587686400000,09171,Altötting,335,7,328,111210,195
DE-BY,25-04-2020,RKI,3,3,0,1587772800000,09171,Altötting,338,7,331,111210,195
DE-BY,26-04-2020,RKI,2,2,0,1587859200000,09171,Altötting,340,7,333,111210,195
DE-BY,27-04-2020,RKI,1,1,0,1587945600000,09171,Altötting,341,7,334,111210,195
DE-BY,28-04-2020,RKI,4,4,0,1588032000000,09171,Altötting,345,7,338,111210,195
DE-BY,29-04-2020,RKI,0,0,0,1588118400000,09171,Altötting,345,7,338,111210,195
DE-BY,30-04-2020,RKI,1,1,0,1588204800000,09171,Altötting,346,7,339,111210,195
DE-BY,05-05-2020,RKI,1,1,0,1588636800000,09171,Altötting,347,7,340,111210,195
DE-BY,06-05-2020,RKI,1,1,0,1588723200000,09171,Altötting,348,7,341,111210,195
DE-BY,07-05-2020,RKI,1,1,0,1588809600000,09171,Altötting,349,7,342,111210,195
DE-BY,11-05-2020,RKI,0,0,0,1589155200000,09171,Altötting,349,7,342,111210,195
DE-BY,14-05-2020,RKI,0,0,0,1589414400000,09171,Altötting,349,7,342,111210,195
DE-BY,15-05-2020,RKI,0,0,0,1589500800000,09171,Altötting,349,7,342,111210,195
DE-BY,20-05-2020,RKI,0,0,0,1589932800000,09171,Altötting,349,7,342,111210,195
DE-BY,24-05-2020,RKI,0,0,0,1590278400000,09171,Altötting,349,7,342,111210,195
DE-BY,25-05-2020,RKI,0,0,0,1590364800000,09171,Altötting,349,7,342,111210,195
DE-BY,28-05-2020,RKI,0,0,0,1590624000000,09171,Altötting,349,7,342,111210,195
DE-BY,29-05-2020,RKI,2,2,0,1590710400000,09171,Altötting,351,7,344,111210,195
DE-BY,25-06-2020,RKI,0,0,0,1593043200000,09171,Altötting,351,7,344,111210,195
DE-BY,10-07-2020,RKI,0,0,0,1594339200000,09171,Altötting,351,7,344,111210,195
DE-BY,14-07-2020,RKI,0,0,0,1594684800000,09171,Altötting,351,7,344,111210,195
DE-BE,05-03-2020,RKI,3,3,0,1583366400000,11001,Berlin Mitte,5,0,5,384172,9733
DE-BE,06-03-2020,RKI,0,0,0,1583452800000,11001,Berlin Mitte,5,0,5,384172,9733
DE-BE,08-03-2020,RKI,0,0,0,1583625600000,11001,Berlin Mitte,5,0,5,384172,9733
DE-BE,10-03-2020,RKI,1,1,0,1583798400000,11001,Berlin Mitte,6,0,6,384172,9733
DE-BE,11-03-2020,RKI,8,8,0,1583884800000,11001,Berlin Mitte,14,0,14,384172,9733
DE-BE,12-03-2020,RKI,6,6,0,1583971200000,11001,Berlin Mitte,20,0,20,384172,9733
DE-BE,13-03-2020,RKI,6,6,0,1584057600000,11001,Berlin Mitte,26,0,26,384172,9733
DE-BE,14-03-2020,RKI,6,6,0,1584144000000,11001,Berlin Mitte,32,0,32,384172,9733
DE-BE,15-03-2020,RKI,7,7,0,1584230400000,11001,Berlin Mitte,39,0,39,384172,9733
DE-BE,16-03-2020,RKI,3,3,0,1584316800000,11001,Berlin Mitte,42,0,42,384172,9733
DE-BE,17-03-2020,RKI,19,19,0,1584403200000,11001,Berlin Mitte,61,0,61,384172,9733
DE-BE,18-03-2020,RKI,22,21,1,1584489600000,11001,Berlin Mitte,83,1,82,384172,9733
DE-BE,19-03-2020,RKI,24,24,0,1584576000000,11001,Berlin Mitte,107,1,106,384172,9733
DE-BE,20-03-2020,RKI,16,16,0,1584662400000,11001,Berlin Mitte,123,1,122,384172,9733
DE-BE,21-03-2020,RKI,24,24,0,1584748800000,11001,Berlin Mitte,147,1,146,384172,9733
DE-BE,22-03-2020,RKI,28,28,0,1584835200000,11001,Berlin Mitte,175,1,174,384172,9733
DE-BE,23-03-2020,RKI,19,19,0,1584921600000,11001,Berlin Mitte,194,1,193,384172,9733
DE-BE,24-03-2020,RKI,22,22,0,1585008000000,11001,Berlin Mitte,216,1,215,384172,9733
DE-BE,25-03-2020,RKI,25,25,0,1585094400000,11001,Berlin Mitte,241,1,240,384172,9733
DE-BE,26-03-2020,RKI,51,51,0,1585180800000,11001,Berlin Mitte,292,1,291,384172,9733
DE-BE,27-03-2020,RKI,45,45,0,1585267200000,11001,Berlin Mitte,337,1,336,384172,9733
DE-BE,28-03-2020,RKI,25,25,0,1585353600000,11001,Berlin Mitte,362,1,361,384172,9733
DE-BE,29-03-2020,RKI,15,15,0,1585440000000,11001,Berlin Mitte,377,1,376,384172,9733
DE-BE,30-03-2020,RKI,13,12,1,1585526400000,11001,Berlin Mitte,390,2,388,384172,9733
DE-BE,31-03-2020,RKI,45,45,0,1585612800000,11001,Berlin Mitte,435,2,433,384172,9733
DE-BE,01-04-2020,RKI,18,17,1,1585699200000,11001,Berlin Mitte,453,3,450,384172,9733
DE-BE,02-04-2020,RKI,34,33,1,1585785600000,11001,Berlin Mitte,487,4,483,384172,9733
DE-BE,03-04-2020,RKI,8,8,0,1585872000000,11001,Berlin Mitte,495,4,491,384172,9733
DE-BE,04-04-2020,RKI,17,17,0,1585958400000,11001,Berlin Mitte,512,4,508,384172,9733
DE-BE,05-04-2020,RKI,4,4,0,1586044800000,11001,Berlin Mitte,516,4,512,384172,9733
DE-BE,06-04-2020,RKI,35,35,0,1586131200000,11001,Berlin Mitte,551,4,547,384172,9733
DE-BE,07-04-2020,RKI,31,29,2,1586217600000,11001,Berlin Mitte,582,6,576,384172,9733
DE-BE,08-04-2020,RKI,12,12,0,1586304000000,11001,Berlin Mitte,594,6,588,384172,9733
DE-BE,09-04-2020,RKI,27,26,1,1586390400000,11001,Berlin Mitte,621,7,614,384172,9733
DE-BE,10-04-2020,RKI,22,21,1,1586476800000,11001,Berlin Mitte,643,8,635,384172,9733
DE-BE,11-04-2020,RKI,32,32,0,1586563200000,11001,Berlin Mitte,675,8,667,384172,9733
DE-BE,12-04-2020,RKI,8,8,0,1586649600000,11001,Berlin Mitte,683,8,675,384172,9733
DE-BE,13-04-2020,RKI,13,12,1,1586736000000,11001,Berlin Mitte,696,9,687,384172,9733
DE-BE,14-04-2020,RKI,11,11,0,1586822400000,11001,Berlin Mitte,707,9,698,384172,9733
DE-BE,15-04-2020,RKI,16,16,0,1586908800000,11001,Berlin Mitte,723,9,714,384172,9733
DE-BE,16-04-2020,RKI,11,10,1,1586995200000,11001,Berlin Mitte,734,10,724,384172,9733
DE-BE,17-04-2020,RKI,16,16,0,1587081600000,11001,Berlin Mitte,750,10,740,384172,9733
DE-BE,18-04-2020,RKI,3,3,0,1587168000000,11001,Berlin Mitte,753,10,743,384172,9733
DE-BE,19-04-2020,RKI,4,4,0,1587254400000,11001,Berlin Mitte,757,10,747,384172,9733
DE-BE,20-04-2020,RKI,4,4,0,1587340800000,11001,Berlin Mitte,761,10,751,384172,9733
DE-BE,21-04-2020,RKI,4,4,0,1587427200000,11001,Berlin Mitte,765,10,755,384172,9733
DE-BE,22-04-2020,RKI,9,7,2,1587513600000,11001,Berlin Mitte,774,12,762,384172,9733
DE-BE,23-04-2020,RKI,5,5,0,1587600000000,11001,Berlin Mitte,779,12,767,384172,9733
DE-BE,24-04-2020,RKI,3,3,0,1587686400000,11001,Berlin Mitte,782,12,770,384172,9733
DE-BE,25-04-2020,RKI,7,7,0,1587772800000,11001,Berlin Mitte,789,12,777,384172,9733
DE-BE,26-04-2020,RKI,1,1,0,1587859200000,11001,Berlin Mitte,790,12,778,384172,9733
DE-BE,27-04-2020,RKI,15,15,0,1587945600000,11001,Berlin Mitte,805,12,793,384172,9733
DE-BE,28-04-2020,RKI,6,6,0,1588032000000,11001,Berlin Mitte,811,12,799,384172,9733
DE-BE,29-04-2020,RKI,11,11,0,1588118400000,11001,Berlin Mitte,822,12,810,384172,9733
DE-BE,30-04-2020,RKI,4,4,0,1588204800000,11001,Berlin Mitte,826,12,814,384172,9733
DE-BE,01-05-2020,RKI,3,3,0,1588291200000,11001,Berlin Mitte,829,12,817,384172,9733
DE-BE,02-05-2020,RKI,2,2,0,1588377600000,11001,Berlin Mitte,831,12,819,384172,9733
DE-BE,04-05-2020,RKI,4,4,0,1588550400000,11001,Berlin Mitte,835,12,823,384172,9733
DE-BE,05-05-2020,RKI,10,10,0,1588636800000,11001,Berlin Mitte,845,12,833,384172,9733
DE-BE,06-05-2020,RKI,7,7,0,1588723200000,11001,Berlin Mitte,852,12,840,384172,9733
DE-BE,07-05-2020,RKI,3,2,1,1588809600000,11001,Berlin Mitte,855,13,842,384172,9733
DE-BE,09-05-2020,RKI,1,1,0,1588982400000,11001,Berlin Mitte,856,13,843,384172,9733
DE-BE,12-05-2020,RKI,5,5,0,1589241600000,11001,Berlin Mitte,861,13,848,384172,9733
DE-BE,13-05-2020,RKI,2,2,0,1589328000000,11001,Berlin Mitte,863,13,850,384172,9733
DE-BE,14-05-2020,RKI,5,5,0,1589414400000,11001,Berlin Mitte,868,13,855,384172,9733
DE-BE,15-05-2020,RKI,2,2,0,1589500800000,11001,Berlin Mitte,870,13,857,384172,9733
DE-BE,18-05-2020,RKI,2,2,0,1589760000000,11001,Berlin Mitte,872,13,859,384172,9733
DE-BE,19-05-2020,RKI,12,12,0,1589846400000,11001,Berlin Mitte,884,13,871,384172,9733
DE-BE,20-05-2020,RKI,2,2,0,1589932800000,11001,Berlin Mitte,886,13,873,384172,9733
DE-BE,22-05-2020,RKI,1,1,0,1590105600000,11001,Berlin Mitte,887,13,874,384172,9733
DE-BE,23-05-2020,RKI,0,0,0,1590192000000,11001,Berlin Mitte,887,13,874,384172,9733
DE-BE,25-05-2020,RKI,4,4,0,1590364800000,11001,Berlin Mitte,891,13,878,384172,9733
DE-BE,27-05-2020,RKI,5,5,0,1590537600000,11001,Berlin Mitte,896,13,883,384172,9733
DE-BE,28-05-2020,RKI,3,3,0,1590624000000,11001,Berlin Mitte,899,13,886,384172,9733
DE-BE,29-05-2020,RKI,6,6,0,1590710400000,11001,Berlin Mitte,905,13,892,384172,9733
DE-BE,31-05-2020,RKI,6,6,0,1590883200000,11001,Berlin Mitte,911,13,898,384172,9733
DE-BE,01-06-2020,RKI,0,0,0,1590969600000,11001,Berlin Mitte,911,13,898,384172,9733
DE-BE,02-06-2020,RKI,4,4,0,1591056000000,11001,Berlin Mitte,915,13,902,384172,9733
DE-BE,03-06-2020,RKI,3,3,0,1591142400000,11001,Berlin Mitte,918,13,905,384172,9733
DE-BE,04-06-2020,RKI,3,3,0,1591228800000,11001,Berlin Mitte,921,13,908,384172,9733
DE-BE,05-06-2020,RKI,4,4,0,1591315200000,11001,Berlin Mitte,925,13,912,384172,9733
DE-BE,08-06-2020,RKI,5,5,0,1591574400000,11001,Berlin Mitte,930,13,917,384172,9733
DE-BE,09-06-2020,RKI,6,6,0,1591660800000,11001,Berlin Mitte,936,13,923,384172,9733
DE-BE,10-06-2020,RKI,5,5,0,1591747200000,11001,Berlin Mitte,941,13,928,384172,9733
DE-BE,11-06-2020,RKI,8,8,0,1591833600000,11001,Berlin Mitte,949,13,936,384172,9733
DE-BE,12-06-2020,RKI,1,1,0,1591920000000,11001,Berlin Mitte,950,13,937,384172,9733
DE-BE,13-06-2020,RKI,22,22,0,1592006400000,11001,Berlin Mitte,972,13,959,384172,9733
DE-BE,14-06-2020,RKI,0,0,0,1592092800000,11001,Berlin Mitte,972,13,959,384172,9733
DE-BE,15-06-2020,RKI,11,11,0,1592179200000,11001,Berlin Mitte,983,13,970,384172,9733
DE-BE,16-06-2020,RKI,5,5,0,1592265600000,11001,Berlin Mitte,988,13,975,384172,9733
DE-BE,17-06-2020,RKI,8,8,0,1592352000000,11001,Berlin Mitte,996,13,983,384172,9733
DE-BE,18-06-2020,RKI,21,21,0,1592438400000,11001,Berlin Mitte,1017,13,1004,384172,9733
DE-BE,19-06-2020,RKI,21,20,1,1592524800000,11001,Berlin Mitte,1038,14,1024,384172,9733
DE-BE,22-06-2020,RKI,7,6,0,1592784000000,11001,Berlin Mitte,1045,14,1030,384172,9733
DE-BE,23-06-2020,RKI,3,3,0,1592870400000,11001,Berlin Mitte,1048,14,1033,384172,9733
DE-BE,24-06-2020,RKI,6,5,0,1592956800000,11001,Berlin Mitte,1054,14,1038,384172,9733
DE-BE,25-06-2020,RKI,9,9,0,1593043200000,11001,Berlin Mitte,1063,14,1047,384172,9733
DE-BE,26-06-2020,RKI,10,3,0,1593129600000,11001,Berlin Mitte,1073,14,1050,384172,9733
DE-BE,29-06-2020,RKI,13,12,0,1593388800000,11001,Berlin Mitte,1086,14,1062,384172,9733
DE-BE,30-06-2020,RKI,9,6,0,1593475200000,11001,Berlin Mitte,1095,14,1068,384172,9733
DE-BE,01-07-2020,RKI,7,6,0,1593561600000,11001,Berlin Mitte,1102,14,1074,384172,9733
DE-BE,02-07-2020,RKI,9,7,0,1593648000000,11001,Berlin Mitte,1111,14,1081,384172,9733
DE-BE,03-07-2020,RKI,4,4,0,1593734400000,11001,Berlin Mitte,1115,14,1085,384172,9733
DE-BE,04-07-2020,RKI,10,3,0,1593820800000,11001,Berlin Mitte,1125,14,1088,384172,9733
DE-BE,06-07-2020,RKI,6,3,1,1593993600000,11001,Berlin Mitte,1131,15,1091,384172,9733
DE-BE,07-07-2020,RKI,9,6,0,1594080000000,11001,Berlin Mitte,1140,15,1097,384172,9733
DE-BE,08-07-2020,RKI,3,0,0,1594166400000,11001,Berlin Mitte,1143,15,1097,384172,9733
DE-BE,09-07-2020,RKI,4,2,0,1594252800000,11001,Berlin Mitte,1147,15,1099,384172,9733
DE-BE,10-07-2020,RKI,5,1,0,1594339200000,11001,Berlin Mitte,1152,15,1100,384172,9733
DE-BE,13-07-2020,RKI,6,0,0,1594598400000,11001,Berlin Mitte,1158,15,1100,384172,9733
DE-BE,14-07-2020,RKI,1,0,0,1594684800000,11001,Berlin Mitte,1159,15,1100,384172,9733
DE-BE,15-07-2020,RKI,1,0,0,1594771200000,11001,Berlin Mitte,1160,15,1100,384172,9733
DE-BE,05-03-2020,RKI,1,1,0,1583366400000,11002,Berlin Friedrichshain-Kreuzberg,2,0,2,289762,14373
DE-BE,08-03-2020,RKI,0,0,0,1583625600000,11002,Berlin Friedrichshain-Kreuzberg,2,0,2,289762,14373
DE-BE,09-03-2020,RKI,2,2,0,1583712000000,11002,Berlin Friedrichshain-Kreuzberg,4,0,4,289762,14373
DE-BE,10-03-2020,RKI,3,3,0,1583798400000,11002,Berlin Friedrichshain-Kreuzberg,7,0,7,289762,14373
DE-BE,11-03-2020,RKI,1,1,0,1583884800000,11002,Berlin Friedrichshain-Kreuzberg,8,0,8,289762,14373
DE-BE,13-03-2020,RKI,9,9,0,1584057600000,11002,Berlin Friedrichshain-Kreuzberg,17,0,17,289762,14373
DE-BE,14-03-2020,RKI,4,4,0,1584144000000,11002,Berlin Friedrichshain-Kreuzberg,21,0,21,289762,14373
DE-BE,15-03-2020,RKI,1,1,0,1584230400000,11002,Berlin Friedrichshain-Kreuzberg,22,0,22,289762,14373
DE-BE,16-03-2020,RKI,5,5,0,1584316800000,11002,Berlin Friedrichshain-Kreuzberg,27,0,27,289762,14373
DE-BE,17-03-2020,RKI,3,3,0,1584403200000,11002,Berlin Friedrichshain-Kreuzberg,30,0,30,289762,14373
DE-BE,18-03-2020,RKI,18,17,1,1584489600000,11002,Berlin Friedrichshain-Kreuzberg,48,1,47,289762,14373
DE-BE,19-03-2020,RKI,19,19,0,1584576000000,11002,Berlin Friedrichshain-Kreuzberg,67,1,66,289762,14373
DE-BE,20-03-2020,RKI,15,15,0,1584662400000,11002,Berlin Friedrichshain-Kreuzberg,82,1,81,289762,14373
DE-BE,21-03-2020,RKI,20,19,1,1584748800000,11002,Berlin Friedrichshain-Kreuzberg,102,2,100,289762,14373
DE-BE,22-03-2020,RKI,8,8,0,1584835200000,11002,Berlin Friedrichshain-Kreuzberg,110,2,108,289762,14373
DE-BE,23-03-2020,RKI,8,8,0,1584921600000,11002,Berlin Friedrichshain-Kreuzberg,118,2,116,289762,14373
DE-BE,24-03-2020,RKI,18,18,0,1585008000000,11002,Berlin Friedrichshain-Kreuzberg,136,2,134,289762,14373
DE-BE,25-03-2020,RKI,45,45,0,1585094400000,11002,Berlin Friedrichshain-Kreuzberg,181,2,179,289762,14373
DE-BE,26-03-2020,RKI,18,18,0,1585180800000,11002,Berlin Friedrichshain-Kreuzberg,199,2,197,289762,14373
DE-BE,27-03-2020,RKI,19,19,0,1585267200000,11002,Berlin Friedrichshain-Kreuzberg,218,2,216,289762,14373
DE-BE,28-03-2020,RKI,13,13,0,1585353600000,11002,Berlin Friedrichshain-Kreuzberg,231,2,229,289762,14373
DE-BE,29-03-2020,RKI,4,4,0,1585440000000,11002,Berlin Friedrichshain-Kreuzberg,235,2,233,289762,14373
DE-BE,30-03-2020,RKI,12,12,0,1585526400000,11002,Berlin Friedrichshain-Kreuzberg,247,2,245,289762,14373
DE-BE,31-03-2020,RKI,9,9,0,1585612800000,11002,Berlin Friedrichshain-Kreuzberg,256,2,254,289762,14373
DE-BE,01-04-2020,RKI,20,19,1,1585699200000,11002,Berlin Friedrichshain-Kreuzberg,276,3,273,289762,14373
DE-BE,02-04-2020,RKI,23,23,0,1585785600000,11002,Berlin Friedrichshain-Kreuzberg,299,3,296,289762,14373
DE-BE,03-04-2020,RKI,16,16,0,1585872000000,11002,Berlin Friedrichshain-Kreuzberg,315,3,312,289762,14373
DE-BE,04-04-2020,RKI,4,4,0,1585958400000,11002,Berlin Friedrichshain-Kreuzberg,319,3,316,289762,14373
DE-BE,05-04-2020,RKI,1,1,0,1586044800000,11002,Berlin Friedrichshain-Kreuzberg,320,3,317,289762,14373
DE-BE,06-04-2020,RKI,3,3,0,1586131200000,11002,Berlin Friedrichshain-Kreuzberg,323,3,320,289762,14373
DE-BE,07-04-2020,RKI,8,8,0,1586217600000,11002,Berlin Friedrichshain-Kreuzberg,331,3,328,289762,14373
DE-BE,08-04-2020,RKI,4,4,0,1586304000000,11002,Berlin Friedrichshain-Kreuzberg,335,3,332,289762,14373
DE-BE,09-04-2020,RKI,13,13,0,1586390400000,11002,Berlin Friedrichshain-Kreuzberg,348,3,345,289762,14373
DE-BE,10-04-2020,RKI,5,4,1,1586476800000,11002,Berlin Friedrichshain-Kreuzberg,353,4,349,289762,14373
DE-BE,11-04-2020,RKI,4,4,0,1586563200000,11002,Berlin Friedrichshain-Kreuzberg,357,4,353,289762,14373
DE-BE,12-04-2020,RKI,2,2,0,1586649600000,11002,Berlin Friedrichshain-Kreuzberg,359,4,355,289762,14373
DE-BE,13-04-2020,RKI,1,1,0,1586736000000,11002,Berlin Friedrichshain-Kreuzberg,360,4,356,289762,14373
DE-BE,14-04-2020,RKI,2,2,0,1586822400000,11002,Berlin Friedrichshain-Kreuzberg,362,4,358,289762,14373
DE-BE,15-04-2020,RKI,6,6,0,1586908800000,11002,Berlin Friedrichshain-Kreuzberg,368,4,364,289762,14373
DE-BE,16-04-2020,RKI,3,3,0,1586995200000,11002,Berlin Friedrichshain-Kreuzberg,371,4,367,289762,14373
DE-BE,17-04-2020,RKI,2,2,0,1587081600000,11002,Berlin Friedrichshain-Kreuzberg,373,4,369,289762,14373
DE-BE,18-04-2020,RKI,4,4,0,1587168000000,11002,Berlin Friedrichshain-Kreuzberg,377,4,373,289762,14373
DE-BE,19-04-2020,RKI,3,3,0,1587254400000,11002,Berlin Friedrichshain-Kreuzberg,380,4,376,289762,14373
DE-BE,20-04-2020,RKI,1,1,0,1587340800000,11002,Berlin Friedrichshain-Kreuzberg,381,4,377,289762,14373
DE-BE,21-04-2020,RKI,4,4,0,1587427200000,11002,Berlin Friedrichshain-Kreuzberg,385,4,381,289762,14373
DE-BE,22-04-2020,RKI,8,8,0,1587513600000,11002,Berlin Friedrichshain-Kreuzberg,393,4,389,289762,14373
DE-BE,23-04-2020,RKI,4,4,0,1587600000000,11002,Berlin Friedrichshain-Kreuzberg,397,4,393,289762,14373
DE-BE,24-04-2020,RKI,3,3,0,1587686400000,11002,Berlin Friedrichshain-Kreuzberg,400,4,396,289762,14373
DE-BE,25-04-2020,RKI,1,1,0,1587772800000,11002,Berlin Friedrichshain-Kreuzberg,401,4,397,289762,14373
DE-BE,27-04-2020,RKI,0,0,0,1587945600000,11002,Berlin Friedrichshain-Kreuzberg,401,4,397,289762,14373
DE-BE,28-04-2020,RKI,2,1,1,1588032000000,11002,Berlin Friedrichshain-Kreuzberg,403,5,398,289762,14373
DE-BE,29-04-2020,RKI,2,2,0,1588118400000,11002,Berlin Friedrichshain-Kreuzberg,405,5,400,289762,14373
DE-BE,30-04-2020,RKI,2,2,0,1588204800000,11002,Berlin Friedrichshain-Kreuzberg,407,5,402,289762,14373
DE-BE,01-05-2020,RKI,0,0,0,1588291200000,11002,Berlin Friedrichshain-Kreuzberg,407,5,402,289762,14373
DE-BE,02-05-2020,RKI,0,0,0,1588377600000,11002,Berlin Friedrichshain-Kreuzberg,407,5,402,289762,14373
DE-BE,04-05-2020,RKI,4,4,0,1588550400000,11002,Berlin Friedrichshain-Kreuzberg,411,5,406,289762,14373
DE-BE,05-05-2020,RKI,4,4,0,1588636800000,11002,Berlin Friedrichshain-Kreuzberg,415,5,410,289762,14373
DE-BE,06-05-2020,RKI,6,6,0,1588723200000,11002,Berlin Friedrichshain-Kreuzberg,421,5,416,289762,14373
DE-BE,07-05-2020,RKI,2,2,0,1588809600000,11002,Berlin Friedrichshain-Kreuzberg,423,5,418,289762,14373
DE-BE,11-05-2020,RKI,1,0,1,1589155200000,11002,Berlin Friedrichshain-Kreuzberg,424,6,418,289762,14373
DE-BE,12-05-2020,RKI,2,1,1,1589241600000,11002,Berlin Friedrichshain-Kreuzberg,426,7,419,289762,14373
DE-BE,13-05-2020,RKI,3,3,0,1589328000000,11002,Berlin Friedrichshain-Kreuzberg,429,7,422,289762,14373
DE-BE,14-05-2020,RKI,1,1,0,1589414400000,11002,Berlin Friedrichshain-Kreuzberg,430,7,423,289762,14373
DE-BE,16-05-2020,RKI,1,1,0,1589587200000,11002,Berlin Friedrichshain-Kreuzberg,431,7,424,289762,14373
DE-BE,17-05-2020,RKI,1,1,0,1589673600000,11002,Berlin Friedrichshain-Kreuzberg,432,7,425,289762,14373
DE-BE,18-05-2020,RKI,0,0,0,1589760000000,11002,Berlin Friedrichshain-Kreuzberg,432,7,425,289762,14373
DE-BE,19-05-2020,RKI,6,5,1,1589846400000,11002,Berlin Friedrichshain-Kreuzberg,438,8,430,289762,14373
DE-BE,20-05-2020,RKI,6,6,0,1589932800000,11002,Berlin Friedrichshain-Kreuzberg,444,8,436,289762,14373
DE-BE,22-05-2020,RKI,2,2,0,1590105600000,11002,Berlin Friedrichshain-Kreuzberg,446,8,438,289762,14373
DE-BE,25-05-2020,RKI,1,1,0,1590364800000,11002,Berlin Friedrichshain-Kreuzberg,447,8,439,289762,14373
DE-BE,26-05-2020,RKI,0,0,0,1590451200000,11002,Berlin Friedrichshain-Kreuzberg,447,8,439,289762,14373
DE-BE,27-05-2020,RKI,0,0,0,1590537600000,11002,Berlin Friedrichshain-Kreuzberg,447,8,439,289762,14373
DE-BE,28-05-2020,RKI,1,1,0,1590624000000,11002,Berlin Friedrichshain-Kreuzberg,448,8,440,289762,14373
DE-BE,29-05-2020,RKI,0,0,0,1590710400000,11002,Berlin Friedrichshain-Kreuzberg,448,8,440,289762,14373
DE-BE,31-05-2020,RKI,1,1,0,1590883200000,11002,Berlin Friedrichshain-Kreuzberg,449,8,441,289762,14373
DE-BE,02-06-2020,RKI,11,11,0,1591056000000,11002,Berlin Friedrichshain-Kreuzberg,460,8,452,289762,14373
DE-BE,03-06-2020,RKI,7,7,0,1591142400000,11002,Berlin Friedrichshain-Kreuzberg,467,8,459,289762,14373
DE-BE,04-06-2020,RKI,5,5,0,1591228800000,11002,Berlin Friedrichshain-Kreuzberg,472,8,464,289762,14373
DE-BE,06-06-2020,RKI,3,3,0,1591401600000,11002,Berlin Friedrichshain-Kreuzberg,475,8,467,289762,14373
DE-BE,07-06-2020,RKI,0,0,0,1591488000000,11002,Berlin Friedrichshain-Kreuzberg,475,8,467,289762,14373
DE-BE,09-06-2020,RKI,6,6,0,1591660800000,11002,Berlin Friedrichshain-Kreuzberg,481,8,473,289762,14373
DE-BE,10-06-2020,RKI,0,0,0,1591747200000,11002,Berlin Friedrichshain-Kreuzberg,481,8,473,289762,14373
DE-BE,11-06-2020,RKI,1,1,0,1591833600000,11002,Berlin Friedrichshain-Kreuzberg,482,8,474,289762,14373
DE-BE,12-06-2020,RKI,0,0,0,1591920000000,11002,Berlin Friedrichshain-Kreuzberg,482,8,474,289762,14373
DE-BE,13-06-2020,RKI,1,1,0,1592006400000,11002,Berlin Friedrichshain-Kreuzberg,483,8,475,289762,14373
DE-BE,15-06-2020,RKI,0,0,0,1592179200000,11002,Berlin Friedrichshain-Kreuzberg,483,8,475,289762,14373
DE-BE,16-06-2020,RKI,3,3,0,1592265600000,11002,Berlin Friedrichshain-Kreuzberg,486,8,478,289762,14373
DE-BE,17-06-2020,RKI,17,17,0,1592352000000,11002,Berlin Friedrichshain-Kreuzberg,503,8,495,289762,14373
DE-BE,18-06-2020,RKI,6,6,0,1592438400000,11002,Berlin Friedrichshain-Kreuzberg,509,8,501,289762,14373
DE-BE,19-06-2020,RKI,34,34,0,1592524800000,11002,Berlin Friedrichshain-Kreuzberg,543,8,535,289762,14373
DE-BE,20-06-2020,RKI,5,5,0,1592611200000,11002,Berlin Friedrichshain-Kreuzberg,548,8,540,289762,14373
DE-BE,22-06-2020,RKI,3,2,0,1592784000000,11002,Berlin Friedrichshain-Kreuzberg,551,8,542,289762,14373
DE-BE,23-06-2020,RKI,2,1,0,1592870400000,11002,Berlin Friedrichshain-Kreuzberg,553,8,543,289762,14373
DE-BE,24-06-2020,RKI,3,2,0,1592956800000,11002,Berlin Friedrichshain-Kreuzberg,556,8,545,289762,14373
DE-BE,25-06-2020,RKI,1,1,0,1593043200000,11002,Berlin Friedrichshain-Kreuzberg,557,8,546,289762,14373
DE-BE,26-06-2020,RKI,3,3,0,1593129600000,11002,Berlin Friedrichshain-Kreuzberg,560,8,549,289762,14373
DE-BE,27-06-2020,RKI,1,1,0,1593216000000,11002,Berlin Friedrichshain-Kreuzberg,561,8,550,289762,14373
DE-BE,29-06-2020,RKI,5,5,0,1593388800000,11002,Berlin Friedrichshain-Kreuzberg,566,8,555,289762,14373
DE-BE,30-06-2020,RKI,0,0,0,1593475200000,11002,Berlin Friedrichshain-Kreuzberg,566,8,555,289762,14373
DE-BE,01-07-2020,RKI,4,3,0,1593561600000,11002,Berlin Friedrichshain-Kreuzberg,570,8,558,289762,14373
DE-BE,02-07-2020,RKI,11,11,0,1593648000000,11002,Berlin Friedrichshain-Kreuzberg,581,8,569,289762,14373
DE-BE,03-07-2020,RKI,3,3,0,1593734400000,11002,Berlin Friedrichshain-Kreuzberg,584,8,572,289762,14373
DE-BE,04-07-2020,RKI,0,0,0,1593820800000,11002,Berlin Friedrichshain-Kreuzberg,584,8,572,289762,14373
DE-BE,07-07-2020,RKI,3,2,0,1594080000000,11002,Berlin Friedrichshain-Kreuzberg,587,8,574,289762,14373
DE-BE,08-07-2020,RKI,1,0,0,1594166400000,11002,Berlin Friedrichshain-Kreuzberg,588,8,574,289762,14373
DE-BE,09-07-2020,RKI,3,0,0,1594252800000,11002,Berlin Friedrichshain-Kreuzberg,591,8,574,289762,14373
DE-BE,10-07-2020,RKI,2,0,0,1594339200000,11002,Berlin Friedrichshain-Kreuzberg,593,8,574,289762,14373
DE-BE,13-07-2020,RKI,0,0,0,1594598400000,11002,Berlin Friedrichshain-Kreuzberg,593,8,574,289762,14373
DE-BE,15-07-2020,RKI,0,0,0,1594771200000,11002,Berlin Friedrichshain-Kreuzberg,593,8,574,289762,14373
DE-BE,05-03-2020,RKI,1,1,0,1583366400000,11003,Berlin Pankow,1,0,1,407765,3958
DE-BE,06-03-2020,RKI,0,0,0,1583452800000,11003,Berlin Pankow,1,0,1,407765,3958
DE-BE,09-03-2020,RKI,1,1,0,1583712000000,11003,Berlin Pankow,2,0,2,407765,3958
DE-BE,10-03-2020,RKI,2,2,0,1583798400000,11003,Berlin Pankow,4,0,4,407765,3958
DE-BE,11-03-2020,RKI,5,5,0,1583884800000,11003,Berlin Pankow,9,0,9,407765,3958
DE-BE,12-03-2020,RKI,3,3,0,1583971200000,11003,Berlin Pankow,12,0,12,407765,3958
DE-BE,13-03-2020,RKI,8,8,0,1584057600000,11003,Berlin Pankow,20,0,20,407765,3958
DE-BE,16-03-2020,RKI,13,13,0,1584316800000,11003,Berlin Pankow,33,0,33,407765,3958
DE-BE,17-03-2020,RKI,7,7,0,1584403200000,11003,Berlin Pankow,40,0,40,407765,3958
DE-BE,18-03-2020,RKI,9,9,0,1584489600000,11003,Berlin Pankow,49,0,49,407765,3958
DE-BE,19-03-2020,RKI,16,16,0,1584576000000,11003,Berlin Pankow,65,0,65,407765,3958
DE-BE,20-03-2020,RKI,15,15,0,1584662400000,11003,Berlin Pankow,80,0,80,407765,3958
DE-BE,21-03-2020,RKI,15,15,0,1584748800000,11003,Berlin Pankow,95,0,95,407765,3958
DE-BE,22-03-2020,RKI,6,6,0,1584835200000,11003,Berlin Pankow,101,0,101,407765,3958
DE-BE,23-03-2020,RKI,8,8,0,1584921600000,11003,Berlin Pankow,109,0,109,407765,3958
DE-BE,24-03-2020,RKI,21,21,0,1585008000000,11003,Berlin Pankow,130,0,130,407765,3958
DE-BE,25-03-2020,RKI,17,17,0,1585094400000,11003,Berlin Pankow,147,0,147,407765,3958
DE-BE,26-03-2020,RKI,37,37,0,1585180800000,11003,Berlin Pankow,184,0,184,407765,3958
DE-BE,27-03-2020,RKI,31,30,1,1585267200000,11003,Berlin Pankow,215,1,214,407765,3958
DE-BE,28-03-2020,RKI,10,9,1,1585353600000,11003,Berlin Pankow,225,2,223,407765,3958
DE-BE,29-03-2020,RKI,10,9,1,1585440000000,11003,Berlin Pankow,235,3,232,407765,3958
DE-BE,30-03-2020,RKI,12,12,0,1585526400000,11003,Berlin Pankow,247,3,244,407765,3958
DE-BE,31-03-2020,RKI,18,18,0,1585612800000,11003,Berlin Pankow,265,3,262,407765,3958
DE-BE,01-04-2020,RKI,12,12,0,1585699200000,11003,Berlin Pankow,277,3,274,407765,3958
DE-BE,02-04-2020,RKI,20,19,1,1585785600000,11003,Berlin Pankow,297,4,293,407765,3958
DE-BE,03-04-2020,RKI,36,31,5,1585872000000,11003,Berlin Pankow,333,9,324,407765,3958
DE-BE,04-04-2020,RKI,9,9,0,1585958400000,11003,Berlin Pankow,342,9,333,407765,3958
DE-BE,05-04-2020,RKI,7,7,0,1586044800000,11003,Berlin Pankow,349,9,340,407765,3958
DE-BE,06-04-2020,RKI,11,11,0,1586131200000,11003,Berlin Pankow,360,9,351,407765,3958
DE-BE,07-04-2020,RKI,17,12,5,1586217600000,11003,Berlin Pankow,377,14,363,407765,3958
DE-BE,08-04-2020,RKI,17,16,1,1586304000000,11003,Berlin Pankow,394,15,379,407765,3958
DE-BE,09-04-2020,RKI,26,24,2,1586390400000,11003,Berlin Pankow,420,17,403,407765,3958
DE-BE,10-04-2020,RKI,3,3,0,1586476800000,11003,Berlin Pankow,423,17,406,407765,3958
DE-BE,11-04-2020,RKI,7,6,1,1586563200000,11003,Berlin Pankow,430,18,412,407765,3958
DE-BE,12-04-2020,RKI,5,5,0,1586649600000,11003,Berlin Pankow,435,18,417,407765,3958
DE-BE,13-04-2020,RKI,4,4,0,1586736000000,11003,Berlin Pankow,439,18,421,407765,3958
DE-BE,14-04-2020,RKI,6,6,0,1586822400000,11003,Berlin Pankow,445,18,427,407765,3958
DE-BE,15-04-2020,RKI,5,5,0,1586908800000,11003,Berlin Pankow,450,18,432,407765,3958
DE-BE,16-04-2020,RKI,11,10,1,1586995200000,11003,Berlin Pankow,461,19,442,407765,3958
DE-BE,17-04-2020,RKI,30,26,4,1587081600000,11003,Berlin Pankow,491,23,468,407765,3958
DE-BE,18-04-2020,RKI,11,10,1,1587168000000,11003,Berlin Pankow,502,24,478,407765,3958
DE-BE,19-04-2020,RKI,3,3,0,1587254400000,11003,Berlin Pankow,505,24,481,407765,3958
DE-BE,20-04-2020,RKI,3,3,0,1587340800000,11003,Berlin Pankow,508,24,484,407765,3958
DE-BE,21-04-2020,RKI,8,8,0,1587427200000,11003,Berlin Pankow,516,24,492,407765,3958
DE-BE,22-04-2020,RKI,5,5,0,1587513600000,11003,Berlin Pankow,521,24,497,407765,3958
DE-BE,23-04-2020,RKI,6,6,0,1587600000000,11003,Berlin Pankow,527,24,503,407765,3958
DE-BE,24-04-2020,RKI,14,12,2,1587686400000,11003,Berlin Pankow,541,26,515,407765,3958
DE-BE,25-04-2020,RKI,0,0,0,1587772800000,11003,Berlin Pankow,541,26,515,407765,3958
DE-BE,26-04-2020,RKI,0,0,0,1587859200000,11003,Berlin Pankow,541,26,515,407765,3958
DE-BE,27-04-2020,RKI,1,0,1,1587945600000,11003,Berlin Pankow,542,27,515,407765,3958
DE-BE,28-04-2020,RKI,4,3,1,1588032000000,11003,Berlin Pankow,546,28,518,407765,3958
DE-BE,29-04-2020,RKI,2,2,0,1588118400000,11003,Berlin Pankow,548,28,520,407765,3958
DE-BE,30-04-2020,RKI,11,10,1,1588204800000,11003,Berlin Pankow,559,29,530,407765,3958
DE-BE,02-05-2020,RKI,8,6,2,1588377600000,11003,Berlin Pankow,567,31,536,407765,3958
DE-BE,03-05-2020,RKI,1,1,0,1588464000000,11003,Berlin Pankow,568,31,537,407765,3958
DE-BE,04-05-2020,RKI,3,3,0,1588550400000,11003,Berlin Pankow,571,31,540,407765,3958
DE-BE,05-05-2020,RKI,5,5,0,1588636800000,11003,Berlin Pankow,576,31,545,407765,3958
DE-BE,06-05-2020,RKI,4,4,0,1588723200000,11003,Berlin Pankow,580,31,549,407765,3958
DE-BE,07-05-2020,RKI,5,5,0,1588809600000,11003,Berlin Pankow,585,31,554,407765,3958
DE-BE,09-05-2020,RKI,2,1,1,1588982400000,11003,Berlin Pankow,587,32,555,407765,3958
DE-BE,11-05-2020,RKI,2,1,1,1589155200000,11003,Berlin Pankow,589,33,556,407765,3958
DE-BE,13-05-2020,RKI,8,8,0,1589328000000,11003,Berlin Pankow,597,33,564,407765,3958
DE-BE,14-05-2020,RKI,0,0,0,1589414400000,11003,Berlin Pankow,597,33,564,407765,3958
DE-BE,15-05-2020,RKI,0,0,0,1589500800000,11003,Berlin Pankow,597,33,564,407765,3958
DE-BE,17-05-2020,RKI,0,0,0,1589673600000,11003,Berlin Pankow,597,33,564,407765,3958
DE-BE,18-05-2020,RKI,9,9,0,1589760000000,11003,Berlin Pankow,606,33,573,407765,3958
DE-BE,19-05-2020,RKI,11,9,2,1589846400000,11003,Berlin Pankow,617,35,582,407765,3958
DE-BE,20-05-2020,RKI,5,4,1,1589932800000,11003,Berlin Pankow,622,36,586,407765,3958
DE-BE,22-05-2020,RKI,8,8,0,1590105600000,11003,Berlin Pankow,630,36,594,407765,3958
DE-BE,23-05-2020,RKI,0,0,0,1590192000000,11003,Berlin Pankow,630,36,594,407765,3958
DE-BE,26-05-2020,RKI,0,0,0,1590451200000,11003,Berlin Pankow,630,36,594,407765,3958
DE-BE,27-05-2020,RKI,3,3,0,1590537600000,11003,Berlin Pankow,633,36,597,407765,3958
DE-BE,29-05-2020,RKI,0,0,0,1590710400000,11003,Berlin Pankow,633,36,597,407765,3958
DE-BE,02-06-2020,RKI,4,4,0,1591056000000,11003,Berlin Pankow,637,36,601,407765,3958
DE-BE,03-06-2020,RKI,2,2,0,1591142400000,11003,Berlin Pankow,639,36,603,407765,3958
DE-BE,05-06-2020,RKI,3,3,0,1591315200000,11003,Berlin Pankow,642,36,606,407765,3958
DE-BE,07-06-2020,RKI,0,0,0,1591488000000,11003,Berlin Pankow,642,36,606,407765,3958
DE-BE,08-06-2020,RKI,2,2,0,1591574400000,11003,Berlin Pankow,644,36,608,407765,3958
DE-BE,09-06-2020,RKI,1,1,0,1591660800000,11003,Berlin Pankow,645,36,609,407765,3958
DE-BE,10-06-2020,RKI,1,1,0,1591747200000,11003,Berlin Pankow,646,36,610,407765,3958
DE-BE,11-06-2020,RKI,2,2,0,1591833600000,11003,Berlin Pankow,648,36,612,407765,3958
DE-BE,12-06-2020,RKI,2,1,1,1591920000000,11003,Berlin Pankow,650,37,613,407765,3958
DE-BE,14-06-2020,RKI,2,2,0,1592092800000,11003,Berlin Pankow,652,37,615,407765,3958
DE-BE,15-06-2020,RKI,0,0,0,1592179200000,11003,Berlin Pankow,652,37,615,407765,3958
DE-BE,16-06-2020,RKI,7,7,0,1592265600000,11003,Berlin Pankow,659,37,622,407765,3958
DE-BE,17-06-2020,RKI,2,2,0,1592352000000,11003,Berlin Pankow,661,37,624,407765,3958
DE-BE,18-06-2020,RKI,1,1,0,1592438400000,11003,Berlin Pankow,662,37,625,407765,3958
DE-BE,19-06-2020,RKI,4,4,0,1592524800000,11003,Berlin Pankow,666,37,629,407765,3958
DE-BE,22-06-2020,RKI,5,5,0,1592784000000,11003,Berlin Pankow,671,37,634,407765,3958
DE-BE,23-06-2020,RKI,4,4,0,1592870400000,11003,Berlin Pankow,675,37,638,407765,3958
DE-BE,24-06-2020,RKI,1,1,0,1592956800000,11003,Berlin Pankow,676,37,639,407765,3958
DE-BE,25-06-2020,RKI,0,0,0,1593043200000,11003,Berlin Pankow,676,37,639,407765,3958
DE-BE,26-06-2020,RKI,0,0,0,1593129600000,11003,Berlin Pankow,676,37,639,407765,3958
DE-BE,29-06-2020,RKI,3,3,0,1593388800000,11003,Berlin Pankow,679,37,642,407765,3958
DE-BE,01-07-2020,RKI,5,5,0,1593561600000,11003,Berlin Pankow,684,37,647,407765,3958
DE-BE,02-07-2020,RKI,1,1,0,1593648000000,11003,Berlin Pankow,685,37,648,407765,3958
DE-BE,03-07-2020,RKI,2,2,0,1593734400000,11003,Berlin Pankow,687,37,650,407765,3958
DE-BE,06-07-2020,RKI,5,3,0,1593993600000,11003,Berlin Pankow,692,37,653,407765,3958
DE-BE,07-07-2020,RKI,2,0,0,1594080000000,11003,Berlin Pankow,694,37,653,407765,3958
DE-BE,08-07-2020,RKI,0,0,0,1594166400000,11003,Berlin Pankow,694,37,653,407765,3958
DE-BE,09-07-2020,RKI,0,0,0,1594252800000,11003,Berlin Pankow,694,37,653,407765,3958
DE-BE,10-07-2020,RKI,1,0,0,1594339200000,11003,Berlin Pankow,695,37,653,407765,3958
DE-BE,13-07-2020,RKI,3,1,0,1594598400000,11003,Berlin Pankow,698,37,654,407765,3958
DE-BE,14-07-2020,RKI,0,0,0,1594684800000,11003,Berlin Pankow,698,37,654,407765,3958
DE-BE,15-07-2020,RKI,0,0,0,1594771200000,11003,Berlin Pankow,698,37,654,407765,3958
DE-BE,07-03-2020,RKI,0,0,0,1583539200000,11004,Berlin Charlottenburg-Wilmersdorf,1,0,1,342332,5289
DE-BE,08-03-2020,RKI,6,6,0,1583625600000,11004,Berlin Charlottenburg-Wilmersdorf,7,0,7,342332,5289
DE-BE,09-03-2020,RKI,0,0,0,1583712000000,11004,Berlin Charlottenburg-Wilmersdorf,7,0,7,342332,5289
DE-BE,10-03-2020,RKI,5,5,0,1583798400000,11004,Berlin Charlottenburg-Wilmersdorf,12,0,12,342332,5289
DE-BE,11-03-2020,RKI,7,7,0,1583884800000,11004,Berlin Charlottenburg-Wilmersdorf,19,0,19,342332,5289
DE-BE,12-03-2020,RKI,9,9,0,1583971200000,11004,Berlin Charlottenburg-Wilmersdorf,28,0,28,342332,5289
DE-BE,13-03-2020,RKI,11,11,0,1584057600000,11004,Berlin Charlottenburg-Wilmersdorf,39,0,39,342332,5289
DE-BE,14-03-2020,RKI,1,1,0,1584144000000,11004,Berlin Charlottenburg-Wilmersdorf,40,0,40,342332,5289
DE-BE,15-03-2020,RKI,5,5,0,1584230400000,11004,Berlin Charlottenburg-Wilmersdorf,45,0,45,342332,5289
DE-BE,16-03-2020,RKI,6,6,0,1584316800000,11004,Berlin Charlottenburg-Wilmersdorf,51,0,51,342332,5289
DE-BE,17-03-2020,RKI,12,12,0,1584403200000,11004,Berlin Charlottenburg-Wilmersdorf,63,0,63,342332,5289
DE-BE,18-03-2020,RKI,15,15,0,1584489600000,11004,Berlin Charlottenburg-Wilmersdorf,78,0,78,342332,5289
DE-BE,19-03-2020,RKI,25,25,0,1584576000000,11004,Berlin Charlottenburg-Wilmersdorf,103,0,103,342332,5289
DE-BE,20-03-2020,RKI,13,12,1,1584662400000,11004,Berlin Charlottenburg-Wilmersdorf,116,1,115,342332,5289
DE-BE,21-03-2020,RKI,6,5,1,1584748800000,11004,Berlin Charlottenburg-Wilmersdorf,122,2,120,342332,5289
DE-BE,22-03-2020,RKI,9,9,0,1584835200000,11004,Berlin Charlottenburg-Wilmersdorf,131,2,129,342332,5289
DE-BE,23-03-2020,RKI,23,23,0,1584921600000,11004,Berlin Charlottenburg-Wilmersdorf,154,2,152,342332,5289
DE-BE,24-03-2020,RKI,22,22,0,1585008000000,11004,Berlin Charlottenburg-Wilmersdorf,176,2,174,342332,5289
DE-BE,25-03-2020,RKI,35,35,0,1585094400000,11004,Berlin Charlottenburg-Wilmersdorf,211,2,209,342332,5289
DE-BE,26-03-2020,RKI,43,41,2,1585180800000,11004,Berlin Charlottenburg-Wilmersdorf,254,4,250,342332,5289
DE-BE,27-03-2020,RKI,15,15,0,1585267200000,11004,Berlin Charlottenburg-Wilmersdorf,269,4,265,342332,5289
DE-BE,28-03-2020,RKI,20,20,0,1585353600000,11004,Berlin Charlottenburg-Wilmersdorf,289,4,285,342332,5289
DE-BE,29-03-2020,RKI,5,5,0,1585440000000,11004,Berlin Charlottenburg-Wilmersdorf,294,4,290,342332,5289
DE-BE,30-03-2020,RKI,36,36,0,1585526400000,11004,Berlin Charlottenburg-Wilmersdorf,330,4,326,342332,5289
DE-BE,31-03-2020,RKI,23,22,1,1585612800000,11004,Berlin Charlottenburg-Wilmersdorf,353,5,348,342332,5289
DE-BE,01-04-2020,RKI,22,21,1,1585699200000,11004,Berlin Charlottenburg-Wilmersdorf,375,6,369,342332,5289
DE-BE,02-04-2020,RKI,30,30,0,1585785600000,11004,Berlin Charlottenburg-Wilmersdorf,405,6,399,342332,5289
DE-BE,03-04-2020,RKI,15,14,1,1585872000000,11004,Berlin Charlottenburg-Wilmersdorf,420,7,413,342332,5289
DE-BE,04-04-2020,RKI,3,3,0,1585958400000,11004,Berlin Charlottenburg-Wilmersdorf,423,7,416,342332,5289
DE-BE,05-04-2020,RKI,4,4,0,1586044800000,11004,Berlin Charlottenburg-Wilmersdorf,427,7,420,342332,5289
DE-BE,06-04-2020,RKI,18,17,1,1586131200000,11004,Berlin Charlottenburg-Wilmersdorf,445,8,437,342332,5289
DE-BE,07-04-2020,RKI,40,35,5,1586217600000,11004,Berlin Charlottenburg-Wilmersdorf,485,13,472,342332,5289
DE-BE,08-04-2020,RKI,19,19,0,1586304000000,11004,Berlin Charlottenburg-Wilmersdorf,504,13,491,342332,5289
DE-BE,09-04-2020,RKI,11,10,1,1586390400000,11004,Berlin Charlottenburg-Wilmersdorf,515,14,501,342332,5289
DE-BE,10-04-2020,RKI,6,6,0,1586476800000,11004,Berlin Charlottenburg-Wilmersdorf,521,14,507,342332,5289
DE-BE,11-04-2020,RKI,2,2,0,1586563200000,11004,Berlin Charlottenburg-Wilmersdorf,523,14,509,342332,5289
DE-BE,12-04-2020,RKI,6,6,0,1586649600000,11004,Berlin Charlottenburg-Wilmersdorf,529,14,515,342332,5289
DE-BE,13-04-2020,RKI,3,2,1,1586736000000,11004,Berlin Charlottenburg-Wilmersdorf,532,15,517,342332,5289
DE-BE,14-04-2020,RKI,5,5,0,1586822400000,11004,Berlin Charlottenburg-Wilmersdorf,537,15,522,342332,5289
DE-BE,15-04-2020,RKI,13,12,1,1586908800000,11004,Berlin Charlottenburg-Wilmersdorf,550,16,534,342332,5289
DE-BE,16-04-2020,RKI,13,12,1,1586995200000,11004,Berlin Charlottenburg-Wilmersdorf,563,17,546,342332,5289
DE-BE,17-04-2020,RKI,7,7,0,1587081600000,11004,Berlin Charlottenburg-Wilmersdorf,570,17,553,342332,5289
DE-BE,18-04-2020,RKI,3,3,0,1587168000000,11004,Berlin Charlottenburg-Wilmersdorf,573,17,556,342332,5289
DE-BE,19-04-2020,RKI,4,4,0,1587254400000,11004,Berlin Charlottenburg-Wilmersdorf,577,17,560,342332,5289
DE-BE,20-04-2020,RKI,1,1,0,1587340800000,11004,Berlin Charlottenburg-Wilmersdorf,578,17,561,342332,5289
DE-BE,21-04-2020,RKI,8,7,1,1587427200000,11004,Berlin Charlottenburg-Wilmersdorf,586,18,568,342332,5289
DE-BE,22-04-2020,RKI,6,5,1,1587513600000,11004,Berlin Charlottenburg-Wilmersdorf,592,19,573,342332,5289
DE-BE,23-04-2020,RKI,12,12,0,1587600000000,11004,Berlin Charlottenburg-Wilmersdorf,604,19,585,342332,5289
DE-BE,24-04-2020,RKI,4,3,1,1587686400000,11004,Berlin Charlottenburg-Wilmersdorf,608,20,588,342332,5289
DE-BE,25-04-2020,RKI,3,3,0,1587772800000,11004,Berlin Charlottenburg-Wilmersdorf,611,20,591,342332,5289
DE-BE,26-04-2020,RKI,2,1,1,1587859200000,11004,Berlin Charlottenburg-Wilmersdorf,613,21,592,342332,5289
DE-BE,27-04-2020,RKI,3,3,0,1587945600000,11004,Berlin Charlottenburg-Wilmersdorf,616,21,595,342332,5289
DE-BE,28-04-2020,RKI,3,2,1,1588032000000,11004,Berlin Charlottenburg-Wilmersdorf,619,22,597,342332,5289
DE-BE,29-04-2020,RKI,3,3,0,1588118400000,11004,Berlin Charlottenburg-Wilmersdorf,622,22,600,342332,5289
DE-BE,30-04-2020,RKI,0,0,0,1588204800000,11004,Berlin Charlottenburg-Wilmersdorf,622,22,600,342332,5289
DE-BE,01-05-2020,RKI,2,2,0,1588291200000,11004,Berlin Charlottenburg-Wilmersdorf,624,22,602,342332,5289
DE-BE,02-05-2020,RKI,1,1,0,1588377600000,11004,Berlin Charlottenburg-Wilmersdorf,625,22,603,342332,5289
DE-BE,03-05-2020,RKI,2,2,0,1588464000000,11004,Berlin Charlottenburg-Wilmersdorf,627,22,605,342332,5289
DE-BE,04-05-2020,RKI,1,1,0,1588550400000,11004,Berlin Charlottenburg-Wilmersdorf,628,22,606,342332,5289
DE-BE,05-05-2020,RKI,3,3,0,1588636800000,11004,Berlin Charlottenburg-Wilmersdorf,631,22,609,342332,5289
DE-BE,06-05-2020,RKI,3,3,0,1588723200000,11004,Berlin Charlottenburg-Wilmersdorf,634,22,612,342332,5289
DE-BE,07-05-2020,RKI,3,3,0,1588809600000,11004,Berlin Charlottenburg-Wilmersdorf,637,22,615,342332,5289
DE-BE,09-05-2020,RKI,4,4,0,1588982400000,11004,Berlin Charlottenburg-Wilmersdorf,641,22,619,342332,5289
DE-BE,11-05-2020,RKI,1,1,0,1589155200000,11004,Berlin Charlottenburg-Wilmersdorf,642,22,620,342332,5289
DE-BE,12-05-2020,RKI,2,2,0,1589241600000,11004,Berlin Charlottenburg-Wilmersdorf,644,22,622,342332,5289
DE-BE,13-05-2020,RKI,6,6,0,1589328000000,11004,Berlin Charlottenburg-Wilmersdorf,650,22,628,342332,5289
DE-BE,14-05-2020,RKI,2,2,0,1589414400000,11004,Berlin Charlottenburg-Wilmersdorf,652,22,630,342332,5289
DE-BE,15-05-2020,RKI,0,0,0,1589500800000,11004,Berlin Charlottenburg-Wilmersdorf,652,22,630,342332,5289
DE-BE,16-05-2020,RKI,1,1,0,1589587200000,11004,Berlin Charlottenburg-Wilmersdorf,653,22,631,342332,5289
DE-BE,19-05-2020,RKI,0,0,0,1589846400000,11004,Berlin Charlottenburg-Wilmersdorf,653,22,631,342332,5289
DE-BE,20-05-2020,RKI,5,5,0,1589932800000,11004,Berlin Charlottenburg-Wilmersdorf,658,22,636,342332,5289
DE-BE,21-05-2020,RKI,2,2,0,1590019200000,11004,Berlin Charlottenburg-Wilmersdorf,660,22,638,342332,5289
DE-BE,22-05-2020,RKI,1,1,0,1590105600000,11004,Berlin Charlottenburg-Wilmersdorf,661,22,639,342332,5289
DE-BE,23-05-2020,RKI,0,0,0,1590192000000,11004,Berlin Charlottenburg-Wilmersdorf,661,22,639,342332,5289
DE-BE,24-05-2020,RKI,0,0,0,1590278400000,11004,Berlin Charlottenburg-Wilmersdorf,661,22,639,342332,5289
DE-BE,25-05-2020,RKI,0,0,0,1590364800000,11004,Berlin Charlottenburg-Wilmersdorf,661,22,639,342332,5289
DE-BE,27-05-2020,RKI,0,0,0,1590537600000,11004,Berlin Charlottenburg-Wilmersdorf,661,22,639,342332,5289
DE-BE,28-05-2020,RKI,3,3,0,1590624000000,11004,Berlin Charlottenburg-Wilmersdorf,664,22,642,342332,5289
DE-BE,29-05-2020,RKI,0,0,0,1590710400000,11004,Berlin Charlottenburg-Wilmersdorf,664,22,642,342332,5289
DE-BE,30-05-2020,RKI,1,1,0,1590796800000,11004,Berlin Charlottenburg-Wilmersdorf,665,22,643,342332,5289
DE-BE,31-05-2020,RKI,0,0,0,1590883200000,11004,Berlin Charlottenburg-Wilmersdorf,665,22,643,342332,5289
DE-BE,03-06-2020,RKI,1,1,0,1591142400000,11004,Berlin Charlottenburg-Wilmersdorf,666,22,644,342332,5289
DE-BE,04-06-2020,RKI,3,3,0,1591228800000,11004,Berlin Charlottenburg-Wilmersdorf,669,22,647,342332,5289
DE-BE,05-06-2020,RKI,1,1,0,1591315200000,11004,Berlin Charlottenburg-Wilmersdorf,670,22,648,342332,5289
DE-BE,08-06-2020,RKI,1,1,0,1591574400000,11004,Berlin Charlottenburg-Wilmersdorf,671,22,649,342332,5289
DE-BE,09-06-2020,RKI,1,1,0,1591660800000,11004,Berlin Charlottenburg-Wilmersdorf,672,22,650,342332,5289
DE-BE,10-06-2020,RKI,1,1,0,1591747200000,11004,Berlin Charlottenburg-Wilmersdorf,673,22,651,342332,5289
DE-BE,11-06-2020,RKI,6,6,0,1591833600000,11004,Berlin Charlottenburg-Wilmersdorf,679,22,657,342332,5289
DE-BE,12-06-2020,RKI,3,3,0,1591920000000,11004,Berlin Charlottenburg-Wilmersdorf,682,22,660,342332,5289
DE-BE,13-06-2020,RKI,2,2,0,1592006400000,11004,Berlin Charlottenburg-Wilmersdorf,684,22,662,342332,5289
DE-BE,16-06-2020,RKI,6,6,0,1592265600000,11004,Berlin Charlottenburg-Wilmersdorf,690,22,668,342332,5289
DE-BE,17-06-2020,RKI,3,3,0,1592352000000,11004,Berlin Charlottenburg-Wilmersdorf,693,22,671,342332,5289
DE-BE,18-06-2020,RKI,9,9,0,1592438400000,11004,Berlin Charlottenburg-Wilmersdorf,702,22,680,342332,5289
DE-BE,19-06-2020,RKI,12,11,0,1592524800000,11004,Berlin Charlottenburg-Wilmersdorf,714,22,691,342332,5289
DE-BE,20-06-2020,RKI,2,2,0,1592611200000,11004,Berlin Charlottenburg-Wilmersdorf,716,22,693,342332,5289
DE-BE,22-06-2020,RKI,5,4,0,1592784000000,11004,Berlin Charlottenburg-Wilmersdorf,721,22,697,342332,5289
DE-BE,23-06-2020,RKI,2,2,0,1592870400000,11004,Berlin Charlottenburg-Wilmersdorf,723,22,699,342332,5289
DE-BE,24-06-2020,RKI,3,2,0,1592956800000,11004,Berlin Charlottenburg-Wilmersdorf,726,22,701,342332,5289
DE-BE,25-06-2020,RKI,3,3,0,1593043200000,11004,Berlin Charlottenburg-Wilmersdorf,729,22,704,342332,5289
DE-BE,26-06-2020,RKI,2,1,0,1593129600000,11004,Berlin Charlottenburg-Wilmersdorf,731,22,705,342332,5289
DE-BE,29-06-2020,RKI,2,2,0,1593388800000,11004,Berlin Charlottenburg-Wilmersdorf,733,22,707,342332,5289
DE-BE,30-06-2020,RKI,3,1,1,1593475200000,11004,Berlin Charlottenburg-Wilmersdorf,736,23,708,342332,5289
DE-BE,01-07-2020,RKI,2,2,0,1593561600000,11004,Berlin Charlottenburg-Wilmersdorf,738,23,710,342332,5289
DE-BE,02-07-2020,RKI,2,2,0,1593648000000,11004,Berlin Charlottenburg-Wilmersdorf,740,23,712,342332,5289
DE-BE,03-07-2020,RKI,1,1,0,1593734400000,11004,Berlin Charlottenburg-Wilmersdorf,741,23,713,342332,5289
DE-BE,04-07-2020,RKI,1,1,0,1593820800000,11004,Berlin Charlottenburg-Wilmersdorf,742,23,714,342332,5289
DE-BE,06-07-2020,RKI,1,0,0,1593993600000,11004,Berlin Charlottenburg-Wilmersdorf,743,23,714,342332,5289
DE-BE,07-07-2020,RKI,2,2,0,1594080000000,11004,Berlin Charlottenburg-Wilmersdorf,745,23,716,342332,5289
DE-BE,09-07-2020,RKI,1,0,0,1594252800000,11004,Berlin Charlottenburg-Wilmersdorf,746,23,716,342332,5289
DE-BE,10-07-2020,RKI,1,0,0,1594339200000,11004,Berlin Charlottenburg-Wilmersdorf,747,23,716,342332,5289
DE-BE,13-07-2020,RKI,0,0,0,1594598400000,11004,Berlin Charlottenburg-Wilmersdorf,747,23,716,342332,5289
DE-BE,14-07-2020,RKI,1,0,0,1594684800000,11004,Berlin Charlottenburg-Wilmersdorf,748,23,716,342332,5289
DE-BE,15-07-2020,RKI,1,0,0,1594771200000,11004,Berlin Charlottenburg-Wilmersdorf,749,23,716,342332,5289
DE-BE,16-07-2020,RKI,2,0,0,1594857600000,11004,Berlin Charlottenburg-Wilmersdorf,751,23,716,342332,5289
DE-BE,09-03-2020,RKI,2,2,0,1583712000000,11005,Berlin Spandau,3,0,3,243977,2655
DE-BE,10-03-2020,RKI,1,1,0,1583798400000,11005,Berlin Spandau,4,0,4,243977,2655
DE-BE,11-03-2020,RKI,0,0,0,1583884800000,11005,Berlin Spandau,4,0,4,243977,2655
DE-BE,13-03-2020,RKI,0,0,0,1584057600000,11005,Berlin Spandau,4,0,4,243977,2655
DE-BE,14-03-2020,RKI,0,0,0,1584144000000,11005,Berlin Spandau,4,0,4,243977,2655
DE-BE,15-03-2020,RKI,1,1,0,1584230400000,11005,Berlin Spandau,5,0,5,243977,2655
DE-BE,18-03-2020,RKI,2,2,0,1584489600000,11005,Berlin Spandau,7,0,7,243977,2655
DE-BE,19-03-2020,RKI,4,4,0,1584576000000,11005,Berlin Spandau,11,0,11,243977,2655
DE-BE,20-03-2020,RKI,7,7,0,1584662400000,11005,Berlin Spandau,18,0,18,243977,2655
DE-BE,21-03-2020,RKI,6,6,0,1584748800000,11005,Berlin Spandau,24,0,24,243977,2655
DE-BE,23-03-2020,RKI,8,7,1,1584921600000,11005,Berlin Spandau,32,1,31,243977,2655
DE-BE,24-03-2020,RKI,5,5,0,1585008000000,11005,Berlin Spandau,37,1,36,243977,2655
DE-BE,25-03-2020,RKI,8,8,0,1585094400000,11005,Berlin Spandau,45,1,44,243977,2655
DE-BE,26-03-2020,RKI,9,9,0,1585180800000,11005,Berlin Spandau,54,1,53,243977,2655
DE-BE,27-03-2020,RKI,5,4,1,1585267200000,11005,Berlin Spandau,59,2,57,243977,2655
DE-BE,28-03-2020,RKI,13,13,0,1585353600000,11005,Berlin Spandau,72,2,70,243977,2655
DE-BE,29-03-2020,RKI,4,3,1,1585440000000,11005,Berlin Spandau,76,3,73,243977,2655
DE-BE,30-03-2020,RKI,2,2,0,1585526400000,11005,Berlin Spandau,78,3,75,243977,2655
DE-BE,31-03-2020,RKI,2,1,1,1585612800000,11005,Berlin Spandau,80,4,76,243977,2655
DE-BE,01-04-2020,RKI,8,8,0,1585699200000,11005,Berlin Spandau,88,4,84,243977,2655
DE-BE,02-04-2020,RKI,8,8,0,1585785600000,11005,Berlin Spandau,96,4,92,243977,2655
DE-BE,03-04-2020,RKI,21,20,1,1585872000000,11005,Berlin Spandau,117,5,112,243977,2655
DE-BE,04-04-2020,RKI,8,8,0,1585958400000,11005,Berlin Spandau,125,5,120,243977,2655
DE-BE,05-04-2020,RKI,1,1,0,1586044800000,11005,Berlin Spandau,126,5,121,243977,2655
DE-BE,06-04-2020,RKI,3,3,0,1586131200000,11005,Berlin Spandau,129,5,124,243977,2655
DE-BE,07-04-2020,RKI,13,13,0,1586217600000,11005,Berlin Spandau,142,5,137,243977,2655
DE-BE,08-04-2020,RKI,8,8,0,1586304000000,11005,Berlin Spandau,150,5,145,243977,2655
DE-BE,09-04-2020,RKI,2,1,1,1586390400000,11005,Berlin Spandau,152,6,146,243977,2655
DE-BE,10-04-2020,RKI,0,0,0,1586476800000,11005,Berlin Spandau,152,6,146,243977,2655
DE-BE,11-04-2020,RKI,1,1,0,1586563200000,11005,Berlin Spandau,153,6,147,243977,2655
DE-BE,14-04-2020,RKI,3,3,0,1586822400000,11005,Berlin Spandau,156,6,150,243977,2655
DE-BE,15-04-2020,RKI,4,3,1,1586908800000,11005,Berlin Spandau,160,7,153,243977,2655
DE-BE,16-04-2020,RKI,7,7,0,1586995200000,11005,Berlin Spandau,167,7,160,243977,2655
DE-BE,17-04-2020,RKI,8,8,0,1587081600000,11005,Berlin Spandau,175,7,168,243977,2655
DE-BE,18-04-2020,RKI,6,6,0,1587168000000,11005,Berlin Spandau,181,7,174,243977,2655
DE-BE,19-04-2020,RKI,0,0,0,1587254400000,11005,Berlin Spandau,181,7,174,243977,2655
DE-BE,20-04-2020,RKI,2,2,0,1587340800000,11005,Berlin Spandau,183,7,176,243977,2655
DE-BE,21-04-2020,RKI,0,0,0,1587427200000,11005,Berlin Spandau,183,7,176,243977,2655
DE-BE,22-04-2020,RKI,3,3,0,1587513600000,11005,Berlin Spandau,186,7,179,243977,2655
DE-BE,23-04-2020,RKI,0,0,0,1587600000000,11005,Berlin Spandau,186,7,179,243977,2655
DE-BE,24-04-2020,RKI,0,0,0,1587686400000,11005,Berlin Spandau,186,7,179,243977,2655
DE-BE,25-04-2020,RKI,0,0,0,1587772800000,11005,Berlin Spandau,186,7,179,243977,2655
DE-BE,27-04-2020,RKI,2,2,0,1587945600000,11005,Berlin Spandau,188,7,181,243977,2655
DE-BE,28-04-2020,RKI,3,3,0,1588032000000,11005,Berlin Spandau,191,7,184,243977,2655
DE-BE,29-04-2020,RKI,1,1,0,1588118400000,11005,Berlin Spandau,192,7,185,243977,2655
DE-BE,30-04-2020,RKI,1,1,0,1588204800000,11005,Berlin Spandau,193,7,186,243977,2655
DE-BE,03-05-2020,RKI,3,2,1,1588464000000,11005,Berlin Spandau,196,8,188,243977,2655
DE-BE,05-05-2020,RKI,1,1,0,1588636800000,11005,Berlin Spandau,197,8,189,243977,2655
DE-BE,06-05-2020,RKI,4,4,0,1588723200000,11005,Berlin Spandau,201,8,193,243977,2655
DE-BE,07-05-2020,RKI,4,4,0,1588809600000,11005,Berlin Spandau,205,8,197,243977,2655
DE-BE,08-05-2020,RKI,0,0,0,1588896000000,11005,Berlin Spandau,205,8,197,243977,2655
DE-BE,10-05-2020,RKI,0,0,0,1589068800000,11005,Berlin Spandau,205,8,197,243977,2655
DE-BE,12-05-2020,RKI,1,1,0,1589241600000,11005,Berlin Spandau,206,8,198,243977,2655
DE-BE,13-05-2020,RKI,4,4,0,1589328000000,11005,Berlin Spandau,210,8,202,243977,2655
DE-BE,14-05-2020,RKI,18,18,0,1589414400000,11005,Berlin Spandau,228,8,220,243977,2655
DE-BE,15-05-2020,RKI,1,1,0,1589500800000,11005,Berlin Spandau,229,8,221,243977,2655
DE-BE,16-05-2020,RKI,1,1,0,1589587200000,11005,Berlin Spandau,230,8,222,243977,2655
DE-BE,18-05-2020,RKI,2,2,0,1589760000000,11005,Berlin Spandau,232,8,224,243977,2655
DE-BE,19-05-2020,RKI,0,0,0,1589846400000,11005,Berlin Spandau,232,8,224,243977,2655
DE-BE,20-05-2020,RKI,1,1,0,1589932800000,11005,Berlin Spandau,233,8,225,243977,2655
DE-BE,21-05-2020,RKI,2,2,0,1590019200000,11005,Berlin Spandau,235,8,227,243977,2655
DE-BE,22-05-2020,RKI,0,0,0,1590105600000,11005,Berlin Spandau,235,8,227,243977,2655
DE-BE,24-05-2020,RKI,0,0,0,1590278400000,11005,Berlin Spandau,235,8,227,243977,2655
DE-BE,26-05-2020,RKI,1,1,0,1590451200000,11005,Berlin Spandau,236,8,228,243977,2655
DE-BE,27-05-2020,RKI,1,1,0,1590537600000,11005,Berlin Spandau,237,8,229,243977,2655
DE-BE,28-05-2020,RKI,0,0,0,1590624000000,11005,Berlin Spandau,237,8,229,243977,2655
DE-BE,30-05-2020,RKI,0,0,0,1590796800000,11005,Berlin Spandau,237,8,229,243977,2655
DE-BE,31-05-2020,RKI,5,5,0,1590883200000,11005,Berlin Spandau,242,8,234,243977,2655
DE-BE,02-06-2020,RKI,3,2,1,1591056000000,11005,Berlin Spandau,245,9,236,243977,2655
DE-BE,03-06-2020,RKI,10,10,0,1591142400000,11005,Berlin Spandau,255,9,246,243977,2655
DE-BE,05-06-2020,RKI,4,4,0,1591315200000,11005,Berlin Spandau,259,9,250,243977,2655
DE-BE,06-06-2020,RKI,2,2,0,1591401600000,11005,Berlin Spandau,261,9,252,243977,2655
DE-BE,07-06-2020,RKI,0,0,0,1591488000000,11005,Berlin Spandau,261,9,252,243977,2655
DE-BE,09-06-2020,RKI,1,1,0,1591660800000,11005,Berlin Spandau,262,9,253,243977,2655
DE-BE,10-06-2020,RKI,14,14,0,1591747200000,11005,Berlin Spandau,276,9,267,243977,2655
DE-BE,11-06-2020,RKI,2,2,0,1591833600000,11005,Berlin Spandau,278,9,269,243977,2655
DE-BE,12-06-2020,RKI,5,5,0,1591920000000,11005,Berlin Spandau,283,9,274,243977,2655
DE-BE,13-06-2020,RKI,4,4,0,1592006400000,11005,Berlin Spandau,287,9,278,243977,2655
DE-BE,14-06-2020,RKI,0,0,0,1592092800000,11005,Berlin Spandau,287,9,278,243977,2655
DE-BE,16-06-2020,RKI,6,6,0,1592265600000,11005,Berlin Spandau,293,9,284,243977,2655
DE-BE,17-06-2020,RKI,0,0,0,1592352000000,11005,Berlin Spandau,293,9,284,243977,2655
DE-BE,18-06-2020,RKI,10,10,0,1592438400000,11005,Berlin Spandau,303,9,294,243977,2655
DE-BE,19-06-2020,RKI,19,19,0,1592524800000,11005,Berlin Spandau,322,9,313,243977,2655
DE-BE,20-06-2020,RKI,1,1,0,1592611200000,11005,Berlin Spandau,323,9,314,243977,2655
DE-BE,22-06-2020,RKI,7,7,0,1592784000000,11005,Berlin Spandau,330,9,321,243977,2655
DE-BE,24-06-2020,RKI,4,4,0,1592956800000,11005,Berlin Spandau,334,9,325,243977,2655
DE-BE,25-06-2020,RKI,5,5,0,1593043200000,11005,Berlin Spandau,339,9,330,243977,2655
DE-BE,26-06-2020,RKI,1,1,0,1593129600000,11005,Berlin Spandau,340,9,331,243977,2655
DE-BE,27-06-2020,RKI,4,4,0,1593216000000,11005,Berlin Spandau,344,9,335,243977,2655
DE-BE,29-06-2020,RKI,0,0,0,1593388800000,11005,Berlin Spandau,344,9,335,243977,2655
DE-BE,30-06-2020,RKI,0,0,0,1593475200000,11005,Berlin Spandau,344,9,335,243977,2655
DE-BE,01-07-2020,RKI,1,1,0,1593561600000,11005,Berlin Spandau,345,9,336,243977,2655
DE-BE,02-07-2020,RKI,2,2,0,1593648000000,11005,Berlin Spandau,347,9,338,243977,2655
DE-BE,03-07-2020,RKI,0,0,0,1593734400000,11005,Berlin Spandau,347,9,338,243977,2655
DE-BE,04-07-2020,RKI,0,0,0,1593820800000,11005,Berlin Spandau,347,9,338,243977,2655
DE-BE,06-07-2020,RKI,2,1,0,1593993600000,11005,Berlin Spandau,349,9,339,243977,2655
DE-BE,07-07-2020,RKI,0,0,0,1594080000000,11005,Berlin Spandau,349,9,339,243977,2655
DE-BE,08-07-2020,RKI,1,0,0,1594166400000,11005,Berlin Spandau,350,9,339,243977,2655
DE-BE,09-07-2020,RKI,2,1,0,1594252800000,11005,Berlin Spandau,352,9,340,243977,2655
DE-BE,10-07-2020,RKI,1,0,0,1594339200000,11005,Berlin Spandau,353,9,340,243977,2655
DE-BE,10-03-2020,RKI,3,3,0,1583798400000,11006,Berlin Steglitz-Zehlendorf,4,0,4,308697,3012
DE-BE,11-03-2020,RKI,6,6,0,1583884800000,11006,Berlin Steglitz-Zehlendorf,10,0,10,308697,3012
DE-BE,12-03-2020,RKI,5,5,0,1583971200000,11006,Berlin Steglitz-Zehlendorf,15,0,15,308697,3012
DE-BE,13-03-2020,RKI,3,3,0,1584057600000,11006,Berlin Steglitz-Zehlendorf,18,0,18,308697,3012
DE-BE,14-03-2020,RKI,5,5,0,1584144000000,11006,Berlin Steglitz-Zehlendorf,23,0,23,308697,3012
DE-BE,15-03-2020,RKI,2,2,0,1584230400000,11006,Berlin Steglitz-Zehlendorf,25,0,25,308697,3012
DE-BE,16-03-2020,RKI,5,5,0,1584316800000,11006,Berlin Steglitz-Zehlendorf,30,0,30,308697,3012
DE-BE,17-03-2020,RKI,6,6,0,1584403200000,11006,Berlin Steglitz-Zehlendorf,36,0,36,308697,3012
DE-BE,18-03-2020,RKI,9,9,0,1584489600000,11006,Berlin Steglitz-Zehlendorf,45,0,45,308697,3012
DE-BE,19-03-2020,RKI,12,12,0,1584576000000,11006,Berlin Steglitz-Zehlendorf,57,0,57,308697,3012
DE-BE,20-03-2020,RKI,11,11,0,1584662400000,11006,Berlin Steglitz-Zehlendorf,68,0,68,308697,3012
DE-BE,21-03-2020,RKI,14,14,0,1584748800000,11006,Berlin Steglitz-Zehlendorf,82,0,82,308697,3012
DE-BE,22-03-2020,RKI,2,1,1,1584835200000,11006,Berlin Steglitz-Zehlendorf,84,1,83,308697,3012
DE-BE,23-03-2020,RKI,6,6,0,1584921600000,11006,Berlin Steglitz-Zehlendorf,90,1,89,308697,3012
DE-BE,24-03-2020,RKI,8,8,0,1585008000000,11006,Berlin Steglitz-Zehlendorf,98,1,97,308697,3012
DE-BE,25-03-2020,RKI,7,7,0,1585094400000,11006,Berlin Steglitz-Zehlendorf,105,1,104,308697,3012
DE-BE,26-03-2020,RKI,18,18,0,1585180800000,11006,Berlin Steglitz-Zehlendorf,123,1,122,308697,3012
DE-BE,27-03-2020,RKI,5,5,0,1585267200000,11006,Berlin Steglitz-Zehlendorf,128,1,127,308697,3012
DE-BE,28-03-2020,RKI,39,39,0,1585353600000,11006,Berlin Steglitz-Zehlendorf,167,1,166,308697,3012
DE-BE,29-03-2020,RKI,11,11,0,1585440000000,11006,Berlin Steglitz-Zehlendorf,178,1,177,308697,3012
DE-BE,30-03-2020,RKI,8,8,0,1585526400000,11006,Berlin Steglitz-Zehlendorf,186,1,185,308697,3012
DE-BE,31-03-2020,RKI,27,27,0,1585612800000,11006,Berlin Steglitz-Zehlendorf,213,1,212,308697,3012
DE-BE,01-04-2020,RKI,23,23,0,1585699200000,11006,Berlin Steglitz-Zehlendorf,236,1,235,308697,3012
DE-BE,02-04-2020,RKI,20,19,1,1585785600000,11006,Berlin Steglitz-Zehlendorf,256,2,254,308697,3012
DE-BE,03-04-2020,RKI,18,18,0,1585872000000,11006,Berlin Steglitz-Zehlendorf,274,2,272,308697,3012
DE-BE,04-04-2020,RKI,11,11,0,1585958400000,11006,Berlin Steglitz-Zehlendorf,285,2,283,308697,3012
DE-BE,05-04-2020,RKI,3,3,0,1586044800000,11006,Berlin Steglitz-Zehlendorf,288,2,286,308697,3012
DE-BE,06-04-2020,RKI,11,10,1,1586131200000,11006,Berlin Steglitz-Zehlendorf,299,3,296,308697,3012
DE-BE,07-04-2020,RKI,16,16,0,1586217600000,11006,Berlin Steglitz-Zehlendorf,315,3,312,308697,3012
DE-BE,08-04-2020,RKI,16,15,1,1586304000000,11006,Berlin Steglitz-Zehlendorf,331,4,327,308697,3012
DE-BE,09-04-2020,RKI,12,11,1,1586390400000,11006,Berlin Steglitz-Zehlendorf,343,5,338,308697,3012
DE-BE,10-04-2020,RKI,8,7,1,1586476800000,11006,Berlin Steglitz-Zehlendorf,351,6,345,308697,3012
DE-BE,11-04-2020,RKI,13,13,0,1586563200000,11006,Berlin Steglitz-Zehlendorf,364,6,358,308697,3012
DE-BE,12-04-2020,RKI,4,4,0,1586649600000,11006,Berlin Steglitz-Zehlendorf,368,6,362,308697,3012
DE-BE,13-04-2020,RKI,7,7,0,1586736000000,11006,Berlin Steglitz-Zehlendorf,375,6,369,308697,3012
DE-BE,14-04-2020,RKI,4,4,0,1586822400000,11006,Berlin Steglitz-Zehlendorf,379,6,373,308697,3012
DE-BE,15-04-2020,RKI,4,4,0,1586908800000,11006,Berlin Steglitz-Zehlendorf,383,6,377,308697,3012
DE-BE,16-04-2020,RKI,2,2,0,1586995200000,11006,Berlin Steglitz-Zehlendorf,385,6,379,308697,3012
DE-BE,17-04-2020,RKI,12,12,0,1587081600000,11006,Berlin Steglitz-Zehlendorf,397,6,391,308697,3012
DE-BE,18-04-2020,RKI,3,3,0,1587168000000,11006,Berlin Steglitz-Zehlendorf,400,6,394,308697,3012
DE-BE,19-04-2020,RKI,3,2,1,1587254400000,11006,Berlin Steglitz-Zehlendorf,403,7,396,308697,3012
DE-BE,21-04-2020,RKI,2,2,0,1587427200000,11006,Berlin Steglitz-Zehlendorf,405,7,398,308697,3012
DE-BE,22-04-2020,RKI,5,5,0,1587513600000,11006,Berlin Steglitz-Zehlendorf,410,7,403,308697,3012
DE-BE,23-04-2020,RKI,4,4,0,1587600000000,11006,Berlin Steglitz-Zehlendorf,414,7,407,308697,3012
DE-BE,24-04-2020,RKI,0,0,0,1587686400000,11006,Berlin Steglitz-Zehlendorf,414,7,407,308697,3012
DE-BE,25-04-2020,RKI,1,1,0,1587772800000,11006,Berlin Steglitz-Zehlendorf,415,7,408,308697,3012
DE-BE,26-04-2020,RKI,0,0,0,1587859200000,11006,Berlin Steglitz-Zehlendorf,415,7,408,308697,3012
DE-BE,27-04-2020,RKI,5,0,5,1587945600000,11006,Berlin Steglitz-Zehlendorf,420,12,408,308697,3012
DE-BE,28-04-2020,RKI,11,11,0,1588032000000,11006,Berlin Steglitz-Zehlendorf,431,12,419,308697,3012
DE-BE,29-04-2020,RKI,3,3,0,1588118400000,11006,Berlin Steglitz-Zehlendorf,434,12,422,308697,3012
DE-BE,30-04-2020,RKI,0,0,0,1588204800000,11006,Berlin Steglitz-Zehlendorf,434,12,422,308697,3012
DE-BE,01-05-2020,RKI,1,1,0,1588291200000,11006,Berlin Steglitz-Zehlendorf,435,12,423,308697,3012
DE-BE,02-05-2020,RKI,1,1,0,1588377600000,11006,Berlin Steglitz-Zehlendorf,436,12,424,308697,3012
DE-BE,03-05-2020,RKI,3,3,0,1588464000000,11006,Berlin Steglitz-Zehlendorf,439,12,427,308697,3012
DE-BE,04-05-2020,RKI,7,7,0,1588550400000,11006,Berlin Steglitz-Zehlendorf,446,12,434,308697,3012
DE-BE,05-05-2020,RKI,1,1,0,1588636800000,11006,Berlin Steglitz-Zehlendorf,447,12,435,308697,3012
DE-BE,06-05-2020,RKI,0,0,0,1588723200000,11006,Berlin Steglitz-Zehlendorf,447,12,435,308697,3012
DE-BE,07-05-2020,RKI,8,8,0,1588809600000,11006,Berlin Steglitz-Zehlendorf,455,12,443,308697,3012
DE-BE,10-05-2020,RKI,0,0,0,1589068800000,11006,Berlin Steglitz-Zehlendorf,455,12,443,308697,3012
DE-BE,11-05-2020,RKI,0,0,0,1589155200000,11006,Berlin Steglitz-Zehlendorf,455,12,443,308697,3012
DE-BE,13-05-2020,RKI,3,3,0,1589328000000,11006,Berlin Steglitz-Zehlendorf,458,12,446,308697,3012
DE-BE,14-05-2020,RKI,1,1,0,1589414400000,11006,Berlin Steglitz-Zehlendorf,459,12,447,308697,3012
DE-BE,15-05-2020,RKI,0,0,0,1589500800000,11006,Berlin Steglitz-Zehlendorf,459,12,447,308697,3012
DE-BE,16-05-2020,RKI,1,1,0,1589587200000,11006,Berlin Steglitz-Zehlendorf,460,12,448,308697,3012
DE-BE,18-05-2020,RKI,2,2,0,1589760000000,11006,Berlin Steglitz-Zehlendorf,462,12,450,308697,3012
DE-BE,19-05-2020,RKI,1,1,0,1589846400000,11006,Berlin Steglitz-Zehlendorf,463,12,451,308697,3012
DE-BE,20-05-2020,RKI,3,3,0,1589932800000,11006,Berlin Steglitz-Zehlendorf,466,12,454,308697,3012
DE-BE,22-05-2020,RKI,0,0,0,1590105600000,11006,Berlin Steglitz-Zehlendorf,466,12,454,308697,3012
DE-BE,23-05-2020,RKI,0,0,0,1590192000000,11006,Berlin Steglitz-Zehlendorf,466,12,454,308697,3012
DE-BE,25-05-2020,RKI,5,5,0,1590364800000,11006,Berlin Steglitz-Zehlendorf,471,12,459,308697,3012
DE-BE,27-05-2020,RKI,0,0,0,1590537600000,11006,Berlin Steglitz-Zehlendorf,471,12,459,308697,3012
DE-BE,29-05-2020,RKI,1,1,0,1590710400000,11006,Berlin Steglitz-Zehlendorf,472,12,460,308697,3012
DE-BE,31-05-2020,RKI,1,1,0,1590883200000,11006,Berlin Steglitz-Zehlendorf,473,12,461,308697,3012
DE-BE,03-06-2020,RKI,6,6,0,1591142400000,11006,Berlin Steglitz-Zehlendorf,479,12,467,308697,3012
DE-BE,06-06-2020,RKI,1,1,0,1591401600000,11006,Berlin Steglitz-Zehlendorf,480,12,468,308697,3012
DE-BE,08-06-2020,RKI,1,1,0,1591574400000,11006,Berlin Steglitz-Zehlendorf,481,12,469,308697,3012
DE-BE,09-06-2020,RKI,0,0,0,1591660800000,11006,Berlin Steglitz-Zehlendorf,481,12,469,308697,3012
DE-BE,11-06-2020,RKI,1,1,0,1591833600000,11006,Berlin Steglitz-Zehlendorf,482,12,470,308697,3012
DE-BE,12-06-2020,RKI,1,1,0,1591920000000,11006,Berlin Steglitz-Zehlendorf,483,12,471,308697,3012
DE-BE,13-06-2020,RKI,1,1,0,1592006400000,11006,Berlin Steglitz-Zehlendorf,484,12,472,308697,3012
DE-BE,15-06-2020,RKI,0,0,0,1592179200000,11006,Berlin Steglitz-Zehlendorf,484,12,472,308697,3012
DE-BE,18-06-2020,RKI,2,2,0,1592438400000,11006,Berlin Steglitz-Zehlendorf,486,12,474,308697,3012
DE-BE,19-06-2020,RKI,0,0,0,1592524800000,11006,Berlin Steglitz-Zehlendorf,486,12,474,308697,3012
DE-BE,20-06-2020,RKI,1,1,0,1592611200000,11006,Berlin Steglitz-Zehlendorf,487,12,475,308697,3012
DE-BE,22-06-2020,RKI,1,1,0,1592784000000,11006,Berlin Steglitz-Zehlendorf,488,12,476,308697,3012
DE-BE,23-06-2020,RKI,3,3,0,1592870400000,11006,Berlin Steglitz-Zehlendorf,491,12,479,308697,3012
DE-BE,25-06-2020,RKI,1,1,0,1593043200000,11006,Berlin Steglitz-Zehlendorf,492,12,480,308697,3012
DE-BE,26-06-2020,RKI,5,4,0,1593129600000,11006,Berlin Steglitz-Zehlendorf,497,12,484,308697,3012
DE-BE,30-06-2020,RKI,0,0,0,1593475200000,11006,Berlin Steglitz-Zehlendorf,497,12,484,308697,3012
DE-BE,01-07-2020,RKI,0,0,0,1593561600000,11006,Berlin Steglitz-Zehlendorf,497,12,484,308697,3012
DE-BE,02-07-2020,RKI,1,1,0,1593648000000,11006,Berlin Steglitz-Zehlendorf,498,12,485,308697,3012
DE-BE,04-07-2020,RKI,0,0,0,1593820800000,11006,Berlin Steglitz-Zehlendorf,498,12,485,308697,3012
DE-BE,06-07-2020,RKI,1,1,0,1593993600000,11006,Berlin Steglitz-Zehlendorf,499,12,486,308697,3012
DE-BE,07-07-2020,RKI,1,1,0,1594080000000,11006,Berlin Steglitz-Zehlendorf,500,12,487,308697,3012
DE-BE,08-07-2020,RKI,0,0,0,1594166400000,11006,Berlin Steglitz-Zehlendorf,500,12,487,308697,3012
DE-BE,09-07-2020,RKI,1,0,0,1594252800000,11006,Berlin Steglitz-Zehlendorf,501,12,487,308697,3012
DE-BE,10-07-2020,RKI,3,1,0,1594339200000,11006,Berlin Steglitz-Zehlendorf,504,12,488,308697,3012
DE-BE,13-07-2020,RKI,0,0,0,1594598400000,11006,Berlin Steglitz-Zehlendorf,504,12,488,308697,3012
DE-BE,14-07-2020,RKI,0,0,0,1594684800000,11006,Berlin Steglitz-Zehlendorf,504,12,488,308697,3012
DE-BE,15-07-2020,RKI,1,0,0,1594771200000,11006,Berlin Steglitz-Zehlendorf,505,12,488,308697,3012
DE-BE,16-07-2020,RKI,1,0,0,1594857600000,11006,Berlin Steglitz-Zehlendorf,506,12,488,308697,3012
DE-BE,06-03-2020,RKI,0,0,0,1583452800000,11007,Berlin Tempelhof-Schöneberg,0,0,0,351644,6624
DE-BE,09-03-2020,RKI,2,2,0,1583712000000,11007,Berlin Tempelhof-Schöneberg,2,0,2,351644,6624
DE-BE,10-03-2020,RKI,4,4,0,1583798400000,11007,Berlin Tempelhof-Schöneberg,6,0,6,351644,6624
DE-BE,11-03-2020,RKI,0,0,0,1583884800000,11007,Berlin Tempelhof-Schöneberg,6,0,6,351644,6624
DE-BE,12-03-2020,RKI,4,4,0,1583971200000,11007,Berlin Tempelhof-Schöneberg,10,0,10,351644,6624
DE-BE,13-03-2020,RKI,6,6,0,1584057600000,11007,Berlin Tempelhof-Schöneberg,16,0,16,351644,6624
DE-BE,14-03-2020,RKI,1,1,0,1584144000000,11007,Berlin Tempelhof-Schöneberg,17,0,17,351644,6624
DE-BE,15-03-2020,RKI,0,0,0,1584230400000,11007,Berlin Tempelhof-Schöneberg,17,0,17,351644,6624
DE-BE,16-03-2020,RKI,5,5,0,1584316800000,11007,Berlin Tempelhof-Schöneberg,22,0,22,351644,6624
DE-BE,17-03-2020,RKI,10,10,0,1584403200000,11007,Berlin Tempelhof-Schöneberg,32,0,32,351644,6624
DE-BE,18-03-2020,RKI,25,25,0,1584489600000,11007,Berlin Tempelhof-Schöneberg,57,0,57,351644,6624
DE-BE,19-03-2020,RKI,14,14,0,1584576000000,11007,Berlin Tempelhof-Schöneberg,71,0,71,351644,6624
DE-BE,20-03-2020,RKI,15,15,0,1584662400000,11007,Berlin Tempelhof-Schöneberg,86,0,86,351644,6624
DE-BE,21-03-2020,RKI,14,14,0,1584748800000,11007,Berlin Tempelhof-Schöneberg,100,0,100,351644,6624
DE-BE,22-03-2020,RKI,1,1,0,1584835200000,11007,Berlin Tempelhof-Schöneberg,101,0,101,351644,6624
DE-BE,23-03-2020,RKI,11,11,0,1584921600000,11007,Berlin Tempelhof-Schöneberg,112,0,112,351644,6624
DE-BE,24-03-2020,RKI,29,28,1,1585008000000,11007,Berlin Tempelhof-Schöneberg,141,1,140,351644,6624
DE-BE,25-03-2020,RKI,29,28,1,1585094400000,11007,Berlin Tempelhof-Schöneberg,170,2,168,351644,6624
DE-BE,26-03-2020,RKI,26,25,1,1585180800000,11007,Berlin Tempelhof-Schöneberg,196,3,193,351644,6624
DE-BE,27-03-2020,RKI,22,21,1,1585267200000,11007,Berlin Tempelhof-Schöneberg,218,4,214,351644,6624
DE-BE,28-03-2020,RKI,9,7,2,1585353600000,11007,Berlin Tempelhof-Schöneberg,227,6,221,351644,6624
DE-BE,29-03-2020,RKI,9,8,1,1585440000000,11007,Berlin Tempelhof-Schöneberg,236,7,229,351644,6624
DE-BE,30-03-2020,RKI,19,19,0,1585526400000,11007,Berlin Tempelhof-Schöneberg,255,7,248,351644,6624
DE-BE,31-03-2020,RKI,23,23,0,1585612800000,11007,Berlin Tempelhof-Schöneberg,278,7,271,351644,6624
DE-BE,01-04-2020,RKI,13,12,1,1585699200000,11007,Berlin Tempelhof-Schöneberg,291,8,283,351644,6624
DE-BE,02-04-2020,RKI,18,18,0,1585785600000,11007,Berlin Tempelhof-Schöneberg,309,8,301,351644,6624
DE-BE,03-04-2020,RKI,30,26,4,1585872000000,11007,Berlin Tempelhof-Schöneberg,339,12,327,351644,6624
DE-BE,04-04-2020,RKI,21,20,1,1585958400000,11007,Berlin Tempelhof-Schöneberg,360,13,347,351644,6624
DE-BE,05-04-2020,RKI,9,9,0,1586044800000,11007,Berlin Tempelhof-Schöneberg,369,13,356,351644,6624
DE-BE,06-04-2020,RKI,8,7,1,1586131200000,11007,Berlin Tempelhof-Schöneberg,377,14,363,351644,6624
DE-BE,07-04-2020,RKI,17,14,3,1586217600000,11007,Berlin Tempelhof-Schöneberg,394,17,377,351644,6624
DE-BE,08-04-2020,RKI,18,18,0,1586304000000,11007,Berlin Tempelhof-Schöneberg,412,17,395,351644,6624
DE-BE,09-04-2020,RKI,17,15,2,1586390400000,11007,Berlin Tempelhof-Schöneberg,429,19,410,351644,6624
DE-BE,10-04-2020,RKI,10,10,0,1586476800000,11007,Berlin Tempelhof-Schöneberg,439,19,420,351644,6624
DE-BE,11-04-2020,RKI,1,1,0,1586563200000,11007,Berlin Tempelhof-Schöneberg,440,19,421,351644,6624
DE-BE,12-04-2020,RKI,4,4,0,1586649600000,11007,Berlin Tempelhof-Schöneberg,444,19,425,351644,6624
DE-BE,13-04-2020,RKI,1,1,0,1586736000000,11007,Berlin Tempelhof-Schöneberg,445,19,426,351644,6624
DE-BE,14-04-2020,RKI,5,5,0,1586822400000,11007,Berlin Tempelhof-Schöneberg,450,19,431,351644,6624
DE-BE,15-04-2020,RKI,15,15,0,1586908800000,11007,Berlin Tempelhof-Schöneberg,465,19,446,351644,6624
DE-BE,16-04-2020,RKI,7,7,0,1586995200000,11007,Berlin Tempelhof-Schöneberg,472,19,453,351644,6624
DE-BE,17-04-2020,RKI,7,7,0,1587081600000,11007,Berlin Tempelhof-Schöneberg,479,19,460,351644,6624
DE-BE,18-04-2020,RKI,8,6,2,1587168000000,11007,Berlin Tempelhof-Schöneberg,487,21,466,351644,6624
DE-BE,19-04-2020,RKI,2,2,0,1587254400000,11007,Berlin Tempelhof-Schöneberg,489,21,468,351644,6624
DE-BE,20-04-2020,RKI,5,4,1,1587340800000,11007,Berlin Tempelhof-Schöneberg,494,22,472,351644,6624
DE-BE,21-04-2020,RKI,0,0,0,1587427200000,11007,Berlin Tempelhof-Schöneberg,494,22,472,351644,6624
DE-BE,22-04-2020,RKI,11,11,0,1587513600000,11007,Berlin Tempelhof-Schöneberg,505,22,483,351644,6624
DE-BE,23-04-2020,RKI,10,10,0,1587600000000,11007,Berlin Tempelhof-Schöneberg,515,22,493,351644,6624
DE-BE,24-04-2020,RKI,6,6,0,1587686400000,11007,Berlin Tempelhof-Schöneberg,521,22,499,351644,6624
DE-BE,26-04-2020,RKI,0,0,0,1587859200000,11007,Berlin Tempelhof-Schöneberg,521,22,499,351644,6624
DE-BE,27-04-2020,RKI,1,1,0,1587945600000,11007,Berlin Tempelhof-Schöneberg,522,22,500,351644,6624
DE-BE,28-04-2020,RKI,10,8,2,1588032000000,11007,Berlin Tempelhof-Schöneberg,532,24,508,351644,6624
DE-BE,29-04-2020,RKI,4,4,0,1588118400000,11007,Berlin Tempelhof-Schöneberg,536,24,512,351644,6624
DE-BE,30-04-2020,RKI,2,2,0,1588204800000,11007,Berlin Tempelhof-Schöneberg,538,24,514,351644,6624
DE-BE,01-05-2020,RKI,5,5,0,1588291200000,11007,Berlin Tempelhof-Schöneberg,543,24,519,351644,6624
DE-BE,03-05-2020,RKI,7,7,0,1588464000000,11007,Berlin Tempelhof-Schöneberg,550,24,526,351644,6624
DE-BE,04-05-2020,RKI,5,5,0,1588550400000,11007,Berlin Tempelhof-Schöneberg,555,24,531,351644,6624
DE-BE,05-05-2020,RKI,3,3,0,1588636800000,11007,Berlin Tempelhof-Schöneberg,558,24,534,351644,6624
DE-BE,06-05-2020,RKI,6,6,0,1588723200000,11007,Berlin Tempelhof-Schöneberg,564,24,540,351644,6624
DE-BE,07-05-2020,RKI,4,4,0,1588809600000,11007,Berlin Tempelhof-Schöneberg,568,24,544,351644,6624
DE-BE,08-05-2020,RKI,2,2,0,1588896000000,11007,Berlin Tempelhof-Schöneberg,570,24,546,351644,6624
DE-BE,09-05-2020,RKI,2,2,0,1588982400000,11007,Berlin Tempelhof-Schöneberg,572,24,548,351644,6624
DE-BE,10-05-2020,RKI,0,0,0,1589068800000,11007,Berlin Tempelhof-Schöneberg,572,24,548,351644,6624
DE-BE,11-05-2020,RKI,2,2,0,1589155200000,11007,Berlin Tempelhof-Schöneberg,574,24,550,351644,6624
DE-BE,13-05-2020,RKI,9,9,0,1589328000000,11007,Berlin Tempelhof-Schöneberg,583,24,559,351644,6624
DE-BE,14-05-2020,RKI,1,1,0,1589414400000,11007,Berlin Tempelhof-Schöneberg,584,24,560,351644,6624
DE-BE,15-05-2020,RKI,0,0,0,1589500800000,11007,Berlin Tempelhof-Schöneberg,584,24,560,351644,6624
DE-BE,17-05-2020,RKI,1,1,0,1589673600000,11007,Berlin Tempelhof-Schöneberg,585,24,561,351644,6624
DE-BE,19-05-2020,RKI,0,0,0,1589846400000,11007,Berlin Tempelhof-Schöneberg,585,24,561,351644,6624
DE-BE,20-05-2020,RKI,2,2,0,1589932800000,11007,Berlin Tempelhof-Schöneberg,587,24,563,351644,6624
DE-BE,21-05-2020,RKI,0,0,0,1590019200000,11007,Berlin Tempelhof-Schöneberg,587,24,563,351644,6624
DE-BE,22-05-2020,RKI,1,1,0,1590105600000,11007,Berlin Tempelhof-Schöneberg,588,24,564,351644,6624
DE-BE,23-05-2020,RKI,0,0,0,1590192000000,11007,Berlin Tempelhof-Schöneberg,588,24,564,351644,6624
DE-BE,26-05-2020,RKI,1,1,0,1590451200000,11007,Berlin Tempelhof-Schöneberg,589,24,565,351644,6624
DE-BE,27-05-2020,RKI,3,3,0,1590537600000,11007,Berlin Tempelhof-Schöneberg,592,24,568,351644,6624
DE-BE,28-05-2020,RKI,4,4,0,1590624000000,11007,Berlin Tempelhof-Schöneberg,596,24,572,351644,6624
DE-BE,30-05-2020,RKI,0,0,0,1590796800000,11007,Berlin Tempelhof-Schöneberg,596,24,572,351644,6624
DE-BE,02-06-2020,RKI,7,7,0,1591056000000,11007,Berlin Tempelhof-Schöneberg,603,24,579,351644,6624
DE-BE,04-06-2020,RKI,0,0,0,1591228800000,11007,Berlin Tempelhof-Schöneberg,603,24,579,351644,6624
DE-BE,05-06-2020,RKI,0,0,0,1591315200000,11007,Berlin Tempelhof-Schöneberg,603,24,579,351644,6624
DE-BE,06-06-2020,RKI,1,1,0,1591401600000,11007,Berlin Tempelhof-Schöneberg,604,24,580,351644,6624
DE-BE,09-06-2020,RKI,14,14,0,1591660800000,11007,Berlin Tempelhof-Schöneberg,618,24,594,351644,6624
DE-BE,10-06-2020,RKI,3,2,1,1591747200000,11007,Berlin Tempelhof-Schöneberg,621,25,596,351644,6624
DE-BE,11-06-2020,RKI,2,2,0,1591833600000,11007,Berlin Tempelhof-Schöneberg,623,25,598,351644,6624
DE-BE,13-06-2020,RKI,4,4,0,1592006400000,11007,Berlin Tempelhof-Schöneberg,627,25,602,351644,6624
DE-BE,16-06-2020,RKI,0,0,0,1592265600000,11007,Berlin Tempelhof-Schöneberg,627,25,602,351644,6624
DE-BE,17-06-2020,RKI,4,4,0,1592352000000,11007,Berlin Tempelhof-Schöneberg,631,25,606,351644,6624
DE-BE,18-06-2020,RKI,15,15,0,1592438400000,11007,Berlin Tempelhof-Schöneberg,646,25,621,351644,6624
DE-BE,19-06-2020,RKI,7,7,0,1592524800000,11007,Berlin Tempelhof-Schöneberg,653,25,628,351644,6624
DE-BE,20-06-2020,RKI,3,3,0,1592611200000,11007,Berlin Tempelhof-Schöneberg,656,25,631,351644,6624
DE-BE,21-06-2020,RKI,2,2,0,1592697600000,11007,Berlin Tempelhof-Schöneberg,658,25,633,351644,6624
DE-BE,22-06-2020,RKI,4,4,0,1592784000000,11007,Berlin Tempelhof-Schöneberg,662,25,637,351644,6624
DE-BE,23-06-2020,RKI,10,9,0,1592870400000,11007,Berlin Tempelhof-Schöneberg,672,25,646,351644,6624
DE-BE,24-06-2020,RKI,3,3,0,1592956800000,11007,Berlin Tempelhof-Schöneberg,675,25,649,351644,6624
DE-BE,25-06-2020,RKI,8,7,0,1593043200000,11007,Berlin Tempelhof-Schöneberg,683,25,656,351644,6624
DE-BE,26-06-2020,RKI,0,0,0,1593129600000,11007,Berlin Tempelhof-Schöneberg,683,25,656,351644,6624
DE-BE,27-06-2020,RKI,1,1,0,1593216000000,11007,Berlin Tempelhof-Schöneberg,684,25,657,351644,6624
DE-BE,29-06-2020,RKI,0,0,0,1593388800000,11007,Berlin Tempelhof-Schöneberg,684,25,657,351644,6624
DE-BE,30-06-2020,RKI,2,1,0,1593475200000,11007,Berlin Tempelhof-Schöneberg,686,25,658,351644,6624
DE-BE,01-07-2020,RKI,0,0,0,1593561600000,11007,Berlin Tempelhof-Schöneberg,686,25,658,351644,6624
DE-BE,02-07-2020,RKI,1,0,0,1593648000000,11007,Berlin Tempelhof-Schöneberg,687,25,658,351644,6624
DE-BE,03-07-2020,RKI,4,4,0,1593734400000,11007,Berlin Tempelhof-Schöneberg,691,25,662,351644,6624
DE-BE,04-07-2020,RKI,10,6,0,1593820800000,11007,Berlin Tempelhof-Schöneberg,701,25,668,351644,6624
DE-BE,05-07-2020,RKI,0,0,0,1593907200000,11007,Berlin Tempelhof-Schöneberg,701,25,668,351644,6624
DE-BE,06-07-2020,RKI,0,0,0,1593993600000,11007,Berlin Tempelhof-Schöneberg,701,25,668,351644,6624
DE-BE,07-07-2020,RKI,1,0,0,1594080000000,11007,Berlin Tempelhof-Schöneberg,702,25,668,351644,6624
DE-BE,08-07-2020,RKI,2,1,0,1594166400000,11007,Berlin Tempelhof-Schöneberg,704,25,669,351644,6624
DE-BE,09-07-2020,RKI,1,0,0,1594252800000,11007,Berlin Tempelhof-Schöneberg,705,25,669,351644,6624
DE-BE,11-07-2020,RKI,0,0,0,1594425600000,11007,Berlin Tempelhof-Schöneberg,705,25,669,351644,6624
DE-BE,12-07-2020,RKI,0,0,0,1594512000000,11007,Berlin Tempelhof-Schöneberg,705,25,669,351644,6624
DE-BE,13-07-2020,RKI,0,0,0,1594598400000,11007,Berlin Tempelhof-Schöneberg,705,25,669,351644,6624
DE-BE,14-07-2020,RKI,4,0,0,1594684800000,11007,Berlin Tempelhof-Schöneberg,709,25,669,351644,6624
DE-BE,15-07-2020,RKI,4,0,0,1594771200000,11007,Berlin Tempelhof-Schöneberg,713,25,669,351644,6624
DE-BE,16-07-2020,RKI,0,0,0,1594857600000,11007,Berlin Tempelhof-Schöneberg,713,25,669,351644,6624
DE-BE,14-03-2020,RKI,0,0,0,1584144000000,11008,Berlin Neukölln,0,0,0,329691,7338
DE-BE,24-03-2020,RKI,0,0,0,1585008000000,11008,Berlin Neukölln,0,0,0,329691,7338
DE-BE,26-03-2020,RKI,0,0,0,1585180800000,11008,Berlin Neukölln,0,0,0,329691,7338
DE-BE,27-03-2020,RKI,0,0,0,1585267200000,11008,Berlin Neukölln,0,0,0,329691,7338
DE-BE,28-03-2020,RKI,1,1,0,1585353600000,11008,Berlin Neukölln,1,0,1,329691,7338
DE-BE,31-03-2020,RKI,0,0,0,1585612800000,11008,Berlin Neukölln,1,0,1,329691,7338
DE-BE,01-04-2020,RKI,1,1,0,1585699200000,11008,Berlin Neukölln,2,0,2,329691,7338
DE-BE,02-04-2020,RKI,2,2,0,1585785600000,11008,Berlin Neukölln,4,0,4,329691,7338
DE-BE,03-04-2020,RKI,0,0,0,1585872000000,11008,Berlin Neukölln,4,0,4,329691,7338
DE-BE,07-04-2020,RKI,0,0,0,1586217600000,11008,Berlin Neukölln,4,0,4,329691,7338
DE-BE,09-04-2020,RKI,0,0,0,1586390400000,11008,Berlin Neukölln,4,0,4,329691,7338
DE-BE,10-04-2020,RKI,0,0,0,1586476800000,11008,Berlin Neukölln,4,0,4,329691,7338
DE-BE,14-04-2020,RKI,0,0,0,1586822400000,11008,Berlin Neukölln,4,0,4,329691,7338
DE-BE,15-04-2020,RKI,0,0,0,1586908800000,11008,Berlin Neukölln,4,0,4,329691,7338
DE-BE,29-04-2020,RKI,0,0,0,1588118400000,11008,Berlin Neukölln,4,0,4,329691,7338
DE-BE,30-04-2020,RKI,0,0,0,1588204800000,11008,Berlin Neukölln,4,0,4,329691,7338
DE-BE,12-05-2020,RKI,1,1,0,1589241600000,11008,Berlin Neukölln,5,0,5,329691,7338
DE-BE,14-05-2020,RKI,0,0,0,1589414400000,11008,Berlin Neukölln,5,0,5,329691,7338
DE-BE,25-05-2020,RKI,0,0,0,1590364800000,11008,Berlin Neukölln,5,0,5,329691,7338
DE-BE,28-05-2020,RKI,0,0,0,1590624000000,11008,Berlin Neukölln,5,0,5,329691,7338
DE-BE,04-06-2020,RKI,2,2,0,1591228800000,11008,Berlin Neukölln,7,0,7,329691,7338
DE-BE,05-06-2020,RKI,0,0,0,1591315200000,11008,Berlin Neukölln,7,0,7,329691,7338
DE-BE,07-06-2020,RKI,0,0,0,1591488000000,11008,Berlin Neukölln,7,0,7,329691,7338
DE-BE,08-06-2020,RKI,0,0,0,1591574400000,11008,Berlin Neukölln,7,0,7,329691,7338
DE-BE,09-06-2020,RKI,0,0,0,1591660800000,11008,Berlin Neukölln,7,0,7,329691,7338
DE-BE,10-06-2020,RKI,4,4,0,1591747200000,11008,Berlin Neukölln,11,0,11,329691,7338
DE-BE,11-06-2020,RKI,0,0,0,1591833600000,11008,Berlin Neukölln,11,0,11,329691,7338
DE-BE,12-06-2020,RKI,0,0,0,1591920000000,11008,Berlin Neukölln,11,0,11,329691,7338
DE-BE,13-06-2020,RKI,0,0,0,1592006400000,11008,Berlin Neukölln,11,0,11,329691,7338
DE-BE,16-06-2020,RKI,5,5,0,1592265600000,11008,Berlin Neukölln,16,0,16,329691,7338
DE-BE,17-06-2020,RKI,4,4,0,1592352000000,11008,Berlin Neukölln,20,0,20,329691,7338
DE-BE,18-06-2020,RKI,1,1,0,1592438400000,11008,Berlin Neukölln,21,0,21,329691,7338
DE-BE,23-06-2020,RKI,0,0,0,1592870400000,11008,Berlin Neukölln,21,0,21,329691,7338
DE-BE,24-06-2020,RKI,0,0,0,1592956800000,11008,Berlin Neukölln,21,0,21,329691,7338
DE-BE,25-06-2020,RKI,0,0,0,1593043200000,11008,Berlin Neukölln,21,0,21,329691,7338
DE-BE,29-06-2020,RKI,0,0,0,1593388800000,11008,Berlin Neukölln,21,0,21,329691,7338
DE-BE,30-06-2020,RKI,1,1,0,1593475200000,11008,Berlin Neukölln,22,0,22,329691,7338
DE-BB,17-03-2020,RKI,0,0,0,1584403200000,12051,Brandenburg an der Havel,1,0,1,72124,314
DE-BB,19-03-2020,RKI,1,1,0,1584576000000,12051,Brandenburg an der Havel,2,0,2,72124,314
DE-BB,20-03-2020,RKI,0,0,0,1584662400000,12051,Brandenburg an der Havel,2,0,2,72124,314
DE-BB,22-03-2020,RKI,1,1,0,1584835200000,12051,Brandenburg an der Havel,3,0,3,72124,314
DE-BB,23-03-2020,RKI,2,2,0,1584921600000,12051,Brandenburg an der Havel,5,0,5,72124,314
DE-BB,24-03-2020,RKI,0,0,0,1585008000000,12051,Brandenburg an der Havel,5,0,5,72124,314
DE-BB,26-03-2020,RKI,1,1,0,1585180800000,12051,Brandenburg an der Havel,6,0,6,72124,314
DE-BB,28-03-2020,RKI,0,0,0,1585353600000,12051,Brandenburg an der Havel,6,0,6,72124,314
DE-BB,29-03-2020,RKI,0,0,0,1585440000000,12051,Brandenburg an der Havel,6,0,6,72124,314
DE-BB,30-03-2020,RKI,0,0,0,1585526400000,12051,Brandenburg an der Havel,6,0,6,72124,314
DE-BB,31-03-2020,RKI,6,6,0,1585612800000,12051,Brandenburg an der Havel,12,0,12,72124,314
DE-BB,01-04-2020,RKI,2,2,0,1585699200000,12051,Brandenburg an der Havel,14,0,14,72124,314
DE-BB,02-04-2020,RKI,0,0,0,1585785600000,12051,Brandenburg an der Havel,14,0,14,72124,314
DE-BB,03-04-2020,RKI,1,1,0,1585872000000,12051,Brandenburg an der Havel,15,0,15,72124,314
DE-BB,04-04-2020,RKI,0,0,0,1585958400000,12051,Brandenburg an der Havel,15,0,15,72124,314
DE-BB,05-04-2020,RKI,0,0,0,1586044800000,12051,Brandenburg an der Havel,15,0,15,72124,314
DE-BB,06-04-2020,RKI,0,0,0,1586131200000,12051,Brandenburg an der Havel,15,0,15,72124,314
DE-BB,07-04-2020,RKI,4,4,0,1586217600000,12051,Brandenburg an der Havel,19,0,19,72124,314
DE-BB,09-04-2020,RKI,2,2,0,1586390400000,12051,Brandenburg an der Havel,21,0,21,72124,314
DE-BB,10-04-2020,RKI,1,1,0,1586476800000,12051,Brandenburg an der Havel,22,0,22,72124,314
DE-BB,11-04-2020,RKI,0,0,0,1586563200000,12051,Brandenburg an der Havel,22,0,22,72124,314
DE-BB,13-04-2020,RKI,0,0,0,1586736000000,12051,Brandenburg an der Havel,22,0,22,72124,314
DE-BB,15-04-2020,RKI,2,2,0,1586908800000,12051,Brandenburg an der Havel,24,0,24,72124,314
DE-BB,20-04-2020,RKI,0,0,0,1587340800000,12051,Brandenburg an der Havel,24,0,24,72124,314
DE-BB,21-04-2020,RKI,0,0,0,1587427200000,12051,Brandenburg an der Havel,24,0,24,72124,314
DE-BB,22-04-2020,RKI,1,1,0,1587513600000,12051,Brandenburg an der Havel,25,0,25,72124,314
DE-BB,23-04-2020,RKI,0,0,0,1587600000000,12051,Brandenburg an der Havel,25,0,25,72124,314
DE-BB,24-04-2020,RKI,0,0,0,1587686400000,12051,Brandenburg an der Havel,25,0,25,72124,314
DE-BB,29-04-2020,RKI,0,0,0,1588118400000,12051,Brandenburg an der Havel,25,0,25,72124,314
DE-BB,30-04-2020,RKI,0,0,0,1588204800000,12051,Brandenburg an der Havel,25,0,25,72124,314
DE-BB,02-05-2020,RKI,1,1,0,1588377600000,12051,Brandenburg an der Havel,26,0,26,72124,314
DE-BB,07-05-2020,RKI,0,0,0,1588809600000,12051,Brandenburg an der Havel,26,0,26,72124,314
DE-BB,20-05-2020,RKI,0,0,0,1589932800000,12051,Brandenburg an der Havel,26,0,26,72124,314
DE-BB,10-06-2020,RKI,0,0,0,1591747200000,12051,Brandenburg an der Havel,26,0,26,72124,314
DE-BB,12-06-2020,RKI,1,1,0,1591920000000,12051,Brandenburg an der Havel,27,0,27,72124,314
DE-BB,16-06-2020,RKI,0,0,0,1592265600000,12051,Brandenburg an der Havel,27,0,27,72124,314
DE-BB,12-03-2020,RKI,4,4,0,1583971200000,12052,Cottbus,6,0,6,100219,607
DE-BB,13-03-2020,RKI,3,3,0,1584057600000,12052,Cottbus,9,0,9,100219,607
DE-BB,14-03-2020,RKI,0,0,0,1584144000000,12052,Cottbus,9,0,9,100219,607
DE-BB,16-03-2020,RKI,2,2,0,1584316800000,12052,Cottbus,11,0,11,100219,607
DE-BB,17-03-2020,RKI,0,0,0,1584403200000,12052,Cottbus,11,0,11,100219,607
DE-BB,19-03-2020,RKI,2,2,0,1584576000000,12052,Cottbus,13,0,13,100219,607
DE-BB,22-03-2020,RKI,2,2,0,1584835200000,12052,Cottbus,15,0,15,100219,607
DE-BB,23-03-2020,RKI,2,2,0,1584921600000,12052,Cottbus,17,0,17,100219,607
DE-BB,24-03-2020,RKI,0,0,0,1585008000000,12052,Cottbus,17,0,17,100219,607
DE-BB,26-03-2020,RKI,0,0,0,1585180800000,12052,Cottbus,17,0,17,100219,607
DE-BB,29-03-2020,RKI,1,1,0,1585440000000,12052,Cottbus,18,0,18,100219,607
DE-BB,01-04-2020,RKI,0,0,0,1585699200000,12052,Cottbus,18,0,18,100219,607
DE-BB,02-04-2020,RKI,1,1,0,1585785600000,12052,Cottbus,19,0,19,100219,607
DE-BB,09-04-2020,RKI,0,0,0,1586390400000,12052,Cottbus,19,0,19,100219,607
DE-BB,13-04-2020,RKI,3,3,0,1586736000000,12052,Cottbus,22,0,22,100219,607
DE-BB,18-03-2020,RKI,0,0,0,1584489600000,12053,Frankfurt,0,0,0,57873,391
DE-BB,19-03-2020,RKI,0,0,0,1584576000000,12053,Frankfurt,0,0,0,57873,391
DE-BB,21-03-2020,RKI,1,1,0,1584748800000,12053,Frankfurt,1,0,1,57873,391
DE-BB,25-03-2020,RKI,0,0,0,1585094400000,12053,Frankfurt,1,0,1,57873,391
DE-BB,01-04-2020,RKI,0,0,0,1585699200000,12053,Frankfurt,1,0,1,57873,391
DE-BB,02-04-2020,RKI,2,2,0,1585785600000,12053,Frankfurt,3,0,3,57873,391
DE-BB,03-04-2020,RKI,1,1,0,1585872000000,12053,Frankfurt,4,0,4,57873,391
DE-BB,04-04-2020,RKI,0,0,0,1585958400000,12053,Frankfurt,4,0,4,57873,391
DE-BB,05-04-2020,RKI,0,0,0,1586044800000,12053,Frankfurt,4,0,4,57873,391
DE-BB,07-04-2020,RKI,7,7,0,1586217600000,12053,Frankfurt,11,0,11,57873,391
DE-BB,17-04-2020,RKI,0,0,0,1587081600000,12053,Frankfurt,11,0,11,57873,391
DE-BB,25-04-2020,RKI,1,1,0,1587772800000,12053,Frankfurt,12,0,12,57873,391
DE-BB,28-04-2020,RKI,1,1,0,1588032000000,12053,Frankfurt,13,0,13,57873,391
DE-BB,01-05-2020,RKI,0,0,0,1588291200000,12053,Frankfurt,13,0,13,57873,391
DE-BB,07-05-2020,RKI,0,0,0,1588809600000,12053,Frankfurt,13,0,13,57873,391
DE-BB,03-06-2020,RKI,0,0,0,1591142400000,12053,Frankfurt,13,0,13,57873,391
DE-BB,18-06-2020,RKI,0,0,0,1592438400000,12053,Frankfurt,13,0,13,57873,391
DE-BB,26-06-2020,RKI,0,0,0,1593129600000,12053,Frankfurt,13,0,13,57873,391
DE-BB,04-07-2020,RKI,0,0,0,1593820800000,12053,Frankfurt,13,0,13,57873,391
DE-BB,18-03-2020,RKI,2,2,0,1584489600000,12054,Potsdam,11,0,11,178089,944
DE-BB,19-03-2020,RKI,9,9,0,1584576000000,12054,Potsdam,20,0,20,178089,944
DE-BB,20-03-2020,RKI,8,8,0,1584662400000,12054,Potsdam,28,0,28,178089,944
DE-BB,23-03-2020,RKI,8,8,0,1584921600000,12054,Potsdam,36,0,36,178089,944
DE-BB,24-03-2020,RKI,6,6,0,1585008000000,12054,Potsdam,42,0,42,178089,944
DE-BB,25-03-2020,RKI,9,7,2,1585094400000,12054,Potsdam,51,2,49,178089,944
DE-BB,26-03-2020,RKI,5,5,0,1585180800000,12054,Potsdam,56,2,54,178089,944
DE-BB,27-03-2020,RKI,15,12,3,1585267200000,12054,Potsdam,71,5,66,178089,944
DE-BB,30-03-2020,RKI,32,27,5,1585526400000,12054,Potsdam,103,10,93,178089,944
DE-BB,31-03-2020,RKI,17,16,1,1585612800000,12054,Potsdam,120,11,109,178089,944
DE-BB,01-04-2020,RKI,17,13,4,1585699200000,12054,Potsdam,137,15,122,178089,944
DE-BB,02-04-2020,RKI,20,18,2,1585785600000,12054,Potsdam,157,17,140,178089,944
DE-BB,03-04-2020,RKI,39,29,10,1585872000000,12054,Potsdam,196,27,169,178089,944
DE-BB,06-04-2020,RKI,29,28,1,1586131200000,12054,Potsdam,225,28,197,178089,944
DE-BB,07-04-2020,RKI,34,31,3,1586217600000,12054,Potsdam,259,31,228,178089,944
DE-BB,08-04-2020,RKI,62,62,0,1586304000000,12054,Potsdam,321,31,290,178089,944
DE-BB,09-04-2020,RKI,8,7,1,1586390400000,12054,Potsdam,329,32,297,178089,944
DE-BB,10-04-2020,RKI,48,46,2,1586476800000,12054,Potsdam,377,34,343,178089,944
DE-BB,11-04-2020,RKI,21,19,2,1586563200000,12054,Potsdam,398,36,362,178089,944
DE-BB,12-04-2020,RKI,14,11,3,1586649600000,12054,Potsdam,412,39,373,178089,944
DE-BB,14-04-2020,RKI,1,1,0,1586822400000,12054,Potsdam,413,39,374,178089,944
DE-BB,15-04-2020,RKI,23,20,3,1586908800000,12054,Potsdam,436,42,394,178089,944
DE-BB,16-04-2020,RKI,17,14,3,1586995200000,12054,Potsdam,453,45,408,178089,944
DE-BB,17-04-2020,RKI,39,39,0,1587081600000,12054,Potsdam,492,45,447,178089,944
DE-BB,20-04-2020,RKI,10,7,3,1587340800000,12054,Potsdam,502,48,454,178089,944
DE-BB,21-04-2020,RKI,3,2,1,1587427200000,12054,Potsdam,505,49,456,178089,944
DE-BB,22-04-2020,RKI,5,5,0,1587513600000,12054,Potsdam,510,49,461,178089,944
DE-BB,23-04-2020,RKI,9,8,1,1587600000000,12054,Potsdam,519,50,469,178089,944
DE-BB,24-04-2020,RKI,20,20,0,1587686400000,12054,Potsdam,539,50,489,178089,944
DE-BB,26-04-2020,RKI,0,0,0,1587859200000,12054,Potsdam,539,50,489,178089,944
DE-BB,27-04-2020,RKI,2,2,0,1587945600000,12054,Potsdam,541,50,491,178089,944
DE-BB,28-04-2020,RKI,9,9,0,1588032000000,12054,Potsdam,550,50,500,178089,944
DE-BB,29-04-2020,RKI,1,1,0,1588118400000,12054,Potsdam,551,50,501,178089,944
DE-BB,30-04-2020,RKI,5,5,0,1588204800000,12054,Potsdam,556,50,506,178089,944
DE-BB,01-05-2020,RKI,3,3,0,1588291200000,12054,Potsdam,559,50,509,178089,944
DE-BB,02-05-2020,RKI,2,2,0,1588377600000,12054,Potsdam,561,50,511,178089,944
DE-BB,04-05-2020,RKI,2,1,1,1588550400000,12054,Potsdam,563,51,512,178089,944
DE-BB,05-05-2020,RKI,4,4,0,1588636800000,12054,Potsdam,567,51,516,178089,944
DE-BB,06-05-2020,RKI,3,3,0,1588723200000,12054,Potsdam,570,51,519,178089,944
DE-BB,07-05-2020,RKI,1,1,0,1588809600000,12054,Potsdam,571,51,520,178089,944
DE-BB,08-05-2020,RKI,0,0,0,1588896000000,12054,Potsdam,571,51,520,178089,944
DE-BB,11-05-2020,RKI,0,0,0,1589155200000,12054,Potsdam,571,51,520,178089,944
DE-BB,18-05-2020,RKI,0,0,0,1589760000000,12054,Potsdam,571,51,520,178089,944
DE-BB,20-05-2020,RKI,1,1,0,1589932800000,12054,Potsdam,572,51,521,178089,944
DE-BB,22-05-2020,RKI,0,0,0,1590105600000,12054,Potsdam,572,51,521,178089,944
DE-BB,30-05-2020,RKI,0,0,0,1590796800000,12054,Potsdam,572,51,521,178089,944
DE-BB,02-06-2020,RKI,1,1,0,1591056000000,12054,Potsdam,573,51,522,178089,944
DE-BB,03-06-2020,RKI,0,0,0,1591142400000,12054,Potsdam,573,51,522,178089,944
DE-BB,08-06-2020,RKI,0,0,0,1591574400000,12054,Potsdam,573,51,522,178089,944
DE-BB,17-06-2020,RKI,0,0,0,1592352000000,12054,Potsdam,573,51,522,178089,944
DE-BB,19-06-2020,RKI,1,1,0,1592524800000,12054,Potsdam,574,51,523,178089,944
DE-BB,22-06-2020,RKI,0,0,0,1592784000000,12054,Potsdam,574,51,523,178089,944
DE-BB,24-06-2020,RKI,0,0,0,1592956800000,12054,Potsdam,574,51,523,178089,944
DE-BB,29-06-2020,RKI,1,1,0,1593388800000,12054,Potsdam,575,51,524,178089,944
DE-BB,30-06-2020,RKI,0,0,0,1593475200000,12054,Potsdam,575,51,524,178089,944
DE-BB,07-07-2020,RKI,1,0,0,1594080000000,12054,Potsdam,576,51,524,178089,944
DE-BB,09-07-2020,RKI,0,0,0,1594252800000,12054,Potsdam,576,51,524,178089,944
DE-BB,14-07-2020,RKI,0,0,0,1594684800000,12054,Potsdam,576,51,524,178089,944
DE-BB,11-03-2020,RKI,1,1,0,1583884800000,12060,Barnim,2,0,2,182760,124
DE-BB,12-03-2020,RKI,2,2,0,1583971200000,12060,Barnim,4,0,4,182760,124
DE-BB,13-03-2020,RKI,1,1,0,1584057600000,12060,Barnim,5,0,5,182760,124
DE-BB,15-03-2020,RKI,3,3,0,1584230400000,12060,Barnim,8,0,8,182760,124
DE-BB,16-03-2020,RKI,2,2,0,1584316800000,12060,Barnim,10,0,10,182760,124
DE-BB,17-03-2020,RKI,4,4,0,1584403200000,12060,Barnim,14,0,14,182760,124
DE-BB,18-03-2020,RKI,1,1,0,1584489600000,12060,Barnim,15,0,15,182760,124
DE-BB,19-03-2020,RKI,6,6,0,1584576000000,12060,Barnim,21,0,21,182760,124
DE-BB,20-03-2020,RKI,6,6,0,1584662400000,12060,Barnim,27,0,27,182760,124
DE-BB,21-03-2020,RKI,0,0,0,1584748800000,12060,Barnim,27,0,27,182760,124
DE-BB,22-03-2020,RKI,4,4,0,1584835200000,12060,Barnim,31,0,31,182760,124
DE-BB,23-03-2020,RKI,3,3,0,1584921600000,12060,Barnim,34,0,34,182760,124
DE-BB,24-03-2020,RKI,6,6,0,1585008000000,12060,Barnim,40,0,40,182760,124
DE-BB,25-03-2020,RKI,5,5,0,1585094400000,12060,Barnim,45,0,45,182760,124
DE-BB,26-03-2020,RKI,3,3,0,1585180800000,12060,Barnim,48,0,48,182760,124
DE-BB,27-03-2020,RKI,2,2,0,1585267200000,12060,Barnim,50,0,50,182760,124
DE-BB,29-03-2020,RKI,4,4,0,1585440000000,12060,Barnim,54,0,54,182760,124
DE-BB,30-03-2020,RKI,1,1,0,1585526400000,12060,Barnim,55,0,55,182760,124
DE-BB,31-03-2020,RKI,7,7,0,1585612800000,12060,Barnim,62,0,62,182760,124
DE-BB,01-04-2020,RKI,4,4,0,1585699200000,12060,Barnim,66,0,66,182760,124
DE-BB,02-04-2020,RKI,6,5,1,1585785600000,12060,Barnim,72,1,71,182760,124
DE-BB,03-04-2020,RKI,8,6,2,1585872000000,12060,Barnim,80,3,77,182760,124
DE-BB,04-04-2020,RKI,7,7,0,1585958400000,12060,Barnim,87,3,84,182760,124
DE-BB,05-04-2020,RKI,10,7,3,1586044800000,12060,Barnim,97,6,91,182760,124
DE-BB,06-04-2020,RKI,2,2,0,1586131200000,12060,Barnim,99,6,93,182760,124
DE-BB,07-04-2020,RKI,5,4,1,1586217600000,12060,Barnim,104,7,97,182760,124
DE-BB,08-04-2020,RKI,13,12,1,1586304000000,12060,Barnim,117,8,109,182760,124
DE-BB,09-04-2020,RKI,51,43,8,1586390400000,12060,Barnim,168,16,152,182760,124
DE-BB,10-04-2020,RKI,7,7,0,1586476800000,12060,Barnim,175,16,159,182760,124
DE-BB,11-04-2020,RKI,7,6,1,1586563200000,12060,Barnim,182,17,165,182760,124
DE-BB,12-04-2020,RKI,12,10,2,1586649600000,12060,Barnim,194,19,175,182760,124
DE-BB,13-04-2020,RKI,1,1,0,1586736000000,12060,Barnim,195,19,176,182760,124
DE-BB,14-04-2020,RKI,7,6,1,1586822400000,12060,Barnim,202,20,182,182760,124
DE-BB,15-04-2020,RKI,13,10,3,1586908800000,12060,Barnim,215,23,192,182760,124
DE-BB,16-04-2020,RKI,8,8,0,1586995200000,12060,Barnim,223,23,200,182760,124
DE-BB,17-04-2020,RKI,13,13,0,1587081600000,12060,Barnim,236,23,213,182760,124
DE-BB,18-04-2020,RKI,8,7,1,1587168000000,12060,Barnim,244,24,220,182760,124
DE-BB,19-04-2020,RKI,9,8,1,1587254400000,12060,Barnim,253,25,228,182760,124
DE-BB,20-04-2020,RKI,5,4,1,1587340800000,12060,Barnim,258,26,232,182760,124
DE-BB,21-04-2020,RKI,20,20,0,1587427200000,12060,Barnim,278,26,252,182760,124
DE-BB,22-04-2020,RKI,9,9,0,1587513600000,12060,Barnim,287,26,261,182760,124
DE-BB,23-04-2020,RKI,1,1,0,1587600000000,12060,Barnim,288,26,262,182760,124
DE-BB,24-04-2020,RKI,11,10,1,1587686400000,12060,Barnim,299,27,272,182760,124
DE-BB,25-04-2020,RKI,4,4,0,1587772800000,12060,Barnim,303,27,276,182760,124
DE-BB,26-04-2020,RKI,0,0,0,1587859200000,12060,Barnim,303,27,276,182760,124
DE-BB,27-04-2020,RKI,3,3,0,1587945600000,12060,Barnim,306,27,279,182760,124
DE-BB,28-04-2020,RKI,7,7,0,1588032000000,12060,Barnim,313,27,286,182760,124
DE-BB,29-04-2020,RKI,4,3,1,1588118400000,12060,Barnim,317,28,289,182760,124
DE-BB,30-04-2020,RKI,0,0,0,1588204800000,12060,Barnim,317,28,289,182760,124
DE-BB,01-05-2020,RKI,10,9,1,1588291200000,12060,Barnim,327,29,298,182760,124
DE-BB,02-05-2020,RKI,0,0,0,1588377600000,12060,Barnim,327,29,298,182760,124
DE-BB,03-05-2020,RKI,0,0,0,1588464000000,12060,Barnim,327,29,298,182760,124
DE-BB,05-05-2020,RKI,2,2,0,1588636800000,12060,Barnim,329,29,300,182760,124
DE-BB,06-05-2020,RKI,4,4,0,1588723200000,12060,Barnim,333,29,304,182760,124
DE-BB,07-05-2020,RKI,0,0,0,1588809600000,12060,Barnim,333,29,304,182760,124
DE-BB,08-05-2020,RKI,0,0,0,1588896000000,12060,Barnim,333,29,304,182760,124
DE-BB,09-05-2020,RKI,2,2,0,1588982400000,12060,Barnim,335,29,306,182760,124
DE-BB,10-05-2020,RKI,0,0,0,1589068800000,12060,Barnim,335,29,306,182760,124
DE-BB,12-05-2020,RKI,0,0,0,1589241600000,12060,Barnim,335,29,306,182760,124
DE-BB,13-05-2020,RKI,0,0,0,1589328000000,12060,Barnim,335,29,306,182760,124
DE-BB,14-05-2020,RKI,2,2,0,1589414400000,12060,Barnim,337,29,308,182760,124
DE-BB,22-05-2020,RKI,0,0,0,1590105600000,12060,Barnim,337,29,308,182760,124
DE-BB,28-05-2020,RKI,0,0,0,1590624000000,12060,Barnim,337,29,308,182760,124
DE-BB,30-05-2020,RKI,0,0,0,1590796800000,12060,Barnim,337,29,308,182760,124
DE-BB,02-06-2020,RKI,0,0,0,1591056000000,12060,Barnim,337,29,308,182760,124
DE-BB,04-06-2020,RKI,0,0,0,1591228800000,12060,Barnim,337,29,308,182760,124
DE-BB,05-06-2020,RKI,0,0,0,1591315200000,12060,Barnim,337,29,308,182760,124
DE-BB,11-06-2020,RKI,0,0,0,1591833600000,12060,Barnim,337,29,308,182760,124
DE-BB,12-06-2020,RKI,2,2,0,1591920000000,12060,Barnim,339,29,310,182760,124
DE-BB,15-06-2020,RKI,2,2,0,1592179200000,12060,Barnim,341,29,312,182760,124
DE-BB,16-06-2020,RKI,2,2,0,1592265600000,12060,Barnim,343,29,314,182760,124
DE-BB,19-06-2020,RKI,1,1,0,1592524800000,12060,Barnim,344,29,315,182760,124
DE-BB,20-06-2020,RKI,3,3,0,1592611200000,12060,Barnim,347,29,318,182760,124
DE-BB,22-06-2020,RKI,0,0,0,1592784000000,12060,Barnim,347,29,318,182760,124
DE-BB,23-06-2020,RKI,0,0,0,1592870400000,12060,Barnim,347,29,318,182760,124
DE-BB,24-06-2020,RKI,0,0,0,1592956800000,12060,Barnim,347,29,318,182760,124
DE-BB,03-07-2020,RKI,0,0,0,1593734400000,12060,Barnim,347,29,318,182760,124
DE-BB,10-07-2020,RKI,0,0,0,1594339200000,12060,Barnim,347,29,318,182760,124
DE-BB,13-07-2020,RKI,0,0,0,1594598400000,12060,Barnim,347,29,318,182760,124
DE-BB,16-07-2020,RKI,0,0,0,1594857600000,12060,Barnim,347,29,318,182760,124
DE-BB,14-03-2020,RKI,1,1,0,1584144000000,12061,Dahme-Spreewald,1,0,1,169067,74
DE-BB,15-03-2020,RKI,1,1,0,1584230400000,12061,Dahme-Spreewald,2,0,2,169067,74
DE-BB,16-03-2020,RKI,3,3,0,1584316800000,12061,Dahme-Spreewald,5,0,5,169067,74
DE-BB,17-03-2020,RKI,4,4,0,1584403200000,12061,Dahme-Spreewald,9,0,9,169067,74
DE-BB,19-03-2020,RKI,3,3,0,1584576000000,12061,Dahme-Spreewald,12,0,12,169067,74
DE-BB,20-03-2020,RKI,5,5,0,1584662400000,12061,Dahme-Spreewald,17,0,17,169067,74
DE-BB,21-03-2020,RKI,1,1,0,1584748800000,12061,Dahme-Spreewald,18,0,18,169067,74
DE-BB,23-03-2020,RKI,3,3,0,1584921600000,12061,Dahme-Spreewald,21,0,21,169067,74
DE-BB,24-03-2020,RKI,2,2,0,1585008000000,12061,Dahme-Spreewald,23,0,23,169067,74
DE-BB,25-03-2020,RKI,10,10,0,1585094400000,12061,Dahme-Spreewald,33,0,33,169067,74
DE-BB,26-03-2020,RKI,3,3,0,1585180800000,12061,Dahme-Spreewald,36,0,36,169067,74
DE-BB,27-03-2020,RKI,9,9,0,1585267200000,12061,Dahme-Spreewald,45,0,45,169067,74
DE-BB,28-03-2020,RKI,4,4,0,1585353600000,12061,Dahme-Spreewald,49,0,49,169067,74
DE-BB,29-03-2020,RKI,6,6,0,1585440000000,12061,Dahme-Spreewald,55,0,55,169067,74
DE-BB,30-03-2020,RKI,5,4,1,1585526400000,12061,Dahme-Spreewald,60,1,59,169067,74
DE-BB,31-03-2020,RKI,19,17,2,1585612800000,12061,Dahme-Spreewald,79,3,76,169067,74
DE-BB,01-04-2020,RKI,5,5,0,1585699200000,12061,Dahme-Spreewald,84,3,81,169067,74
DE-BB,02-04-2020,RKI,7,7,0,1585785600000,12061,Dahme-Spreewald,91,3,88,169067,74
DE-BB,03-04-2020,RKI,4,4,0,1585872000000,12061,Dahme-Spreewald,95,3,92,169067,74
DE-BB,04-04-2020,RKI,0,0,0,1585958400000,12061,Dahme-Spreewald,95,3,92,169067,74
DE-BB,05-04-2020,RKI,2,2,0,1586044800000,12061,Dahme-Spreewald,97,3,94,169067,74
DE-BB,06-04-2020,RKI,3,2,1,1586131200000,12061,Dahme-Spreewald,100,4,96,169067,74
DE-BB,07-04-2020,RKI,2,2,0,1586217600000,12061,Dahme-Spreewald,102,4,98,169067,74
DE-BB,08-04-2020,RKI,7,7,0,1586304000000,12061,Dahme-Spreewald,109,4,105,169067,74
DE-BB,09-04-2020,RKI,3,3,0,1586390400000,12061,Dahme-Spreewald,112,4,108,169067,74
DE-BB,10-04-2020,RKI,0,0,0,1586476800000,12061,Dahme-Spreewald,112,4,108,169067,74
DE-BB,11-04-2020,RKI,1,1,0,1586563200000,12061,Dahme-Spreewald,113,4,109,169067,74
DE-BB,13-04-2020,RKI,0,0,0,1586736000000,12061,Dahme-Spreewald,113,4,109,169067,74
DE-BB,14-04-2020,RKI,3,3,0,1586822400000,12061,Dahme-Spreewald,116,4,112,169067,74
DE-BB,15-04-2020,RKI,0,0,0,1586908800000,12061,Dahme-Spreewald,116,4,112,169067,74
DE-BB,16-04-2020,RKI,4,4,0,1586995200000,12061,Dahme-Spreewald,120,4,116,169067,74
DE-BB,17-04-2020,RKI,2,2,0,1587081600000,12061,Dahme-Spreewald,122,4,118,169067,74
DE-BB,18-04-2020,RKI,0,0,0,1587168000000,12061,Dahme-Spreewald,122,4,118,169067,74
DE-BB,19-04-2020,RKI,1,1,0,1587254400000,12061,Dahme-Spreewald,123,4,119,169067,74
DE-BB,21-04-2020,RKI,1,0,1,1587427200000,12061,Dahme-Spreewald,124,5,119,169067,74
DE-BB,22-04-2020,RKI,0,0,0,1587513600000,12061,Dahme-Spreewald,124,5,119,169067,74
DE-BB,23-04-2020,RKI,1,1,0,1587600000000,12061,Dahme-Spreewald,125,5,120,169067,74
DE-BB,24-04-2020,RKI,5,5,0,1587686400000,12061,Dahme-Spreewald,130,5,125,169067,74
DE-BB,25-04-2020,RKI,3,3,0,1587772800000,12061,Dahme-Spreewald,133,5,128,169067,74
DE-BB,26-04-2020,RKI,3,3,0,1587859200000,12061,Dahme-Spreewald,136,5,131,169067,74
DE-BB,27-04-2020,RKI,1,1,0,1587945600000,12061,Dahme-Spreewald,137,5,132,169067,74
DE-BB,28-04-2020,RKI,16,15,1,1588032000000,12061,Dahme-Spreewald,153,6,147,169067,74
DE-BB,29-04-2020,RKI,1,1,0,1588118400000,12061,Dahme-Spreewald,154,6,148,169067,74
DE-BB,30-04-2020,RKI,2,1,1,1588204800000,12061,Dahme-Spreewald,156,7,149,169067,74
DE-BB,01-05-2020,RKI,5,5,0,1588291200000,12061,Dahme-Spreewald,161,7,154,169067,74
DE-BB,05-05-2020,RKI,23,23,0,1588636800000,12061,Dahme-Spreewald,184,7,177,169067,74
DE-BB,06-05-2020,RKI,0,0,0,1588723200000,12061,Dahme-Spreewald,184,7,177,169067,74
DE-BB,07-05-2020,RKI,0,0,0,1588809600000,12061,Dahme-Spreewald,184,7,177,169067,74
DE-BB,11-05-2020,RKI,1,1,0,1589155200000,12061,Dahme-Spreewald,185,7,178,169067,74
DE-BB,18-05-2020,RKI,1,1,0,1589760000000,12061,Dahme-Spreewald,186,7,179,169067,74
DE-BB,21-05-2020,RKI,0,0,0,1590019200000,12061,Dahme-Spreewald,186,7,179,169067,74
DE-BB,23-05-2020,RKI,0,0,0,1590192000000,12061,Dahme-Spreewald,186,7,179,169067,74
DE-BB,25-05-2020,RKI,1,1,0,1590364800000,12061,Dahme-Spreewald,187,7,180,169067,74
DE-BB,27-05-2020,RKI,0,0,0,1590537600000,12061,Dahme-Spreewald,187,7,180,169067,74
DE-BB,29-05-2020,RKI,1,1,0,1590710400000,12061,Dahme-Spreewald,188,7,181,169067,74
DE-BB,30-05-2020,RKI,1,1,0,1590796800000,12061,Dahme-Spreewald,189,7,182,169067,74
DE-BB,31-05-2020,RKI,0,0,0,1590883200000,12061,Dahme-Spreewald,189,7,182,169067,74
DE-BB,03-06-2020,RKI,0,0,0,1591142400000,12061,Dahme-Spreewald,189,7,182,169067,74
DE-BB,04-06-2020,RKI,0,0,0,1591228800000,12061,Dahme-Spreewald,189,7,182,169067,74
DE-BB,15-06-2020,RKI,0,0,0,1592179200000,12061,Dahme-Spreewald,189,7,182,169067,74
DE-BB,16-06-2020,RKI,0,0,0,1592265600000,12061,Dahme-Spreewald,189,7,182,169067,74
DE-BB,22-06-2020,RKI,0,0,0,1592784000000,12061,Dahme-Spreewald,189,7,182,169067,74
DE-BB,24-06-2020,RKI,0,0,0,1592956800000,12061,Dahme-Spreewald,189,7,182,169067,74
DE-BB,25-06-2020,RKI,0,0,0,1593043200000,12061,Dahme-Spreewald,189,7,182,169067,74
DE-BB,28-06-2020,RKI,0,0,0,1593302400000,12061,Dahme-Spreewald,189,7,182,169067,74
DE-BB,29-06-2020,RKI,1,0,0,1593388800000,12061,Dahme-Spreewald,190,7,182,169067,74
DE-BB,01-07-2020,RKI,1,1,0,1593561600000,12061,Dahme-Spreewald,191,7,183,169067,74
DE-BB,02-07-2020,RKI,0,0,0,1593648000000,12061,Dahme-Spreewald,191,7,183,169067,74
DE-BB,03-07-2020,RKI,3,3,0,1593734400000,12061,Dahme-Spreewald,194,7,186,169067,74
DE-BB,04-07-2020,RKI,0,0,0,1593820800000,12061,Dahme-Spreewald,194,7,186,169067,74
DE-BB,12-07-2020,RKI,0,0,0,1594512000000,12061,Dahme-Spreewald,194,7,186,169067,74
DE-BB,15-07-2020,RKI,0,0,0,1594771200000,12061,Dahme-Spreewald,194,7,186,169067,74
DE-BB,10-03-2020,RKI,1,1,0,1583798400000,12062,Elbe-Elster,1,0,1,102638,54
DE-BB,12-03-2020,RKI,1,1,0,1583971200000,12062,Elbe-Elster,2,0,2,102638,54
DE-BB,17-03-2020,RKI,1,1,0,1584403200000,12062,Elbe-Elster,3,0,3,102638,54
DE-BB,18-03-2020,RKI,0,0,0,1584489600000,12062,Elbe-Elster,3,0,3,102638,54
DE-BB,20-03-2020,RKI,0,0,0,1584662400000,12062,Elbe-Elster,3,0,3,102638,54
DE-BB,22-03-2020,RKI,2,2,0,1584835200000,12062,Elbe-Elster,5,0,5,102638,54
DE-BB,24-03-2020,RKI,3,3,0,1585008000000,12062,Elbe-Elster,8,0,8,102638,54
DE-BB,25-03-2020,RKI,0,0,0,1585094400000,12062,Elbe-Elster,8,0,8,102638,54
DE-BB,26-03-2020,RKI,4,4,0,1585180800000,12062,Elbe-Elster,12,0,12,102638,54
DE-BB,27-03-2020,RKI,5,4,1,1585267200000,12062,Elbe-Elster,17,1,16,102638,54
DE-BB,28-03-2020,RKI,2,2,0,1585353600000,12062,Elbe-Elster,19,1,18,102638,54
DE-BB,29-03-2020,RKI,1,1,0,1585440000000,12062,Elbe-Elster,20,1,19,102638,54
DE-BB,30-03-2020,RKI,0,0,0,1585526400000,12062,Elbe-Elster,20,1,19,102638,54
DE-BB,31-03-2020,RKI,2,1,1,1585612800000,12062,Elbe-Elster,22,2,20,102638,54
DE-BB,01-04-2020,RKI,0,0,0,1585699200000,12062,Elbe-Elster,22,2,20,102638,54
DE-BB,02-04-2020,RKI,4,4,0,1585785600000,12062,Elbe-Elster,26,2,24,102638,54
DE-BB,03-04-2020,RKI,5,5,0,1585872000000,12062,Elbe-Elster,31,2,29,102638,54
DE-BB,04-04-2020,RKI,6,6,0,1585958400000,12062,Elbe-Elster,37,2,35,102638,54
DE-BB,06-04-2020,RKI,2,2,0,1586131200000,12062,Elbe-Elster,39,2,37,102638,54
DE-BB,07-04-2020,RKI,2,2,0,1586217600000,12062,Elbe-Elster,41,2,39,102638,54
DE-BB,09-04-2020,RKI,0,0,0,1586390400000,12062,Elbe-Elster,41,2,39,102638,54
DE-BB,10-04-2020,RKI,0,0,0,1586476800000,12062,Elbe-Elster,41,2,39,102638,54
DE-BB,11-04-2020,RKI,0,0,0,1586563200000,12062,Elbe-Elster,41,2,39,102638,54
DE-BB,12-04-2020,RKI,0,0,0,1586649600000,12062,Elbe-Elster,41,2,39,102638,54
DE-BB,16-04-2020,RKI,2,2,0,1586995200000,12062,Elbe-Elster,43,2,41,102638,54
DE-BB,21-04-2020,RKI,0,0,0,1587427200000,12062,Elbe-Elster,43,2,41,102638,54
DE-BB,06-05-2020,RKI,0,0,0,1588723200000,12062,Elbe-Elster,43,2,41,102638,54
DE-BB,07-05-2020,RKI,0,0,0,1588809600000,12062,Elbe-Elster,43,2,41,102638,54
DE-BB,13-05-2020,RKI,0,0,0,1589328000000,12062,Elbe-Elster,43,2,41,102638,54
DE-BB,26-05-2020,RKI,0,0,0,1590451200000,12062,Elbe-Elster,43,2,41,102638,54
DE-BB,08-06-2020,RKI,0,0,0,1591574400000,12062,Elbe-Elster,43,2,41,102638,54
DE-BB,11-06-2020,RKI,0,0,0,1591833600000,12062,Elbe-Elster,43,2,41,102638,54
DE-BB,15-06-2020,RKI,0,0,0,1592179200000,12062,Elbe-Elster,43,2,41,102638,54
DE-BB,26-06-2020,RKI,0,0,0,1593129600000,12062,Elbe-Elster,43,2,41,102638,54
DE-BB,03-07-2020,RKI,0,0,0,1593734400000,12062,Elbe-Elster,43,2,41,102638,54
DE-BB,08-03-2020,RKI,1,1,0,1583625600000,12063,Havelland,2,0,2,161909,94
DE-BB,09-03-2020,RKI,0,0,0,1583712000000,12063,Havelland,2,0,2,161909,94
DE-BB,12-03-2020,RKI,0,0,0,1583971200000,12063,Havelland,2,0,2,161909,94
DE-BB,13-03-2020,RKI,1,1,0,1584057600000,12063,Havelland,3,0,3,161909,94
DE-BB,16-03-2020,RKI,0,0,0,1584316800000,12063,Havelland,3,0,3,161909,94
DE-BB,17-03-2020,RKI,0,0,0,1584403200000,12063,Havelland,3,0,3,161909,94
DE-BB,20-03-2020,RKI,6,6,0,1584662400000,12063,Havelland,9,0,9,161909,94
DE-BB,21-03-2020,RKI,3,3,0,1584748800000,12063,Havelland,12,0,12,161909,94
DE-BB,23-03-2020,RKI,1,1,0,1584921600000,12063,Havelland,13,0,13,161909,94
DE-BB,24-03-2020,RKI,3,3,0,1585008000000,12063,Havelland,16,0,16,161909,94
DE-BB,25-03-2020,RKI,7,6,1,1585094400000,12063,Havelland,23,1,22,161909,94
DE-BB,26-03-2020,RKI,5,5,0,1585180800000,12063,Havelland,28,1,27,161909,94
DE-BB,27-03-2020,RKI,5,5,0,1585267200000,12063,Havelland,33,1,32,161909,94
DE-BB,28-03-2020,RKI,4,4,0,1585353600000,12063,Havelland,37,1,36,161909,94
DE-BB,29-03-2020,RKI,1,1,0,1585440000000,12063,Havelland,38,1,37,161909,94
DE-BB,30-03-2020,RKI,2,0,2,1585526400000,12063,Havelland,40,3,37,161909,94
DE-BB,31-03-2020,RKI,14,14,0,1585612800000,12063,Havelland,54,3,51,161909,94
DE-BB,01-04-2020,RKI,5,4,1,1585699200000,12063,Havelland,59,4,55,161909,94
DE-BB,02-04-2020,RKI,11,11,0,1585785600000,12063,Havelland,70,4,66,161909,94
DE-BB,03-04-2020,RKI,5,5,0,1585872000000,12063,Havelland,75,4,71,161909,94
DE-BB,04-04-2020,RKI,7,7,0,1585958400000,12063,Havelland,82,4,78,161909,94
DE-BB,05-04-2020,RKI,1,1,0,1586044800000,12063,Havelland,83,4,79,161909,94
DE-BB,06-04-2020,RKI,0,0,0,1586131200000,12063,Havelland,83,4,79,161909,94
DE-BB,07-04-2020,RKI,8,7,1,1586217600000,12063,Havelland,91,5,86,161909,94
DE-BB,08-04-2020,RKI,7,7,0,1586304000000,12063,Havelland,98,5,93,161909,94
DE-BB,09-04-2020,RKI,1,1,0,1586390400000,12063,Havelland,99,5,94,161909,94
DE-BB,10-04-2020,RKI,2,2,0,1586476800000,12063,Havelland,101,5,96,161909,94
DE-BB,11-04-2020,RKI,0,0,0,1586563200000,12063,Havelland,101,5,96,161909,94
DE-BB,12-04-2020,RKI,2,1,1,1586649600000,12063,Havelland,103,6,97,161909,94
DE-BB,14-04-2020,RKI,2,2,0,1586822400000,12063,Havelland,105,6,99,161909,94
DE-BB,15-04-2020,RKI,0,0,0,1586908800000,12063,Havelland,105,6,99,161909,94
DE-BB,16-04-2020,RKI,1,1,0,1586995200000,12063,Havelland,106,6,100,161909,94
DE-BB,17-04-2020,RKI,3,3,0,1587081600000,12063,Havelland,109,6,103,161909,94
DE-BB,20-04-2020,RKI,1,1,0,1587340800000,12063,Havelland,110,6,104,161909,94
DE-BB,21-04-2020,RKI,2,2,0,1587427200000,12063,Havelland,112,6,106,161909,94
DE-BB,22-04-2020,RKI,1,1,0,1587513600000,12063,Havelland,113,6,107,161909,94
DE-BB,23-04-2020,RKI,0,0,0,1587600000000,12063,Havelland,113,6,107,161909,94
DE-BB,25-04-2020,RKI,0,0,0,1587772800000,12063,Havelland,113,6,107,161909,94
DE-BB,27-04-2020,RKI,3,3,0,1587945600000,12063,Havelland,116,6,110,161909,94
DE-BB,29-04-2020,RKI,1,1,0,1588118400000,12063,Havelland,117,6,111,161909,94
DE-BB,01-05-2020,RKI,1,1,0,1588291200000,12063,Havelland,118,6,112,161909,94
DE-BB,02-05-2020,RKI,2,2,0,1588377600000,12063,Havelland,120,6,114,161909,94
DE-BB,04-05-2020,RKI,0,0,0,1588550400000,12063,Havelland,120,6,114,161909,94
DE-BB,06-05-2020,RKI,1,1,0,1588723200000,12063,Havelland,121,6,115,161909,94
DE-BB,07-05-2020,RKI,0,0,0,1588809600000,12063,Havelland,121,6,115,161909,94
DE-BB,15-05-2020,RKI,1,1,0,1589500800000,12063,Havelland,122,6,116,161909,94
DE-BB,16-05-2020,RKI,0,0,0,1589587200000,12063,Havelland,122,6,116,161909,94
DE-BB,19-05-2020,RKI,0,0,0,1589846400000,12063,Havelland,122,6,116,161909,94
DE-BB,25-05-2020,RKI,0,0,0,1590364800000,12063,Havelland,122,6,116,161909,94
DE-BB,15-06-2020,RKI,0,0,0,1592179200000,12063,Havelland,122,6,116,161909,94
DE-BB,16-06-2020,RKI,2,2,0,1592265600000,12063,Havelland,124,6,118,161909,94
DE-BB,17-06-2020,RKI,1,1,0,1592352000000,12063,Havelland,125,6,119,161909,94
DE-BB,18-06-2020,RKI,3,3,0,1592438400000,12063,Havelland,128,6,122,161909,94
DE-BB,19-06-2020,RKI,0,0,0,1592524800000,12063,Havelland,128,6,122,161909,94
DE-BB,20-06-2020,RKI,1,1,0,1592611200000,12063,Havelland,129,6,123,161909,94
DE-BB,23-06-2020,RKI,0,0,0,1592870400000,12063,Havelland,129,6,123,161909,94
DE-BB,26-06-2020,RKI,1,0,0,1593129600000,12063,Havelland,130,6,123,161909,94
DE-BB,27-06-2020,RKI,0,0,0,1593216000000,12063,Havelland,130,6,123,161909,94
DE-BB,30-06-2020,RKI,0,0,0,1593475200000,12063,Havelland,130,6,123,161909,94
DE-BB,01-07-2020,RKI,0,0,0,1593561600000,12063,Havelland,130,6,123,161909,94
DE-BB,02-07-2020,RKI,1,1,0,1593648000000,12063,Havelland,131,6,124,161909,94
DE-BB,15-07-2020,RKI,0,0,0,1594771200000,12063,Havelland,131,6,124,161909,94
DE-BB,16-07-2020,RKI,0,0,0,1594857600000,12063,Havelland,131,6,124,161909,94
DE-BB,11-03-2020,RKI,0,0,0,1583884800000,12064,Märkisch-Oderland,2,0,2,194328,90
DE-BB,12-03-2020,RKI,4,4,0,1583971200000,12064,Märkisch-Oderland,6,0,6,194328,90
DE-BB,13-03-2020,RKI,4,4,0,1584057600000,12064,Märkisch-Oderland,10,0,10,194328,90
DE-BB,14-03-2020,RKI,2,2,0,1584144000000,12064,Märkisch-Oderland,12,0,12,194328,90
DE-BB,15-03-2020,RKI,2,2,0,1584230400000,12064,Märkisch-Oderland,14,0,14,194328,90
DE-BB,16-03-2020,RKI,1,1,0,1584316800000,12064,Märkisch-Oderland,15,0,15,194328,90
DE-BB,17-03-2020,RKI,13,13,0,1584403200000,12064,Märkisch-Oderland,28,0,28,194328,90
DE-BB,18-03-2020,RKI,9,9,0,1584489600000,12064,Märkisch-Oderland,37,0,37,194328,90
DE-BB,19-03-2020,RKI,2,2,0,1584576000000,12064,Märkisch-Oderland,39,0,39,194328,90
DE-BB,20-03-2020,RKI,5,5,0,1584662400000,12064,Märkisch-Oderland,44,0,44,194328,90
DE-BB,21-03-2020,RKI,1,1,0,1584748800000,12064,Märkisch-Oderland,45,0,45,194328,90
DE-BB,23-03-2020,RKI,2,2,0,1584921600000,12064,Märkisch-Oderland,47,0,47,194328,90
DE-BB,24-03-2020,RKI,1,1,0,1585008000000,12064,Märkisch-Oderland,48,0,48,194328,90
DE-BB,25-03-2020,RKI,8,7,1,1585094400000,12064,Märkisch-Oderland,56,1,55,194328,90
DE-BB,26-03-2020,RKI,1,1,0,1585180800000,12064,Märkisch-Oderland,57,1,56,194328,90
DE-BB,27-03-2020,RKI,4,4,0,1585267200000,12064,Märkisch-Oderland,61,1,60,194328,90
DE-BB,28-03-2020,RKI,4,4,0,1585353600000,12064,Märkisch-Oderland,65,1,64,194328,90
DE-BB,29-03-2020,RKI,2,2,0,1585440000000,12064,Märkisch-Oderland,67,1,66,194328,90
DE-BB,30-03-2020,RKI,6,6,0,1585526400000,12064,Märkisch-Oderland,73,1,72,194328,90
DE-BB,31-03-2020,RKI,8,8,0,1585612800000,12064,Märkisch-Oderland,81,1,80,194328,90
DE-BB,01-04-2020,RKI,0,0,0,1585699200000,12064,Märkisch-Oderland,81,1,80,194328,90
DE-BB,02-04-2020,RKI,3,3,0,1585785600000,12064,Märkisch-Oderland,84,1,83,194328,90
DE-BB,03-04-2020,RKI,7,7,0,1585872000000,12064,Märkisch-Oderland,91,1,90,194328,90
DE-BB,04-04-2020,RKI,0,0,0,1585958400000,12064,Märkisch-Oderland,91,1,90,194328,90
DE-BB,05-04-2020,RKI,0,0,0,1586044800000,12064,Märkisch-Oderland,91,1,90,194328,90
DE-BB,06-04-2020,RKI,0,0,0,1586131200000,12064,Märkisch-Oderland,91,1,90,194328,90
DE-BB,07-04-2020,RKI,3,3,0,1586217600000,12064,Märkisch-Oderland,94,1,93,194328,90
DE-BB,08-04-2020,RKI,3,2,1,1586304000000,12064,Märkisch-Oderland,97,2,95,194328,90
DE-BB,09-04-2020,RKI,8,7,1,1586390400000,12064,Märkisch-Oderland,105,3,102,194328,90
DE-BB,10-04-2020,RKI,3,3,0,1586476800000,12064,Märkisch-Oderland,108,3,105,194328,90
DE-BB,11-04-2020,RKI,2,1,1,1586563200000,12064,Märkisch-Oderland,110,4,106,194328,90
DE-BB,12-04-2020,RKI,1,1,0,1586649600000,12064,Märkisch-Oderland,111,4,107,194328,90
DE-BB,13-04-2020,RKI,1,1,0,1586736000000,12064,Märkisch-Oderland,112,4,108,194328,90
DE-BB,14-04-2020,RKI,1,1,0,1586822400000,12064,Märkisch-Oderland,113,4,109,194328,90
DE-BB,16-04-2020,RKI,4,4,0,1586995200000,12064,Märkisch-Oderland,117,4,113,194328,90
DE-BB,17-04-2020,RKI,1,1,0,1587081600000,12064,Märkisch-Oderland,118,4,114,194328,90
DE-BB,18-04-2020,RKI,0,0,0,1587168000000,12064,Märkisch-Oderland,118,4,114,194328,90
DE-BB,19-04-2020,RKI,0,0,0,1587254400000,12064,Märkisch-Oderland,118,4,114,194328,90
DE-BB,20-04-2020,RKI,2,2,0,1587340800000,12064,Märkisch-Oderland,120,4,116,194328,90
DE-BB,21-04-2020,RKI,1,1,0,1587427200000,12064,Märkisch-Oderland,121,4,117,194328,90
DE-BB,22-04-2020,RKI,1,1,0,1587513600000,12064,Märkisch-Oderland,122,4,118,194328,90
DE-BB,23-04-2020,RKI,1,1,0,1587600000000,12064,Märkisch-Oderland,123,4,119,194328,90
DE-BB,24-04-2020,RKI,3,3,0,1587686400000,12064,Märkisch-Oderland,126,4,122,194328,90
DE-BB,27-04-2020,RKI,4,4,0,1587945600000,12064,Märkisch-Oderland,130,4,126,194328,90
DE-BB,28-04-2020,RKI,3,3,0,1588032000000,12064,Märkisch-Oderland,133,4,129,194328,90
DE-BB,29-04-2020,RKI,0,0,0,1588118400000,12064,Märkisch-Oderland,133,4,129,194328,90
DE-BB,30-04-2020,RKI,4,4,0,1588204800000,12064,Märkisch-Oderland,137,4,133,194328,90
DE-BB,01-05-2020,RKI,1,1,0,1588291200000,12064,Märkisch-Oderland,138,4,134,194328,90
DE-BB,03-05-2020,RKI,0,0,0,1588464000000,12064,Märkisch-Oderland,138,4,134,194328,90
DE-BB,04-05-2020,RKI,1,1,0,1588550400000,12064,Märkisch-Oderland,139,4,135,194328,90
DE-BB,05-05-2020,RKI,0,0,0,1588636800000,12064,Märkisch-Oderland,139,4,135,194328,90
DE-BB,14-05-2020,RKI,0,0,0,1589414400000,12064,Märkisch-Oderland,139,4,135,194328,90
DE-BB,19-05-2020,RKI,0,0,0,1589846400000,12064,Märkisch-Oderland,139,4,135,194328,90
DE-BB,20-05-2020,RKI,0,0,0,1589932800000,12064,Märkisch-Oderland,139,4,135,194328,90
DE-BB,22-05-2020,RKI,1,1,0,1590105600000,12064,Märkisch-Oderland,140,4,136,194328,90
DE-BB,09-06-2020,RKI,2,2,0,1591660800000,12064,Märkisch-Oderland,142,4,138,194328,90
DE-BB,12-06-2020,RKI,0,0,0,1591920000000,12064,Märkisch-Oderland,142,4,138,194328,90
DE-BB,18-06-2020,RKI,1,1,0,1592438400000,12064,Märkisch-Oderland,143,4,139,194328,90
DE-BB,19-06-2020,RKI,1,1,0,1592524800000,12064,Märkisch-Oderland,144,4,140,194328,90
DE-BB,20-06-2020,RKI,0,0,0,1592611200000,12064,Märkisch-Oderland,144,4,140,194328,90
DE-BB,24-06-2020,RKI,1,1,0,1592956800000,12064,Märkisch-Oderland,145,4,141,194328,90
DE-BB,26-06-2020,RKI,0,0,0,1593129600000,12064,Märkisch-Oderland,145,4,141,194328,90
DE-BB,02-07-2020,RKI,0,0,0,1593648000000,12064,Märkisch-Oderland,145,4,141,194328,90
DE-BB,03-07-2020,RKI,0,0,0,1593734400000,12064,Märkisch-Oderland,145,4,141,194328,90
DE-BB,12-03-2020,RKI,0,0,0,1583971200000,12065,Oberhavel,0,0,0,211249,117
DE-BB,13-03-2020,RKI,1,1,0,1584057600000,12065,Oberhavel,1,0,1,211249,117
DE-BB,15-03-2020,RKI,1,1,0,1584230400000,12065,Oberhavel,2,0,2,211249,117
DE-BB,16-03-2020,RKI,2,2,0,1584316800000,12065,Oberhavel,4,0,4,211249,117
DE-BB,17-03-2020,RKI,4,4,0,1584403200000,12065,Oberhavel,8,0,8,211249,117
DE-BB,18-03-2020,RKI,5,5,0,1584489600000,12065,Oberhavel,13,0,13,211249,117
DE-BB,19-03-2020,RKI,5,4,1,1584576000000,12065,Oberhavel,18,1,17,211249,117
DE-BB,20-03-2020,RKI,13,12,1,1584662400000,12065,Oberhavel,31,2,29,211249,117
DE-BB,22-03-2020,RKI,0,0,0,1584835200000,12065,Oberhavel,31,2,29,211249,117
DE-BB,23-03-2020,RKI,1,1,0,1584921600000,12065,Oberhavel,32,2,30,211249,117
DE-BB,24-03-2020,RKI,11,11,0,1585008000000,12065,Oberhavel,43,2,41,211249,117
DE-BB,25-03-2020,RKI,7,7,0,1585094400000,12065,Oberhavel,50,2,48,211249,117
DE-BB,26-03-2020,RKI,13,12,1,1585180800000,12065,Oberhavel,63,3,60,211249,117
DE-BB,27-03-2020,RKI,11,10,1,1585267200000,12065,Oberhavel,74,4,70,211249,117
DE-BB,28-03-2020,RKI,8,8,0,1585353600000,12065,Oberhavel,82,4,78,211249,117
DE-BB,29-03-2020,RKI,0,0,0,1585440000000,12065,Oberhavel,82,4,78,211249,117
DE-BB,30-03-2020,RKI,4,4,0,1585526400000,12065,Oberhavel,86,4,82,211249,117
DE-BB,31-03-2020,RKI,9,9,0,1585612800000,12065,Oberhavel,95,4,91,211249,117
DE-BB,01-04-2020,RKI,6,5,1,1585699200000,12065,Oberhavel,101,5,96,211249,117
DE-BB,02-04-2020,RKI,7,6,1,1585785600000,12065,Oberhavel,108,6,102,211249,117
DE-BB,03-04-2020,RKI,6,6,0,1585872000000,12065,Oberhavel,114,6,108,211249,117
DE-BB,04-04-2020,RKI,2,2,0,1585958400000,12065,Oberhavel,116,6,110,211249,117
DE-BB,05-04-2020,RKI,0,0,0,1586044800000,12065,Oberhavel,116,6,110,211249,117
DE-BB,06-04-2020,RKI,6,6,0,1586131200000,12065,Oberhavel,122,6,116,211249,117
DE-BB,07-04-2020,RKI,3,2,1,1586217600000,12065,Oberhavel,125,7,118,211249,117
DE-BB,08-04-2020,RKI,3,3,0,1586304000000,12065,Oberhavel,128,7,121,211249,117
DE-BB,09-04-2020,RKI,1,1,0,1586390400000,12065,Oberhavel,129,7,122,211249,117
DE-BB,11-04-2020,RKI,4,4,0,1586563200000,12065,Oberhavel,133,7,126,211249,117
DE-BB,12-04-2020,RKI,0,0,0,1586649600000,12065,Oberhavel,133,7,126,211249,117
DE-BB,13-04-2020,RKI,0,0,0,1586736000000,12065,Oberhavel,133,7,126,211249,117
DE-BB,14-04-2020,RKI,4,4,0,1586822400000,12065,Oberhavel,137,7,130,211249,117
DE-BB,15-04-2020,RKI,1,1,0,1586908800000,12065,Oberhavel,138,7,131,211249,117
DE-BB,16-04-2020,RKI,3,3,0,1586995200000,12065,Oberhavel,141,7,134,211249,117
DE-BB,17-04-2020,RKI,24,24,0,1587081600000,12065,Oberhavel,165,7,158,211249,117
DE-BB,18-04-2020,RKI,39,39,0,1587168000000,12065,Oberhavel,204,7,197,211249,117
DE-BB,19-04-2020,RKI,1,1,0,1587254400000,12065,Oberhavel,205,7,198,211249,117
DE-BB,20-04-2020,RKI,5,5,0,1587340800000,12065,Oberhavel,210,7,203,211249,117
DE-BB,21-04-2020,RKI,6,6,0,1587427200000,12065,Oberhavel,216,7,209,211249,117
DE-BB,22-04-2020,RKI,11,11,0,1587513600000,12065,Oberhavel,227,7,220,211249,117
DE-BB,23-04-2020,RKI,2,2,0,1587600000000,12065,Oberhavel,229,7,222,211249,117
DE-BB,24-04-2020,RKI,0,0,0,1587686400000,12065,Oberhavel,229,7,222,211249,117
DE-BB,27-04-2020,RKI,1,1,0,1587945600000,12065,Oberhavel,230,7,223,211249,117
DE-BB,28-04-2020,RKI,2,2,0,1588032000000,12065,Oberhavel,232,7,225,211249,117
DE-BB,29-04-2020,RKI,5,5,0,1588118400000,12065,Oberhavel,237,7,230,211249,117
DE-BB,30-04-2020,RKI,0,0,0,1588204800000,12065,Oberhavel,237,7,230,211249,117
DE-BB,01-05-2020,RKI,0,0,0,1588291200000,12065,Oberhavel,237,7,230,211249,117
DE-BB,04-05-2020,RKI,2,2,0,1588550400000,12065,Oberhavel,239,7,232,211249,117
DE-BB,05-05-2020,RKI,3,3,0,1588636800000,12065,Oberhavel,242,7,235,211249,117
DE-BB,06-05-2020,RKI,3,3,0,1588723200000,12065,Oberhavel,245,7,238,211249,117
DE-BB,07-05-2020,RKI,0,0,0,1588809600000,12065,Oberhavel,245,7,238,211249,117
DE-BB,08-05-2020,RKI,2,2,0,1588896000000,12065,Oberhavel,247,7,240,211249,117
DE-BB,09-05-2020,RKI,0,0,0,1588982400000,12065,Oberhavel,247,7,240,211249,117
DE-BB,12-05-2020,RKI,1,1,0,1589241600000,12065,Oberhavel,248,7,241,211249,117
DE-BB,13-05-2020,RKI,1,0,1,1589328000000,12065,Oberhavel,249,8,241,211249,117
DE-BB,15-05-2020,RKI,1,1,0,1589500800000,12065,Oberhavel,250,8,242,211249,117
DE-BB,28-05-2020,RKI,2,1,1,1590624000000,12065,Oberhavel,252,9,243,211249,117
DE-BB,09-06-2020,RKI,0,0,0,1591660800000,12065,Oberhavel,252,9,243,211249,117
DE-BB,10-06-2020,RKI,1,1,0,1591747200000,12065,Oberhavel,253,9,244,211249,117
DE-BB,11-06-2020,RKI,1,1,0,1591833600000,12065,Oberhavel,254,9,245,211249,117
DE-BB,18-06-2020,RKI,0,0,0,1592438400000,12065,Oberhavel,254,9,245,211249,117
DE-BB,23-06-2020,RKI,0,0,0,1592870400000,12065,Oberhavel,254,9,245,211249,117
DE-BB,25-06-2020,RKI,1,1,0,1593043200000,12065,Oberhavel,255,9,246,211249,117
DE-BB,01-07-2020,RKI,0,0,0,1593561600000,12065,Oberhavel,255,9,246,211249,117
DE-BB,04-07-2020,RKI,0,0,0,1593820800000,12065,Oberhavel,255,9,246,211249,117
DE-BB,06-07-2020,RKI,0,0,0,1593993600000,12065,Oberhavel,255,9,246,211249,117
DE-BB,09-07-2020,RKI,0,0,0,1594252800000,12065,Oberhavel,255,9,246,211249,117
DE-BB,14-07-2020,RKI,0,0,0,1594684800000,12065,Oberhavel,255,9,246,211249,117
DE-BB,10-03-2020,RKI,0,0,0,1583798400000,12066,Oberspreewald-Lausitz,0,0,0,110476,90
DE-BB,16-03-2020,RKI,1,1,0,1584316800000,12066,Oberspreewald-Lausitz,1,0,1,110476,90
DE-BB,17-03-2020,RKI,0,0,0,1584403200000,12066,Oberspreewald-Lausitz,1,0,1,110476,90
DE-BB,19-03-2020,RKI,0,0,0,1584576000000,12066,Oberspreewald-Lausitz,1,0,1,110476,90
DE-BB,23-03-2020,RKI,4,4,0,1584921600000,12066,Oberspreewald-Lausitz,5,0,5,110476,90
DE-BB,24-03-2020,RKI,1,1,0,1585008000000,12066,Oberspreewald-Lausitz,6,0,6,110476,90
DE-BB,27-03-2020,RKI,0,0,0,1585267200000,12066,Oberspreewald-Lausitz,6,0,6,110476,90
DE-BB,28-03-2020,RKI,1,1,0,1585353600000,12066,Oberspreewald-Lausitz,7,0,7,110476,90
DE-BB,30-03-2020,RKI,1,1,0,1585526400000,12066,Oberspreewald-Lausitz,8,0,8,110476,90
DE-BB,31-03-2020,RKI,0,0,0,1585612800000,12066,Oberspreewald-Lausitz,8,0,8,110476,90
DE-BB,01-04-2020,RKI,2,2,0,1585699200000,12066,Oberspreewald-Lausitz,10,0,10,110476,90
DE-BB,02-04-2020,RKI,2,2,0,1585785600000,12066,Oberspreewald-Lausitz,12,0,12,110476,90
DE-BB,03-04-2020,RKI,2,2,0,1585872000000,12066,Oberspreewald-Lausitz,14,0,14,110476,90
DE-BB,06-04-2020,RKI,2,1,1,1586131200000,12066,Oberspreewald-Lausitz,16,1,15,110476,90
DE-BB,08-04-2020,RKI,1,1,0,1586304000000,12066,Oberspreewald-Lausitz,17,1,16,110476,90
DE-BB,09-04-2020,RKI,2,2,0,1586390400000,12066,Oberspreewald-Lausitz,19,1,18,110476,90
DE-BB,13-04-2020,RKI,0,0,0,1586736000000,12066,Oberspreewald-Lausitz,19,1,18,110476,90
DE-BB,14-04-2020,RKI,0,0,0,1586822400000,12066,Oberspreewald-Lausitz,19,1,18,110476,90
DE-BB,16-04-2020,RKI,0,0,0,1586995200000,12066,Oberspreewald-Lausitz,19,1,18,110476,90
DE-BB,17-04-2020,RKI,0,0,0,1587081600000,12066,Oberspreewald-Lausitz,19,1,18,110476,90
DE-BB,22-04-2020,RKI,1,1,0,1587513600000,12066,Oberspreewald-Lausitz,20,1,19,110476,90
DE-BB,30-04-2020,RKI,0,0,0,1588204800000,12066,Oberspreewald-Lausitz,20,1,19,110476,90
DE-BB,07-05-2020,RKI,1,1,0,1588809600000,12066,Oberspreewald-Lausitz,21,1,20,110476,90
DE-BB,11-05-2020,RKI,0,0,0,1589155200000,12066,Oberspreewald-Lausitz,21,1,20,110476,90
DE-BB,13-05-2020,RKI,2,2,0,1589328000000,12066,Oberspreewald-Lausitz,23,1,22,110476,90
DE-BB,28-05-2020,RKI,0,0,0,1590624000000,12066,Oberspreewald-Lausitz,23,1,22,110476,90
DE-BB,04-06-2020,RKI,0,0,0,1591228800000,12066,Oberspreewald-Lausitz,23,1,22,110476,90
DE-BB,10-06-2020,RKI,0,0,0,1591747200000,12066,Oberspreewald-Lausitz,23,1,22,110476,90
DE-BB,30-06-2020,RKI,0,0,0,1593475200000,12066,Oberspreewald-Lausitz,23,1,22,110476,90
DE-BB,09-07-2020,RKI,0,0,0,1594252800000,12066,Oberspreewald-Lausitz,23,1,22,110476,90
DE-BB,11-07-2020,RKI,1,0,0,1594425600000,12066,Oberspreewald-Lausitz,24,1,22,110476,90
DE-BB,14-07-2020,RKI,1,0,0,1594684800000,12066,Oberspreewald-Lausitz,25,1,22,110476,90
DE-BB,11-03-2020,RKI,0,0,0,1583884800000,12067,Oder-Spree,0,0,0,178658,79
DE-BB,12-03-2020,RKI,0,0,0,1583971200000,12067,Oder-Spree,0,0,0,178658,79
DE-BB,13-03-2020,RKI,0,0,0,1584057600000,12067,Oder-Spree,0,0,0,178658,79
DE-BB,14-03-2020,RKI,1,1,0,1584144000000,12067,Oder-Spree,1,0,1,178658,79
DE-BB,15-03-2020,RKI,2,2,0,1584230400000,12067,Oder-Spree,3,0,3,178658,79
DE-BB,17-03-2020,RKI,2,2,0,1584403200000,12067,Oder-Spree,5,0,5,178658,79
DE-BB,18-03-2020,RKI,8,8,0,1584489600000,12067,Oder-Spree,13,0,13,178658,79
DE-BB,19-03-2020,RKI,9,9,0,1584576000000,12067,Oder-Spree,22,0,22,178658,79
DE-BB,20-03-2020,RKI,2,2,0,1584662400000,12067,Oder-Spree,24,0,24,178658,79
DE-BB,21-03-2020,RKI,4,4,0,1584748800000,12067,Oder-Spree,28,0,28,178658,79
DE-BB,22-03-2020,RKI,1,1,0,1584835200000,12067,Oder-Spree,29,0,29,178658,79
DE-BB,23-03-2020,RKI,1,1,0,1584921600000,12067,Oder-Spree,30,0,30,178658,79
DE-BB,24-03-2020,RKI,3,3,0,1585008000000,12067,Oder-Spree,33,0,33,178658,79
DE-BB,25-03-2020,RKI,1,1,0,1585094400000,12067,Oder-Spree,34,0,34,178658,79
DE-BB,26-03-2020,RKI,8,8,0,1585180800000,12067,Oder-Spree,42,0,42,178658,79
DE-BB,27-03-2020,RKI,4,4,0,1585267200000,12067,Oder-Spree,46,0,46,178658,79
DE-BB,28-03-2020,RKI,6,6,0,1585353600000,12067,Oder-Spree,52,0,52,178658,79
DE-BB,29-03-2020,RKI,1,1,0,1585440000000,12067,Oder-Spree,53,0,53,178658,79
DE-BB,30-03-2020,RKI,1,1,0,1585526400000,12067,Oder-Spree,54,0,54,178658,79
DE-BB,31-03-2020,RKI,1,1,0,1585612800000,12067,Oder-Spree,55,0,55,178658,79
DE-BB,01-04-2020,RKI,0,0,0,1585699200000,12067,Oder-Spree,55,0,55,178658,79
DE-BB,02-04-2020,RKI,0,0,0,1585785600000,12067,Oder-Spree,55,0,55,178658,79
DE-BB,03-04-2020,RKI,1,1,0,1585872000000,12067,Oder-Spree,56,0,56,178658,79
DE-BB,04-04-2020,RKI,0,0,0,1585958400000,12067,Oder-Spree,56,0,56,178658,79
DE-BB,07-04-2020,RKI,5,5,0,1586217600000,12067,Oder-Spree,61,0,61,178658,79
DE-BB,09-04-2020,RKI,3,3,0,1586390400000,12067,Oder-Spree,64,0,64,178658,79
DE-BB,11-04-2020,RKI,1,1,0,1586563200000,12067,Oder-Spree,65,0,65,178658,79
DE-BB,12-04-2020,RKI,1,1,0,1586649600000,12067,Oder-Spree,66,0,66,178658,79
DE-BB,14-04-2020,RKI,1,1,0,1586822400000,12067,Oder-Spree,67,0,67,178658,79
DE-BB,17-04-2020,RKI,2,2,0,1587081600000,12067,Oder-Spree,69,0,69,178658,79
DE-BB,18-04-2020,RKI,0,0,0,1587168000000,12067,Oder-Spree,69,0,69,178658,79
DE-BB,20-04-2020,RKI,3,2,1,1587340800000,12067,Oder-Spree,72,1,71,178658,79
DE-BB,21-04-2020,RKI,0,0,0,1587427200000,12067,Oder-Spree,72,1,71,178658,79
DE-BB,22-04-2020,RKI,0,0,0,1587513600000,12067,Oder-Spree,72,1,71,178658,79
DE-BB,23-04-2020,RKI,0,0,0,1587600000000,12067,Oder-Spree,72,1,71,178658,79
DE-BB,24-04-2020,RKI,3,3,0,1587686400000,12067,Oder-Spree,75,1,74,178658,79
DE-BB,25-04-2020,RKI,2,2,0,1587772800000,12067,Oder-Spree,77,1,76,178658,79
DE-BB,27-04-2020,RKI,0,0,0,1587945600000,12067,Oder-Spree,77,1,76,178658,79
DE-BB,29-04-2020,RKI,2,2,0,1588118400000,12067,Oder-Spree,79,1,78,178658,79
DE-BB,30-04-2020,RKI,0,0,0,1588204800000,12067,Oder-Spree,79,1,78,178658,79
DE-BB,01-05-2020,RKI,1,1,0,1588291200000,12067,Oder-Spree,80,1,79,178658,79
DE-BB,02-05-2020,RKI,1,1,0,1588377600000,12067,Oder-Spree,81,1,80,178658,79
DE-BB,06-05-2020,RKI,0,0,0,1588723200000,12067,Oder-Spree,81,1,80,178658,79
DE-BB,13-05-2020,RKI,0,0,0,1589328000000,12067,Oder-Spree,81,1,80,178658,79
DE-BB,14-05-2020,RKI,0,0,0,1589414400000,12067,Oder-Spree,81,1,80,178658,79
DE-BB,26-05-2020,RKI,0,0,0,1590451200000,12067,Oder-Spree,81,1,80,178658,79
DE-BB,27-05-2020,RKI,0,0,0,1590537600000,12067,Oder-Spree,81,1,80,178658,79
DE-BB,02-06-2020,RKI,0,0,0,1591056000000,12067,Oder-Spree,81,1,80,178658,79
DE-BB,05-06-2020,RKI,1,1,0,1591315200000,12067,Oder-Spree,82,1,81,178658,79
DE-BB,10-06-2020,RKI,0,0,0,1591747200000,12067,Oder-Spree,82,1,81,178658,79
DE-BB,11-06-2020,RKI,0,0,0,1591833600000,12067,Oder-Spree,82,1,81,178658,79
DE-BB,12-06-2020,RKI,0,0,0,1591920000000,12067,Oder-Spree,82,1,81,178658,79
DE-BB,13-06-2020,RKI,2,2,0,1592006400000,12067,Oder-Spree,84,1,83,178658,79
DE-BB,19-06-2020,RKI,0,0,0,1592524800000,12067,Oder-Spree,84,1,83,178658,79
DE-BB,02-07-2020,RKI,0,0,0,1593648000000,12067,Oder-Spree,84,1,83,178658,79
DE-BB,06-07-2020,RKI,0,0,0,1593993600000,12067,Oder-Spree,84,1,83,178658,79
DE-BB,10-07-2020,RKI,0,0,0,1594339200000,12067,Oder-Spree,84,1,83,178658,79
DE-BB,11-07-2020,RKI,0,0,0,1594425600000,12067,Oder-Spree,84,1,83,178658,79
DE-BB,19-03-2020,RKI,0,0,0,1584576000000,12068,Ostprignitz-Ruppin,4,0,4,99078,39
DE-BB,25-03-2020,RKI,1,1,0,1585094400000,12068,Ostprignitz-Ruppin,5,0,5,99078,39
DE-BB,26-03-2020,RKI,0,0,0,1585180800000,12068,Ostprignitz-Ruppin,5,0,5,99078,39
DE-BB,27-03-2020,RKI,1,1,0,1585267200000,12068,Ostprignitz-Ruppin,6,0,6,99078,39
DE-BB,28-03-2020,RKI,0,0,0,1585353600000,12068,Ostprignitz-Ruppin,6,0,6,99078,39
DE-BB,30-03-2020,RKI,1,1,0,1585526400000,12068,Ostprignitz-Ruppin,7,0,7,99078,39
DE-BB,31-03-2020,RKI,3,3,0,1585612800000,12068,Ostprignitz-Ruppin,10,0,10,99078,39
DE-BB,01-04-2020,RKI,0,0,0,1585699200000,12068,Ostprignitz-Ruppin,10,0,10,99078,39
DE-BB,02-04-2020,RKI,1,1,0,1585785600000,12068,Ostprignitz-Ruppin,11,0,11,99078,39
DE-BB,03-04-2020,RKI,3,3,0,1585872000000,12068,Ostprignitz-Ruppin,14,0,14,99078,39
DE-BB,04-04-2020,RKI,0,0,0,1585958400000,12068,Ostprignitz-Ruppin,14,0,14,99078,39
DE-BB,06-04-2020,RKI,0,0,0,1586131200000,12068,Ostprignitz-Ruppin,14,0,14,99078,39
DE-BB,07-04-2020,RKI,0,0,0,1586217600000,12068,Ostprignitz-Ruppin,14,0,14,99078,39
DE-BB,08-04-2020,RKI,0,0,0,1586304000000,12068,Ostprignitz-Ruppin,14,0,14,99078,39
DE-BB,09-04-2020,RKI,6,6,0,1586390400000,12068,Ostprignitz-Ruppin,20,0,20,99078,39
DE-BB,10-04-2020,RKI,0,0,0,1586476800000,12068,Ostprignitz-Ruppin,20,0,20,99078,39
DE-BB,18-04-2020,RKI,0,0,0,1587168000000,12068,Ostprignitz-Ruppin,20,0,20,99078,39
DE-BB,21-04-2020,RKI,8,8,0,1587427200000,12068,Ostprignitz-Ruppin,28,0,28,99078,39
DE-BB,22-04-2020,RKI,1,1,0,1587513600000,12068,Ostprignitz-Ruppin,29,0,29,99078,39
DE-BB,23-04-2020,RKI,3,3,0,1587600000000,12068,Ostprignitz-Ruppin,32,0,32,99078,39
DE-BB,24-04-2020,RKI,0,0,0,1587686400000,12068,Ostprignitz-Ruppin,32,0,32,99078,39
DE-BB,28-04-2020,RKI,5,5,0,1588032000000,12068,Ostprignitz-Ruppin,37,0,37,99078,39
DE-BB,29-04-2020,RKI,3,3,0,1588118400000,12068,Ostprignitz-Ruppin,40,0,40,99078,39
DE-BB,30-04-2020,RKI,0,0,0,1588204800000,12068,Ostprignitz-Ruppin,40,0,40,99078,39
DE-BB,02-05-2020,RKI,0,0,0,1588377600000,12068,Ostprignitz-Ruppin,40,0,40,99078,39
DE-BB,08-05-2020,RKI,4,4,0,1588896000000,12068,Ostprignitz-Ruppin,44,0,44,99078,39
DE-BB,14-05-2020,RKI,5,5,0,1589414400000,12068,Ostprignitz-Ruppin,49,0,49,99078,39
DE-BB,18-05-2020,RKI,0,0,0,1589760000000,12068,Ostprignitz-Ruppin,49,0,49,99078,39
DE-BB,19-05-2020,RKI,0,0,0,1589846400000,12068,Ostprignitz-Ruppin,49,0,49,99078,39
DE-BB,18-06-2020,RKI,0,0,0,1592438400000,12068,Ostprignitz-Ruppin,49,0,49,99078,39
DE-BB,01-07-2020,RKI,0,0,0,1593561600000,12068,Ostprignitz-Ruppin,49,0,49,99078,39
DE-BB,02-07-2020,RKI,1,1,0,1593648000000,12068,Ostprignitz-Ruppin,50,0,50,99078,39
DE-BB,03-07-2020,RKI,1,1,0,1593734400000,12068,Ostprignitz-Ruppin,51,0,51,99078,39
DE-BB,04-07-2020,RKI,0,0,0,1593820800000,12068,Ostprignitz-Ruppin,51,0,51,99078,39
DE-BB,06-07-2020,RKI,0,0,0,1593993600000,12068,Ostprignitz-Ruppin,51,0,51,99078,39
DE-BB,14-07-2020,RKI,0,0,0,1594684800000,12068,Ostprignitz-Ruppin,51,0,51,99078,39
DE-BB,13-03-2020,RKI,0,0,0,1584057600000,12069,Potsdam-Mittelmark,3,0,3,214664,83
DE-BB,15-03-2020,RKI,1,1,0,1584230400000,12069,Potsdam-Mittelmark,4,0,4,214664,83
DE-BB,17-03-2020,RKI,2,2,0,1584403200000,12069,Potsdam-Mittelmark,6,0,6,214664,83
DE-BB,18-03-2020,RKI,3,3,0,1584489600000,12069,Potsdam-Mittelmark,9,0,9,214664,83
DE-BB,19-03-2020,RKI,2,2,0,1584576000000,12069,Potsdam-Mittelmark,11,0,11,214664,83
DE-BB,20-03-2020,RKI,3,3,0,1584662400000,12069,Potsdam-Mittelmark,14,0,14,214664,83
DE-BB,21-03-2020,RKI,4,4,0,1584748800000,12069,Potsdam-Mittelmark,18,0,18,214664,83
DE-BB,22-03-2020,RKI,1,1,0,1584835200000,12069,Potsdam-Mittelmark,19,0,19,214664,83
DE-BB,23-03-2020,RKI,7,7,0,1584921600000,12069,Potsdam-Mittelmark,26,0,26,214664,83
DE-BB,24-03-2020,RKI,3,3,0,1585008000000,12069,Potsdam-Mittelmark,29,0,29,214664,83
DE-BB,25-03-2020,RKI,17,17,0,1585094400000,12069,Potsdam-Mittelmark,46,0,46,214664,83
DE-BB,26-03-2020,RKI,8,8,0,1585180800000,12069,Potsdam-Mittelmark,54,0,54,214664,83
DE-BB,27-03-2020,RKI,3,3,0,1585267200000,12069,Potsdam-Mittelmark,57,0,57,214664,83
DE-BB,28-03-2020,RKI,1,1,0,1585353600000,12069,Potsdam-Mittelmark,58,0,58,214664,83
DE-BB,29-03-2020,RKI,1,1,0,1585440000000,12069,Potsdam-Mittelmark,59,0,59,214664,83
DE-BB,30-03-2020,RKI,13,12,1,1585526400000,12069,Potsdam-Mittelmark,72,1,71,214664,83
DE-BB,31-03-2020,RKI,24,20,4,1585612800000,12069,Potsdam-Mittelmark,96,5,91,214664,83
DE-BB,01-04-2020,RKI,8,7,1,1585699200000,12069,Potsdam-Mittelmark,104,6,98,214664,83
DE-BB,02-04-2020,RKI,30,26,4,1585785600000,12069,Potsdam-Mittelmark,134,10,124,214664,83
DE-BB,03-04-2020,RKI,28,26,2,1585872000000,12069,Potsdam-Mittelmark,162,12,150,214664,83
DE-BB,04-04-2020,RKI,2,2,0,1585958400000,12069,Potsdam-Mittelmark,164,12,152,214664,83
DE-BB,05-04-2020,RKI,4,4,0,1586044800000,12069,Potsdam-Mittelmark,168,12,156,214664,83
DE-BB,06-04-2020,RKI,12,9,3,1586131200000,12069,Potsdam-Mittelmark,180,15,165,214664,83
DE-BB,07-04-2020,RKI,7,7,0,1586217600000,12069,Potsdam-Mittelmark,187,15,172,214664,83
DE-BB,08-04-2020,RKI,6,6,0,1586304000000,12069,Potsdam-Mittelmark,193,15,178,214664,83
DE-BB,09-04-2020,RKI,11,11,0,1586390400000,12069,Potsdam-Mittelmark,204,15,189,214664,83
DE-BB,10-04-2020,RKI,0,0,0,1586476800000,12069,Potsdam-Mittelmark,204,15,189,214664,83
DE-BB,11-04-2020,RKI,1,1,0,1586563200000,12069,Potsdam-Mittelmark,205,15,190,214664,83
DE-BB,12-04-2020,RKI,3,3,0,1586649600000,12069,Potsdam-Mittelmark,208,15,193,214664,83
DE-BB,14-04-2020,RKI,17,17,0,1586822400000,12069,Potsdam-Mittelmark,225,15,210,214664,83
DE-BB,15-04-2020,RKI,17,14,3,1586908800000,12069,Potsdam-Mittelmark,242,18,224,214664,83
DE-BB,16-04-2020,RKI,11,9,2,1586995200000,12069,Potsdam-Mittelmark,253,20,233,214664,83
DE-BB,17-04-2020,RKI,11,11,0,1587081600000,12069,Potsdam-Mittelmark,264,20,244,214664,83
DE-BB,18-04-2020,RKI,2,1,1,1587168000000,12069,Potsdam-Mittelmark,266,21,245,214664,83
DE-BB,19-04-2020,RKI,10,9,1,1587254400000,12069,Potsdam-Mittelmark,276,22,254,214664,83
DE-BB,20-04-2020,RKI,18,15,3,1587340800000,12069,Potsdam-Mittelmark,294,25,269,214664,83
DE-BB,21-04-2020,RKI,7,6,1,1587427200000,12069,Potsdam-Mittelmark,301,26,275,214664,83
DE-BB,22-04-2020,RKI,7,6,1,1587513600000,12069,Potsdam-Mittelmark,308,27,281,214664,83
DE-BB,23-04-2020,RKI,9,7,2,1587600000000,12069,Potsdam-Mittelmark,317,29,288,214664,83
DE-BB,24-04-2020,RKI,27,26,1,1587686400000,12069,Potsdam-Mittelmark,344,30,314,214664,83
DE-BB,25-04-2020,RKI,8,7,1,1587772800000,12069,Potsdam-Mittelmark,352,31,321,214664,83
DE-BB,27-04-2020,RKI,9,8,1,1587945600000,12069,Potsdam-Mittelmark,361,32,329,214664,83
DE-BB,28-04-2020,RKI,14,13,1,1588032000000,12069,Potsdam-Mittelmark,375,33,342,214664,83
DE-BB,29-04-2020,RKI,7,7,0,1588118400000,12069,Potsdam-Mittelmark,382,33,349,214664,83
DE-BB,30-04-2020,RKI,11,10,1,1588204800000,12069,Potsdam-Mittelmark,393,34,359,214664,83
DE-BB,01-05-2020,RKI,1,1,0,1588291200000,12069,Potsdam-Mittelmark,394,34,360,214664,83
DE-BB,02-05-2020,RKI,1,1,0,1588377600000,12069,Potsdam-Mittelmark,395,34,361,214664,83
DE-BB,03-05-2020,RKI,0,0,0,1588464000000,12069,Potsdam-Mittelmark,395,34,361,214664,83
DE-BB,04-05-2020,RKI,7,6,1,1588550400000,12069,Potsdam-Mittelmark,402,35,367,214664,83
DE-BB,05-05-2020,RKI,6,6,0,1588636800000,12069,Potsdam-Mittelmark,408,35,373,214664,83
DE-BB,06-05-2020,RKI,1,1,0,1588723200000,12069,Potsdam-Mittelmark,409,35,374,214664,83
DE-BB,08-05-2020,RKI,1,1,0,1588896000000,12069,Potsdam-Mittelmark,410,35,375,214664,83
DE-BB,09-05-2020,RKI,0,0,0,1588982400000,12069,Potsdam-Mittelmark,410,35,375,214664,83
DE-BB,10-05-2020,RKI,1,1,0,1589068800000,12069,Potsdam-Mittelmark,411,35,376,214664,83
DE-BB,11-05-2020,RKI,4,4,0,1589155200000,12069,Potsdam-Mittelmark,415,35,380,214664,83
DE-BB,12-05-2020,RKI,0,0,0,1589241600000,12069,Potsdam-Mittelmark,415,35,380,214664,83
DE-BB,13-05-2020,RKI,1,1,0,1589328000000,12069,Potsdam-Mittelmark,416,35,381,214664,83
DE-BB,14-05-2020,RKI,2,2,0,1589414400000,12069,Potsdam-Mittelmark,418,35,383,214664,83
DE-BB,15-05-2020,RKI,2,2,0,1589500800000,12069,Potsdam-Mittelmark,420,35,385,214664,83
DE-BB,16-05-2020,RKI,11,11,0,1589587200000,12069,Potsdam-Mittelmark,431,35,396,214664,83
DE-BB,17-05-2020,RKI,0,0,0,1589673600000,12069,Potsdam-Mittelmark,431,35,396,214664,83
DE-BB,18-05-2020,RKI,1,1,0,1589760000000,12069,Potsdam-Mittelmark,432,35,397,214664,83
DE-BB,19-05-2020,RKI,0,0,0,1589846400000,12069,Potsdam-Mittelmark,432,35,397,214664,83
DE-BB,20-05-2020,RKI,6,6,0,1589932800000,12069,Potsdam-Mittelmark,438,35,403,214664,83
DE-BB,21-05-2020,RKI,1,1,0,1590019200000,12069,Potsdam-Mittelmark,439,35,404,214664,83
DE-BB,22-05-2020,RKI,0,0,0,1590105600000,12069,Potsdam-Mittelmark,439,35,404,214664,83
DE-BB,23-05-2020,RKI,3,3,0,1590192000000,12069,Potsdam-Mittelmark,442,35,407,214664,83
DE-BB,24-05-2020,RKI,0,0,0,1590278400000,12069,Potsdam-Mittelmark,442,35,407,214664,83
DE-BB,25-05-2020,RKI,3,3,0,1590364800000,12069,Potsdam-Mittelmark,445,35,410,214664,83
DE-BB,26-05-2020,RKI,2,2,0,1590451200000,12069,Potsdam-Mittelmark,447,35,412,214664,83
DE-BB,27-05-2020,RKI,2,1,1,1590537600000,12069,Potsdam-Mittelmark,449,36,413,214664,83
DE-BB,28-05-2020,RKI,0,0,0,1590624000000,12069,Potsdam-Mittelmark,449,36,413,214664,83
DE-BB,29-05-2020,RKI,0,0,0,1590710400000,12069,Potsdam-Mittelmark,449,36,413,214664,83
DE-BB,03-06-2020,RKI,1,1,0,1591142400000,12069,Potsdam-Mittelmark,450,36,414,214664,83
DE-BB,05-06-2020,RKI,0,0,0,1591315200000,12069,Potsdam-Mittelmark,450,36,414,214664,83
DE-BB,09-06-2020,RKI,1,1,0,1591660800000,12069,Potsdam-Mittelmark,451,36,415,214664,83
DE-BB,13-06-2020,RKI,0,0,0,1592006400000,12069,Potsdam-Mittelmark,451,36,415,214664,83
DE-BB,14-06-2020,RKI,0,0,0,1592092800000,12069,Potsdam-Mittelmark,451,36,415,214664,83
DE-BB,15-06-2020,RKI,1,1,0,1592179200000,12069,Potsdam-Mittelmark,452,36,416,214664,83
DE-BB,18-06-2020,RKI,0,0,0,1592438400000,12069,Potsdam-Mittelmark,452,36,416,214664,83
DE-BB,19-06-2020,RKI,0,0,0,1592524800000,12069,Potsdam-Mittelmark,452,36,416,214664,83
DE-BB,23-06-2020,RKI,2,2,0,1592870400000,12069,Potsdam-Mittelmark,454,36,418,214664,83
DE-BB,24-06-2020,RKI,4,4,0,1592956800000,12069,Potsdam-Mittelmark,458,36,422,214664,83
DE-BB,28-06-2020,RKI,0,0,0,1593302400000,12069,Potsdam-Mittelmark,458,36,422,214664,83
DE-BB,04-07-2020,RKI,1,0,0,1593820800000,12069,Potsdam-Mittelmark,459,36,422,214664,83
DE-BB,24-03-2020,RKI,3,3,0,1585008000000,12070,Prignitz,3,0,3,76508,36
DE-BB,25-03-2020,RKI,0,0,0,1585094400000,12070,Prignitz,3,0,3,76508,36
DE-BB,26-03-2020,RKI,2,2,0,1585180800000,12070,Prignitz,5,0,5,76508,36
DE-BB,03-04-2020,RKI,2,2,0,1585872000000,12070,Prignitz,7,0,7,76508,36
DE-BB,04-04-2020,RKI,1,1,0,1585958400000,12070,Prignitz,8,0,8,76508,36
DE-BB,06-04-2020,RKI,1,1,0,1586131200000,12070,Prignitz,9,0,9,76508,36
DE-BB,07-04-2020,RKI,0,0,0,1586217600000,12070,Prignitz,9,0,9,76508,36
DE-BB,08-04-2020,RKI,0,0,0,1586304000000,12070,Prignitz,9,0,9,76508,36
DE-BB,09-04-2020,RKI,1,1,0,1586390400000,12070,Prignitz,10,0,10,76508,36
DE-BB,14-04-2020,RKI,2,2,0,1586822400000,12070,Prignitz,12,0,12,76508,36
DE-BB,02-05-2020,RKI,0,0,0,1588377600000,12070,Prignitz,12,0,12,76508,36
DE-BB,12-05-2020,RKI,0,0,0,1589241600000,12070,Prignitz,12,0,12,76508,36
DE-BB,06-06-2020,RKI,0,0,0,1591401600000,12070,Prignitz,12,0,12,76508,36
DE-BB,15-06-2020,RKI,1,1,0,1592179200000,12070,Prignitz,13,0,13,76508,36
DE-BB,19-06-2020,RKI,2,2,0,1592524800000,12070,Prignitz,15,0,15,76508,36
DE-BB,09-03-2020,RKI,0,0,0,1583712000000,12071,Spree-Neiße,0,0,0,114429,69
DE-BB,11-03-2020,RKI,0,0,0,1583884800000,12071,Spree-Neiße,0,0,0,114429,69
DE-BB,12-03-2020,RKI,1,1,0,1583971200000,12071,Spree-Neiße,1,0,1,114429,69
DE-BB,13-03-2020,RKI,2,2,0,1584057600000,12071,Spree-Neiße,3,0,3,114429,69
DE-BB,14-03-2020,RKI,1,1,0,1584144000000,12071,Spree-Neiße,4,0,4,114429,69
DE-BB,16-03-2020,RKI,1,1,0,1584316800000,12071,Spree-Neiße,5,0,5,114429,69
DE-BB,17-03-2020,RKI,6,6,0,1584403200000,12071,Spree-Neiße,11,0,11,114429,69
DE-BB,18-03-2020,RKI,0,0,0,1584489600000,12071,Spree-Neiße,11,0,11,114429,69
DE-BB,19-03-2020,RKI,1,1,0,1584576000000,12071,Spree-Neiße,12,0,12,114429,69
DE-BB,20-03-2020,RKI,0,0,0,1584662400000,12071,Spree-Neiße,12,0,12,114429,69
DE-BB,23-03-2020,RKI,5,5,0,1584921600000,12071,Spree-Neiße,17,0,17,114429,69
DE-BB,25-03-2020,RKI,5,5,0,1585094400000,12071,Spree-Neiße,22,0,22,114429,69
DE-BB,26-03-2020,RKI,2,2,0,1585180800000,12071,Spree-Neiße,24,0,24,114429,69
DE-BB,27-03-2020,RKI,2,2,0,1585267200000,12071,Spree-Neiße,26,0,26,114429,69
DE-BB,28-03-2020,RKI,1,1,0,1585353600000,12071,Spree-Neiße,27,0,27,114429,69
DE-BB,30-03-2020,RKI,1,1,0,1585526400000,12071,Spree-Neiße,28,0,28,114429,69
DE-BB,31-03-2020,RKI,0,0,0,1585612800000,12071,Spree-Neiße,28,0,28,114429,69
DE-BB,01-04-2020,RKI,0,0,0,1585699200000,12071,Spree-Neiße,28,0,28,114429,69
DE-BB,02-04-2020,RKI,0,0,0,1585785600000,12071,Spree-Neiße,28,0,28,114429,69
DE-BB,03-04-2020,RKI,0,0,0,1585872000000,12071,Spree-Neiße,28,0,28,114429,69
DE-BB,06-04-2020,RKI,1,1,0,1586131200000,12071,Spree-Neiße,29,0,29,114429,69
DE-BB,14-04-2020,RKI,0,0,0,1586822400000,12071,Spree-Neiße,29,0,29,114429,69
DE-BB,18-04-2020,RKI,0,0,0,1587168000000,12071,Spree-Neiße,29,0,29,114429,69
DE-BB,20-04-2020,RKI,0,0,0,1587340800000,12071,Spree-Neiße,29,0,29,114429,69
DE-BB,24-04-2020,RKI,2,2,0,1587686400000,12071,Spree-Neiße,31,0,31,114429,69
DE-BB,26-04-2020,RKI,0,0,0,1587859200000,12071,Spree-Neiße,31,0,31,114429,69
DE-BB,27-04-2020,RKI,4,4,0,1587945600000,12071,Spree-Neiße,35,0,35,114429,69
DE-BB,30-05-2020,RKI,0,0,0,1590796800000,12071,Spree-Neiße,35,0,35,114429,69
DE-BB,18-06-2020,RKI,0,0,0,1592438400000,12071,Spree-Neiße,35,0,35,114429,69
DE-BB,20-06-2020,RKI,0,0,0,1592611200000,12071,Spree-Neiße,35,0,35,114429,69
DE-BB,11-07-2020,RKI,0,0,0,1594425600000,12071,Spree-Neiße,35,0,35,114429,69
DE-BB,13-03-2020,RKI,0,0,0,1584057600000,12072,Teltow-Fläming,0,0,0,168296,80
DE-BB,14-03-2020,RKI,3,3,0,1584144000000,12072,Teltow-Fläming,3,0,3,168296,80
DE-BB,17-03-2020,RKI,3,3,0,1584403200000,12072,Teltow-Fläming,6,0,6,168296,80
DE-BB,18-03-2020,RKI,0,0,0,1584489600000,12072,Teltow-Fläming,6,0,6,168296,80
DE-BB,19-03-2020,RKI,0,0,0,1584576000000,12072,Teltow-Fläming,6,0,6,168296,80
DE-BB,20-03-2020,RKI,3,3,0,1584662400000,12072,Teltow-Fläming,9,0,9,168296,80
DE-BB,21-03-2020,RKI,2,2,0,1584748800000,12072,Teltow-Fläming,11,0,11,168296,80
DE-BB,22-03-2020,RKI,1,1,0,1584835200000,12072,Teltow-Fläming,12,0,12,168296,80
DE-BB,25-03-2020,RKI,13,13,0,1585094400000,12072,Teltow-Fläming,25,0,25,168296,80
DE-BB,26-03-2020,RKI,0,0,0,1585180800000,12072,Teltow-Fläming,25,0,25,168296,80
DE-BB,27-03-2020,RKI,4,4,0,1585267200000,12072,Teltow-Fläming,29,0,29,168296,80
DE-BB,28-03-2020,RKI,0,0,0,1585353600000,12072,Teltow-Fläming,29,0,29,168296,80
DE-BB,30-03-2020,RKI,6,4,2,1585526400000,12072,Teltow-Fläming,35,2,33,168296,80
DE-BB,31-03-2020,RKI,4,4,0,1585612800000,12072,Teltow-Fläming,39,2,37,168296,80
DE-BB,01-04-2020,RKI,1,1,0,1585699200000,12072,Teltow-Fläming,40,2,38,168296,80
DE-BB,02-04-2020,RKI,5,4,1,1585785600000,12072,Teltow-Fläming,45,3,42,168296,80
DE-BB,03-04-2020,RKI,2,1,1,1585872000000,12072,Teltow-Fläming,47,4,43,168296,80
DE-BB,04-04-2020,RKI,2,1,1,1585958400000,12072,Teltow-Fläming,49,5,44,168296,80
DE-BB,06-04-2020,RKI,1,1,0,1586131200000,12072,Teltow-Fläming,50,5,45,168296,80
DE-BB,07-04-2020,RKI,10,8,2,1586217600000,12072,Teltow-Fläming,60,7,53,168296,80
DE-BB,08-04-2020,RKI,4,3,1,1586304000000,12072,Teltow-Fläming,64,8,56,168296,80
DE-BB,09-04-2020,RKI,1,1,0,1586390400000,12072,Teltow-Fläming,65,8,57,168296,80
DE-BB,10-04-2020,RKI,0,0,0,1586476800000,12072,Teltow-Fläming,65,8,57,168296,80
DE-BB,11-04-2020,RKI,0,0,0,1586563200000,12072,Teltow-Fläming,65,8,57,168296,80
DE-BB,14-04-2020,RKI,4,4,0,1586822400000,12072,Teltow-Fläming,69,8,61,168296,80
DE-BB,15-04-2020,RKI,1,1,0,1586908800000,12072,Teltow-Fläming,70,8,62,168296,80
DE-BB,16-04-2020,RKI,2,2,0,1586995200000,12072,Teltow-Fläming,72,8,64,168296,80
DE-BB,17-04-2020,RKI,1,1,0,1587081600000,12072,Teltow-Fläming,73,8,65,168296,80
DE-BB,18-04-2020,RKI,2,1,1,1587168000000,12072,Teltow-Fläming,75,9,66,168296,80
DE-BB,19-04-2020,RKI,2,2,0,1587254400000,12072,Teltow-Fläming,77,9,68,168296,80
DE-BB,20-04-2020,RKI,0,0,0,1587340800000,12072,Teltow-Fläming,77,9,68,168296,80
DE-BB,21-04-2020,RKI,4,4,0,1587427200000,12072,Teltow-Fläming,81,9,72,168296,80
DE-BB,22-04-2020,RKI,2,2,0,1587513600000,12072,Teltow-Fläming,83,9,74,168296,80
DE-BB,23-04-2020,RKI,1,1,0,1587600000000,12072,Teltow-Fläming,84,9,75,168296,80
DE-BB,24-04-2020,RKI,1,1,0,1587686400000,12072,Teltow-Fläming,85,9,76,168296,80
DE-BB,27-04-2020,RKI,1,0,1,1587945600000,12072,Teltow-Fläming,86,10,76,168296,80
DE-BB,28-04-2020,RKI,1,1,0,1588032000000,12072,Teltow-Fläming,87,10,77,168296,80
DE-BB,29-04-2020,RKI,2,2,0,1588118400000,12072,Teltow-Fläming,89,10,79,168296,80
DE-BB,02-05-2020,RKI,0,0,0,1588377600000,12072,Teltow-Fläming,89,10,79,168296,80
DE-BB,03-05-2020,RKI,1,1,0,1588464000000,12072,Teltow-Fläming,90,10,80,168296,80
DE-BB,04-05-2020,RKI,1,1,0,1588550400000,12072,Teltow-Fläming,91,10,81,168296,80
DE-BB,06-05-2020,RKI,3,3,0,1588723200000,12072,Teltow-Fläming,94,10,84,168296,80
DE-BB,08-05-2020,RKI,4,4,0,1588896000000,12072,Teltow-Fläming,98,10,88,168296,80
DE-BB,14-05-2020,RKI,0,0,0,1589414400000,12072,Teltow-Fläming,98,10,88,168296,80
DE-BB,20-05-2020,RKI,0,0,0,1589932800000,12072,Teltow-Fläming,98,10,88,168296,80
DE-BB,15-06-2020,RKI,0,0,0,1592179200000,12072,Teltow-Fläming,98,10,88,168296,80
DE-BB,16-06-2020,RKI,1,1,0,1592265600000,12072,Teltow-Fläming,99,10,89,168296,80
DE-BB,17-06-2020,RKI,0,0,0,1592352000000,12072,Teltow-Fläming,99,10,89,168296,80
DE-BB,18-06-2020,RKI,0,0,0,1592438400000,12072,Teltow-Fläming,99,10,89,168296,80
DE-BB,19-06-2020,RKI,3,3,0,1592524800000,12072,Teltow-Fläming,102,10,92,168296,80
DE-BB,20-06-2020,RKI,4,4,0,1592611200000,12072,Teltow-Fläming,106,10,96,168296,80
DE-BB,22-06-2020,RKI,0,0,0,1592784000000,12072,Teltow-Fläming,106,10,96,168296,80
DE-BB,23-06-2020,RKI,5,5,0,1592870400000,12072,Teltow-Fläming,111,10,101,168296,80
DE-BB,26-06-2020,RKI,0,0,0,1593129600000,12072,Teltow-Fläming,111,10,101,168296,80
DE-BB,29-06-2020,RKI,0,0,0,1593388800000,12072,Teltow-Fläming,111,10,101,168296,80
DE-BB,01-07-2020,RKI,3,2,0,1593561600000,12072,Teltow-Fläming,114,10,103,168296,80
DE-BB,02-07-2020,RKI,0,0,0,1593648000000,12072,Teltow-Fläming,114,10,103,168296,80
DE-BB,06-07-2020,RKI,0,0,0,1593993600000,12072,Teltow-Fläming,114,10,103,168296,80
DE-BB,09-07-2020,RKI,1,0,0,1594252800000,12072,Teltow-Fläming,115,10,103,168296,80
DE-BB,10-07-2020,RKI,0,0,0,1594339200000,12072,Teltow-Fläming,115,10,103,168296,80
DE-BB,15-07-2020,RKI,0,0,0,1594771200000,12072,Teltow-Fläming,115,10,103,168296,80
DE-BB,18-03-2020,RKI,2,2,0,1584489600000,12073,Uckermark,2,0,2,119552,39
DE-BB,24-03-2020,RKI,0,0,0,1585008000000,12073,Uckermark,2,0,2,119552,39
DE-BB,26-03-2020,RKI,2,2,0,1585180800000,12073,Uckermark,4,0,4,119552,39
DE-BB,27-03-2020,RKI,0,0,0,1585267200000,12073,Uckermark,4,0,4,119552,39
DE-BB,28-03-2020,RKI,0,0,0,1585353600000,12073,Uckermark,4,0,4,119552,39
DE-BB,30-03-2020,RKI,7,6,1,1585526400000,12073,Uckermark,11,1,10,119552,39
DE-BB,01-04-2020,RKI,2,2,0,1585699200000,12073,Uckermark,13,1,12,119552,39
DE-BB,02-04-2020,RKI,0,0,0,1585785600000,12073,Uckermark,13,1,12,119552,39
DE-BB,06-04-2020,RKI,0,0,0,1586131200000,12073,Uckermark,13,1,12,119552,39
DE-BB,07-04-2020,RKI,0,0,0,1586217600000,12073,Uckermark,13,1,12,119552,39
DE-BB,10-04-2020,RKI,2,2,0,1586476800000,12073,Uckermark,15,1,14,119552,39
DE-BB,11-04-2020,RKI,0,0,0,1586563200000,12073,Uckermark,15,1,14,119552,39
DE-BB,12-04-2020,RKI,0,0,0,1586649600000,12073,Uckermark,15,1,14,119552,39
DE-BB,17-04-2020,RKI,1,1,0,1587081600000,12073,Uckermark,16,1,15,119552,39
DE-BB,18-04-2020,RKI,0,0,0,1587168000000,12073,Uckermark,16,1,15,119552,39
DE-BB,20-04-2020,RKI,0,0,0,1587340800000,12073,Uckermark,16,1,15,119552,39
DE-BB,21-04-2020,RKI,1,1,0,1587427200000,12073,Uckermark,17,1,16,119552,39
DE-BB,30-04-2020,RKI,0,0,0,1588204800000,12073,Uckermark,17,1,16,119552,39
DE-BB,27-05-2020,RKI,0,0,0,1590537600000,12073,Uckermark,17,1,16,119552,39
DE-BB,13-06-2020,RKI,0,0,0,1592006400000,12073,Uckermark,17,1,16,119552,39
DE-BB,16-06-2020,RKI,1,1,0,1592265600000,12073,Uckermark,18,1,17,119552,39
DE-BB,17-06-2020,RKI,2,2,0,1592352000000,12073,Uckermark,20,1,19,119552,39
DE-BB,18-06-2020,RKI,0,0,0,1592438400000,12073,Uckermark,20,1,19,119552,39
DE-BB,30-06-2020,RKI,0,0,0,1593475200000,12073,Uckermark,20,1,19,119552,39
DE-HB,02-03-2020,RKI,0,0,0,1583107200000,04011,Bremen,0,0,0,569352,1749
DE-HB,03-03-2020,RKI,1,1,0,1583193600000,04011,Bremen,1,0,1,569352,1749
DE-HB,09-03-2020,RKI,5,5,0,1583712000000,04011,Bremen,6,0,6,569352,1749
DE-HB,10-03-2020,RKI,10,10,0,1583798400000,04011,Bremen,16,0,16,569352,1749
DE-HB,11-03-2020,RKI,10,10,0,1583884800000,04011,Bremen,26,0,26,569352,1749
DE-HB,12-03-2020,RKI,5,5,0,1583971200000,04011,Bremen,31,0,31,569352,1749
DE-HB,13-03-2020,RKI,3,3,0,1584057600000,04011,Bremen,34,0,34,569352,1749
DE-HB,14-03-2020,RKI,1,1,0,1584144000000,04011,Bremen,35,0,35,569352,1749
DE-HB,15-03-2020,RKI,2,2,0,1584230400000,04011,Bremen,37,0,37,569352,1749
DE-HB,16-03-2020,RKI,0,0,0,1584316800000,04011,Bremen,37,0,37,569352,1749
DE-HB,17-03-2020,RKI,7,6,1,1584403200000,04011,Bremen,44,1,43,569352,1749
DE-HB,18-03-2020,RKI,8,8,0,1584489600000,04011,Bremen,52,1,51,569352,1749
DE-HB,19-03-2020,RKI,35,35,0,1584576000000,04011,Bremen,87,1,86,569352,1749
DE-HB,20-03-2020,RKI,23,23,0,1584662400000,04011,Bremen,110,1,109,569352,1749
DE-HB,21-03-2020,RKI,21,21,0,1584748800000,04011,Bremen,131,1,130,569352,1749
DE-HB,22-03-2020,RKI,3,3,0,1584835200000,04011,Bremen,134,1,133,569352,1749
DE-HB,23-03-2020,RKI,11,11,0,1584921600000,04011,Bremen,145,1,144,569352,1749
DE-HB,24-03-2020,RKI,18,17,1,1585008000000,04011,Bremen,163,2,161,569352,1749
DE-HB,25-03-2020,RKI,8,8,0,1585094400000,04011,Bremen,171,2,169,569352,1749
DE-HB,26-03-2020,RKI,30,28,2,1585180800000,04011,Bremen,201,4,197,569352,1749
DE-HB,27-03-2020,RKI,19,18,1,1585267200000,04011,Bremen,220,5,215,569352,1749
DE-HB,28-03-2020,RKI,21,21,0,1585353600000,04011,Bremen,241,5,236,569352,1749
DE-HB,29-03-2020,RKI,0,0,0,1585440000000,04011,Bremen,241,5,236,569352,1749
DE-HB,30-03-2020,RKI,6,4,2,1585526400000,04011,Bremen,247,7,240,569352,1749
DE-HB,31-03-2020,RKI,14,13,1,1585612800000,04011,Bremen,261,8,253,569352,1749
DE-HB,01-04-2020,RKI,15,14,1,1585699200000,04011,Bremen,276,9,267,569352,1749
DE-HB,02-04-2020,RKI,10,9,1,1585785600000,04011,Bremen,286,10,276,569352,1749
DE-HB,03-04-2020,RKI,31,26,5,1585872000000,04011,Bremen,317,15,302,569352,1749
DE-HB,04-04-2020,RKI,12,11,1,1585958400000,04011,Bremen,329,16,313,569352,1749
DE-HB,05-04-2020,RKI,2,2,0,1586044800000,04011,Bremen,331,16,315,569352,1749
DE-HB,06-04-2020,RKI,4,4,0,1586131200000,04011,Bremen,335,16,319,569352,1749
DE-HB,07-04-2020,RKI,34,32,2,1586217600000,04011,Bremen,369,18,351,569352,1749
DE-HB,08-04-2020,RKI,5,5,0,1586304000000,04011,Bremen,374,18,356,569352,1749
DE-HB,09-04-2020,RKI,17,15,2,1586390400000,04011,Bremen,391,20,371,569352,1749
DE-HB,10-04-2020,RKI,8,7,1,1586476800000,04011,Bremen,399,21,378,569352,1749
DE-HB,11-04-2020,RKI,12,10,2,1586563200000,04011,Bremen,411,23,388,569352,1749
DE-HB,12-04-2020,RKI,2,2,0,1586649600000,04011,Bremen,413,23,390,569352,1749
DE-HB,13-04-2020,RKI,5,2,3,1586736000000,04011,Bremen,418,26,392,569352,1749
DE-HB,14-04-2020,RKI,5,5,0,1586822400000,04011,Bremen,423,26,397,569352,1749
DE-HB,15-04-2020,RKI,14,13,1,1586908800000,04011,Bremen,437,27,410,569352,1749
DE-HB,16-04-2020,RKI,42,42,0,1586995200000,04011,Bremen,479,27,452,569352,1749
DE-HB,17-04-2020,RKI,11,10,1,1587081600000,04011,Bremen,490,28,462,569352,1749
DE-HB,18-04-2020,RKI,15,15,0,1587168000000,04011,Bremen,505,28,477,569352,1749
DE-HB,19-04-2020,RKI,11,11,0,1587254400000,04011,Bremen,516,28,488,569352,1749
DE-HB,20-04-2020,RKI,5,5,0,1587340800000,04011,Bremen,521,28,493,569352,1749
DE-HB,21-04-2020,RKI,15,12,3,1587427200000,04011,Bremen,536,31,505,569352,1749
DE-HB,22-04-2020,RKI,100,100,0,1587513600000,04011,Bremen,636,31,605,569352,1749
DE-HB,23-04-2020,RKI,14,14,0,1587600000000,04011,Bremen,650,31,619,569352,1749
DE-HB,24-04-2020,RKI,10,10,0,1587686400000,04011,Bremen,660,31,629,569352,1749
DE-HB,25-04-2020,RKI,12,12,0,1587772800000,04011,Bremen,672,31,641,569352,1749
DE-HB,26-04-2020,RKI,13,13,0,1587859200000,04011,Bremen,685,31,654,569352,1749
DE-HB,27-04-2020,RKI,6,6,0,1587945600000,04011,Bremen,691,31,660,569352,1749
DE-HB,28-04-2020,RKI,34,31,3,1588032000000,04011,Bremen,725,34,691,569352,1749
DE-HB,29-04-2020,RKI,37,37,0,1588118400000,04011,Bremen,762,34,728,569352,1749
DE-HB,30-04-2020,RKI,18,18,0,1588204800000,04011,Bremen,780,34,746,569352,1749
DE-HB,01-05-2020,RKI,10,10,0,1588291200000,04011,Bremen,790,34,756,569352,1749
DE-HB,02-05-2020,RKI,2,2,0,1588377600000,04011,Bremen,792,34,758,569352,1749
DE-HB,03-05-2020,RKI,15,15,0,1588464000000,04011,Bremen,807,34,773,569352,1749
DE-HB,04-05-2020,RKI,15,15,0,1588550400000,04011,Bremen,822,34,788,569352,1749
DE-HB,05-05-2020,RKI,2,2,0,1588636800000,04011,Bremen,824,34,790,569352,1749
DE-HB,06-05-2020,RKI,44,44,0,1588723200000,04011,Bremen,868,34,834,569352,1749
DE-HB,07-05-2020,RKI,26,25,1,1588809600000,04011,Bremen,894,35,859,569352,1749
DE-HB,08-05-2020,RKI,21,21,0,1588896000000,04011,Bremen,915,35,880,569352,1749
DE-HB,09-05-2020,RKI,14,13,1,1588982400000,04011,Bremen,929,36,893,569352,1749
DE-HB,10-05-2020,RKI,9,8,1,1589068800000,04011,Bremen,938,37,901,569352,1749
DE-HB,11-05-2020,RKI,2,2,0,1589155200000,04011,Bremen,940,37,903,569352,1749
DE-HB,12-05-2020,RKI,18,18,0,1589241600000,04011,Bremen,958,37,921,569352,1749
DE-HB,13-05-2020,RKI,28,27,1,1589328000000,04011,Bremen,986,38,948,569352,1749
DE-HB,14-05-2020,RKI,21,21,0,1589414400000,04011,Bremen,1007,38,969,569352,1749
DE-HB,15-05-2020,RKI,20,20,0,1589500800000,04011,Bremen,1027,38,989,569352,1749
DE-HB,16-05-2020,RKI,18,16,2,1589587200000,04011,Bremen,1045,40,1005,569352,1749
DE-HB,17-05-2020,RKI,9,9,0,1589673600000,04011,Bremen,1054,40,1014,569352,1749
DE-HB,18-05-2020,RKI,10,10,0,1589760000000,04011,Bremen,1064,40,1024,569352,1749
DE-HB,19-05-2020,RKI,17,16,1,1589846400000,04011,Bremen,1081,41,1040,569352,1749
DE-HB,20-05-2020,RKI,15,15,0,1589932800000,04011,Bremen,1096,41,1055,569352,1749
DE-HB,21-05-2020,RKI,15,15,0,1590019200000,04011,Bremen,1111,41,1070,569352,1749
DE-HB,22-05-2020,RKI,3,3,0,1590105600000,04011,Bremen,1114,41,1073,569352,1749
DE-HB,23-05-2020,RKI,1,1,0,1590192000000,04011,Bremen,1115,41,1074,569352,1749
DE-HB,24-05-2020,RKI,11,11,0,1590278400000,04011,Bremen,1126,41,1085,569352,1749
DE-HB,25-05-2020,RKI,1,0,1,1590364800000,04011,Bremen,1127,42,1085,569352,1749
DE-HB,26-05-2020,RKI,6,6,0,1590451200000,04011,Bremen,1133,42,1091,569352,1749
DE-HB,27-05-2020,RKI,21,21,0,1590537600000,04011,Bremen,1154,42,1112,569352,1749
DE-HB,28-05-2020,RKI,18,18,0,1590624000000,04011,Bremen,1172,42,1130,569352,1749
DE-HB,29-05-2020,RKI,16,16,0,1590710400000,04011,Bremen,1188,42,1146,569352,1749
DE-HB,30-05-2020,RKI,15,15,0,1590796800000,04011,Bremen,1203,42,1161,569352,1749
DE-HB,31-05-2020,RKI,0,0,0,1590883200000,04011,Bremen,1203,42,1161,569352,1749
DE-HB,01-06-2020,RKI,0,0,0,1590969600000,04011,Bremen,1203,42,1161,569352,1749
DE-HB,02-06-2020,RKI,5,4,1,1591056000000,04011,Bremen,1208,43,1165,569352,1749
DE-HB,03-06-2020,RKI,10,9,1,1591142400000,04011,Bremen,1218,44,1174,569352,1749
DE-HB,04-06-2020,RKI,9,9,0,1591228800000,04011,Bremen,1227,44,1183,569352,1749
DE-HB,05-06-2020,RKI,8,8,0,1591315200000,04011,Bremen,1235,44,1191,569352,1749
DE-HB,06-06-2020,RKI,3,3,0,1591401600000,04011,Bremen,1238,44,1194,569352,1749
DE-HB,07-06-2020,RKI,5,5,0,1591488000000,04011,Bremen,1243,44,1199,569352,1749
DE-HB,08-06-2020,RKI,0,0,0,1591574400000,04011,Bremen,1243,44,1199,569352,1749
DE-HB,09-06-2020,RKI,14,14,0,1591660800000,04011,Bremen,1257,44,1213,569352,1749
DE-HB,10-06-2020,RKI,14,14,0,1591747200000,04011,Bremen,1271,44,1227,569352,1749
DE-HB,11-06-2020,RKI,3,3,0,1591833600000,04011,Bremen,1274,44,1230,569352,1749
DE-HB,12-06-2020,RKI,5,4,1,1591920000000,04011,Bremen,1279,45,1234,569352,1749
DE-HB,13-06-2020,RKI,7,7,0,1592006400000,04011,Bremen,1286,45,1241,569352,1749
DE-HB,14-06-2020,RKI,1,1,0,1592092800000,04011,Bremen,1287,45,1242,569352,1749
DE-HB,15-06-2020,RKI,0,0,0,1592179200000,04011,Bremen,1287,45,1242,569352,1749
DE-HB,16-06-2020,RKI,12,12,0,1592265600000,04011,Bremen,1299,45,1254,569352,1749
DE-HB,17-06-2020,RKI,5,5,0,1592352000000,04011,Bremen,1304,45,1259,569352,1749
DE-HB,18-06-2020,RKI,4,4,0,1592438400000,04011,Bremen,1308,45,1263,569352,1749
DE-HB,19-06-2020,RKI,7,4,3,1592524800000,04011,Bremen,1315,48,1267,569352,1749
DE-HB,20-06-2020,RKI,7,7,0,1592611200000,04011,Bremen,1322,48,1274,569352,1749
DE-HB,21-06-2020,RKI,1,1,0,1592697600000,04011,Bremen,1323,48,1275,569352,1749
DE-HB,22-06-2020,RKI,3,3,0,1592784000000,04011,Bremen,1326,48,1278,569352,1749
DE-HB,24-06-2020,RKI,1,1,0,1592956800000,04011,Bremen,1327,48,1279,569352,1749
DE-HB,25-06-2020,RKI,2,2,0,1593043200000,04011,Bremen,1329,48,1281,569352,1749
DE-HB,26-06-2020,RKI,0,0,0,1593129600000,04011,Bremen,1329,48,1281,569352,1749
DE-HB,27-06-2020,RKI,1,1,0,1593216000000,04011,Bremen,1330,48,1282,569352,1749
DE-HB,30-06-2020,RKI,4,4,0,1593475200000,04011,Bremen,1334,48,1286,569352,1749
DE-HB,01-07-2020,RKI,1,1,0,1593561600000,04011,Bremen,1335,48,1287,569352,1749
DE-HB,02-07-2020,RKI,2,2,0,1593648000000,04011,Bremen,1337,48,1289,569352,1749
DE-HB,04-07-2020,RKI,2,0,0,1593820800000,04011,Bremen,1339,48,1289,569352,1749
DE-HB,05-07-2020,RKI,0,0,0,1593907200000,04011,Bremen,1339,48,1289,569352,1749
DE-HB,07-07-2020,RKI,0,0,0,1594080000000,04011,Bremen,1339,48,1289,569352,1749
DE-HB,08-07-2020,RKI,0,0,0,1594166400000,04011,Bremen,1339,48,1289,569352,1749
DE-HB,09-07-2020,RKI,3,3,0,1594252800000,04011,Bremen,1342,48,1292,569352,1749
DE-HB,10-07-2020,RKI,0,0,0,1594339200000,04011,Bremen,1342,48,1292,569352,1749
DE-HB,13-07-2020,RKI,0,0,0,1594598400000,04011,Bremen,1342,48,1292,569352,1749
DE-HB,15-07-2020,RKI,3,0,0,1594771200000,04011,Bremen,1345,48,1292,569352,1749
DE-HB,16-07-2020,RKI,2,0,0,1594857600000,04011,Bremen,1347,48,1292,569352,1749
DE-HB,12-03-2020,RKI,0,0,0,1583971200000,04012,Bremerhaven,0,0,0,113634,1211
DE-HB,13-03-2020,RKI,3,3,0,1584057600000,04012,Bremerhaven,3,0,3,113634,1211
DE-HB,14-03-2020,RKI,0,0,0,1584144000000,04012,Bremerhaven,3,0,3,113634,1211
DE-HB,17-03-2020,RKI,3,3,0,1584403200000,04012,Bremerhaven,6,0,6,113634,1211
DE-HB,18-03-2020,RKI,0,0,0,1584489600000,04012,Bremerhaven,6,0,6,113634,1211
DE-HB,19-03-2020,RKI,1,1,0,1584576000000,04012,Bremerhaven,7,0,7,113634,1211
DE-HB,25-03-2020,RKI,1,1,0,1585094400000,04012,Bremerhaven,8,0,8,113634,1211
DE-HB,28-03-2020,RKI,2,2,0,1585353600000,04012,Bremerhaven,10,0,10,113634,1211
DE-HB,30-03-2020,RKI,0,0,0,1585526400000,04012,Bremerhaven,10,0,10,113634,1211
DE-HB,31-03-2020,RKI,1,1,0,1585612800000,04012,Bremerhaven,11,0,11,113634,1211
DE-HB,03-04-2020,RKI,0,0,0,1585872000000,04012,Bremerhaven,11,0,11,113634,1211
DE-HB,04-04-2020,RKI,1,1,0,1585958400000,04012,Bremerhaven,12,0,12,113634,1211
DE-HB,07-04-2020,RKI,0,0,0,1586217600000,04012,Bremerhaven,12,0,12,113634,1211
DE-HB,16-04-2020,RKI,0,0,0,1586995200000,04012,Bremerhaven,12,0,12,113634,1211
DE-HB,20-04-2020,RKI,0,0,0,1587340800000,04012,Bremerhaven,12,0,12,113634,1211
DE-HB,21-04-2020,RKI,0,0,0,1587427200000,04012,Bremerhaven,12,0,12,113634,1211
DE-HB,23-04-2020,RKI,1,1,0,1587600000000,04012,Bremerhaven,13,0,13,113634,1211
DE-HB,24-04-2020,RKI,5,5,0,1587686400000,04012,Bremerhaven,18,0,18,113634,1211
DE-HB,25-04-2020,RKI,1,1,0,1587772800000,04012,Bremerhaven,19,0,19,113634,1211
DE-HB,28-04-2020,RKI,4,4,0,1588032000000,04012,Bremerhaven,23,0,23,113634,1211
DE-HB,29-04-2020,RKI,2,2,0,1588118400000,04012,Bremerhaven,25,0,25,113634,1211
DE-HB,30-04-2020,RKI,2,2,0,1588204800000,04012,Bremerhaven,27,0,27,113634,1211
DE-HB,01-05-2020,RKI,0,0,0,1588291200000,04012,Bremerhaven,27,0,27,113634,1211
DE-HB,02-05-2020,RKI,0,0,0,1588377600000,04012,Bremerhaven,27,0,27,113634,1211
DE-HB,03-05-2020,RKI,0,0,0,1588464000000,04012,Bremerhaven,27,0,27,113634,1211
DE-HB,04-05-2020,RKI,0,0,0,1588550400000,04012,Bremerhaven,27,0,27,113634,1211
DE-HB,05-05-2020,RKI,6,5,1,1588636800000,04012,Bremerhaven,33,1,32,113634,1211
DE-HB,06-05-2020,RKI,7,7,0,1588723200000,04012,Bremerhaven,40,1,39,113634,1211
DE-HB,07-05-2020,RKI,1,1,0,1588809600000,04012,Bremerhaven,41,1,40,113634,1211
DE-HB,08-05-2020,RKI,5,3,2,1588896000000,04012,Bremerhaven,46,3,43,113634,1211
DE-HB,10-05-2020,RKI,1,1,0,1589068800000,04012,Bremerhaven,47,3,44,113634,1211
DE-HB,12-05-2020,RKI,0,0,0,1589241600000,04012,Bremerhaven,47,3,44,113634,1211
DE-HB,14-05-2020,RKI,0,0,0,1589414400000,04012,Bremerhaven,47,3,44,113634,1211
DE-HB,20-05-2020,RKI,0,0,0,1589932800000,04012,Bremerhaven,47,3,44,113634,1211
DE-HB,23-05-2020,RKI,0,0,0,1590192000000,04012,Bremerhaven,47,3,44,113634,1211
DE-HB,24-05-2020,RKI,0,0,0,1590278400000,04012,Bremerhaven,47,3,44,113634,1211
DE-HB,26-05-2020,RKI,2,2,0,1590451200000,04012,Bremerhaven,49,3,46,113634,1211
DE-HB,27-05-2020,RKI,3,3,0,1590537600000,04012,Bremerhaven,52,3,49,113634,1211
DE-HB,28-05-2020,RKI,6,6,0,1590624000000,04012,Bremerhaven,58,3,55,113634,1211
DE-HB,29-05-2020,RKI,11,11,0,1590710400000,04012,Bremerhaven,69,3,66,113634,1211
DE-HB,30-05-2020,RKI,7,7,0,1590796800000,04012,Bremerhaven,76,3,73,113634,1211
DE-HB,31-05-2020,RKI,5,5,0,1590883200000,04012,Bremerhaven,81,3,78,113634,1211
DE-HB,02-06-2020,RKI,4,4,0,1591056000000,04012,Bremerhaven,85,3,82,113634,1211
DE-HB,03-06-2020,RKI,5,5,0,1591142400000,04012,Bremerhaven,90,3,87,113634,1211
DE-HB,04-06-2020,RKI,23,23,0,1591228800000,04012,Bremerhaven,113,3,110,113634,1211
DE-HB,05-06-2020,RKI,5,5,0,1591315200000,04012,Bremerhaven,118,3,115,113634,1211
DE-HB,06-06-2020,RKI,0,0,0,1591401600000,04012,Bremerhaven,118,3,115,113634,1211
DE-HB,07-06-2020,RKI,7,7,0,1591488000000,04012,Bremerhaven,125,3,122,113634,1211
DE-HB,10-06-2020,RKI,1,1,0,1591747200000,04012,Bremerhaven,126,3,123,113634,1211
DE-HB,11-06-2020,RKI,3,3,0,1591833600000,04012,Bremerhaven,129,3,126,113634,1211
DE-HB,12-06-2020,RKI,1,1,0,1591920000000,04012,Bremerhaven,130,3,127,113634,1211
DE-HB,14-06-2020,RKI,0,0,0,1592092800000,04012,Bremerhaven,130,3,127,113634,1211
DE-HB,16-06-2020,RKI,0,0,0,1592265600000,04012,Bremerhaven,130,3,127,113634,1211
DE-HB,17-06-2020,RKI,5,5,0,1592352000000,04012,Bremerhaven,135,3,132,113634,1211
DE-HB,18-06-2020,RKI,0,0,0,1592438400000,04012,Bremerhaven,135,3,132,113634,1211
DE-HB,19-06-2020,RKI,1,1,0,1592524800000,04012,Bremerhaven,136,3,133,113634,1211
DE-HB,21-06-2020,RKI,0,0,0,1592697600000,04012,Bremerhaven,136,3,133,113634,1211
DE-HB,22-06-2020,RKI,1,1,0,1592784000000,04012,Bremerhaven,137,3,134,113634,1211
DE-HB,29-06-2020,RKI,0,0,0,1593388800000,04012,Bremerhaven,137,3,134,113634,1211
DE-HB,01-07-2020,RKI,1,0,0,1593561600000,04012,Bremerhaven,138,3,134,113634,1211
DE-HB,02-07-2020,RKI,0,0,0,1593648000000,04012,Bremerhaven,138,3,134,113634,1211
DE-HB,07-07-2020,RKI,0,0,0,1594080000000,04012,Bremerhaven,138,3,134,113634,1211
DE-HB,08-07-2020,RKI,1,0,0,1594166400000,04012,Bremerhaven,139,3,134,113634,1211
DE-HB,12-07-2020,RKI,0,0,0,1594512000000,04012,Bremerhaven,139,3,134,113634,1211
DE-HB,15-07-2020,RKI,1,0,0,1594771200000,04012,Bremerhaven,140,3,134,113634,1211
DE-HB,16-07-2020,RKI,0,0,0,1594857600000,04012,Bremerhaven,140,3,134,113634,1211
DE-HH,01-03-2020,RKI,0,0,0,1583020800000,02000,Hamburg,0,0,0,1841179,2505
DE-HH,03-03-2020,RKI,2,2,0,1583193600000,02000,Hamburg,2,0,2,1841179,2505
DE-HH,04-03-2020,RKI,0,0,0,1583280000000,02000,Hamburg,2,0,2,1841179,2505
DE-HH,05-03-2020,RKI,4,4,0,1583366400000,02000,Hamburg,6,0,6,1841179,2505
DE-HH,06-03-2020,RKI,2,1,1,1583452800000,02000,Hamburg,8,1,7,1841179,2505
DE-HH,07-03-2020,RKI,3,3,0,1583539200000,02000,Hamburg,11,1,10,1841179,2505
DE-HH,08-03-2020,RKI,4,4,0,1583625600000,02000,Hamburg,15,1,14,1841179,2505
DE-HH,09-03-2020,RKI,20,20,0,1583712000000,02000,Hamburg,35,1,34,1841179,2505
DE-HH,10-03-2020,RKI,29,29,0,1583798400000,02000,Hamburg,64,1,63,1841179,2505
DE-HH,11-03-2020,RKI,28,28,0,1583884800000,02000,Hamburg,92,1,91,1841179,2505
DE-HH,12-03-2020,RKI,41,40,1,1583971200000,02000,Hamburg,133,2,131,1841179,2505
DE-HH,13-03-2020,RKI,36,35,1,1584057600000,02000,Hamburg,169,3,166,1841179,2505
DE-HH,14-03-2020,RKI,78,77,1,1584144000000,02000,Hamburg,247,4,243,1841179,2505
DE-HH,15-03-2020,RKI,77,77,0,1584230400000,02000,Hamburg,324,4,320,1841179,2505
DE-HH,16-03-2020,RKI,79,79,0,1584316800000,02000,Hamburg,403,4,399,1841179,2505
DE-HH,17-03-2020,RKI,132,131,1,1584403200000,02000,Hamburg,535,5,530,1841179,2505
DE-HH,18-03-2020,RKI,133,133,0,1584489600000,02000,Hamburg,668,5,663,1841179,2505
DE-HH,19-03-2020,RKI,183,181,2,1584576000000,02000,Hamburg,851,7,844,1841179,2505
DE-HH,20-03-2020,RKI,146,144,2,1584662400000,02000,Hamburg,997,9,988,1841179,2505
DE-HH,21-03-2020,RKI,105,104,1,1584748800000,02000,Hamburg,1102,10,1092,1841179,2505
DE-HH,22-03-2020,RKI,148,146,2,1584835200000,02000,Hamburg,1250,12,1238,1841179,2505
DE-HH,23-03-2020,RKI,132,131,1,1584921600000,02000,Hamburg,1382,13,1369,1841179,2505
DE-HH,24-03-2020,RKI,206,203,3,1585008000000,02000,Hamburg,1588,16,1572,1841179,2505
DE-HH,25-03-2020,RKI,162,151,11,1585094400000,02000,Hamburg,1750,27,1723,1841179,2505
DE-HH,26-03-2020,RKI,170,164,6,1585180800000,02000,Hamburg,1920,33,1887,1841179,2505
DE-HH,27-03-2020,RKI,141,132,9,1585267200000,02000,Hamburg,2061,42,2019,1841179,2505
DE-HH,28-03-2020,RKI,144,134,10,1585353600000,02000,Hamburg,2205,52,2153,1841179,2505
DE-HH,29-03-2020,RKI,114,113,1,1585440000000,02000,Hamburg,2319,53,2266,1841179,2505
DE-HH,30-03-2020,RKI,69,65,4,1585526400000,02000,Hamburg,2388,57,2331,1841179,2505
DE-HH,31-03-2020,RKI,156,148,8,1585612800000,02000,Hamburg,2544,65,2479,1841179,2505
DE-HH,01-04-2020,RKI,139,131,8,1585699200000,02000,Hamburg,2683,73,2610,1841179,2505
DE-HH,02-04-2020,RKI,164,151,13,1585785600000,02000,Hamburg,2847,86,2761,1841179,2505
DE-HH,03-04-2020,RKI,155,134,21,1585872000000,02000,Hamburg,3002,107,2895,1841179,2505
DE-HH,04-04-2020,RKI,106,101,5,1585958400000,02000,Hamburg,3108,112,2996,1841179,2505
DE-HH,05-04-2020,RKI,107,99,8,1586044800000,02000,Hamburg,3215,120,3095,1841179,2505
DE-HH,06-04-2020,RKI,94,83,11,1586131200000,02000,Hamburg,3309,131,3178,1841179,2505
DE-HH,07-04-2020,RKI,210,187,23,1586217600000,02000,Hamburg,3519,154,3365,1841179,2505
DE-HH,08-04-2020,RKI,116,107,9,1586304000000,02000,Hamburg,3635,163,3472,1841179,2505
DE-HH,09-04-2020,RKI,113,110,3,1586390400000,02000,Hamburg,3748,166,3582,1841179,2505
DE-HH,10-04-2020,RKI,96,95,1,1586476800000,02000,Hamburg,3844,167,3677,1841179,2505
DE-HH,11-04-2020,RKI,78,74,4,1586563200000,02000,Hamburg,3922,171,3751,1841179,2505
DE-HH,12-04-2020,RKI,45,37,8,1586649600000,02000,Hamburg,3967,179,3788,1841179,2505
DE-HH,13-04-2020,RKI,40,34,6,1586736000000,02000,Hamburg,4007,185,3822,1841179,2505
DE-HH,14-04-2020,RKI,75,67,8,1586822400000,02000,Hamburg,4082,193,3889,1841179,2505
DE-HH,15-04-2020,RKI,82,77,5,1586908800000,02000,Hamburg,4164,198,3966,1841179,2505
DE-HH,16-04-2020,RKI,73,64,9,1586995200000,02000,Hamburg,4237,207,4030,1841179,2505
DE-HH,17-04-2020,RKI,107,98,9,1587081600000,02000,Hamburg,4344,216,4128,1841179,2505
DE-HH,18-04-2020,RKI,38,37,1,1587168000000,02000,Hamburg,4382,217,4165,1841179,2505
DE-HH,19-04-2020,RKI,21,19,2,1587254400000,02000,Hamburg,4403,219,4184,1841179,2505
DE-HH,20-04-2020,RKI,32,29,3,1587340800000,02000,Hamburg,4435,222,4213,1841179,2505
DE-HH,21-04-2020,RKI,57,54,3,1587427200000,02000,Hamburg,4492,225,4267,1841179,2505
DE-HH,22-04-2020,RKI,48,46,2,1587513600000,02000,Hamburg,4540,227,4313,1841179,2505
DE-HH,23-04-2020,RKI,47,39,8,1587600000000,02000,Hamburg,4587,235,4352,1841179,2505
DE-HH,24-04-2020,RKI,41,40,1,1587686400000,02000,Hamburg,4628,236,4392,1841179,2505
DE-HH,25-04-2020,RKI,43,39,4,1587772800000,02000,Hamburg,4671,240,4431,1841179,2505
DE-HH,26-04-2020,RKI,16,14,2,1587859200000,02000,Hamburg,4687,242,4445,1841179,2505
DE-HH,27-04-2020,RKI,20,17,3,1587945600000,02000,Hamburg,4707,245,4462,1841179,2505
DE-HH,28-04-2020,RKI,24,23,1,1588032000000,02000,Hamburg,4731,246,4485,1841179,2505
DE-HH,29-04-2020,RKI,41,39,2,1588118400000,02000,Hamburg,4772,248,4524,1841179,2505
DE-HH,30-04-2020,RKI,24,23,1,1588204800000,02000,Hamburg,4796,249,4547,1841179,2505
DE-HH,01-05-2020,RKI,6,6,0,1588291200000,02000,Hamburg,4802,249,4553,1841179,2505
DE-HH,02-05-2020,RKI,12,12,0,1588377600000,02000,Hamburg,4814,249,4565,1841179,2505
DE-HH,03-05-2020,RKI,2,2,0,1588464000000,02000,Hamburg,4816,249,4567,1841179,2505
DE-HH,04-05-2020,RKI,8,4,4,1588550400000,02000,Hamburg,4824,253,4571,1841179,2505
DE-HH,05-05-2020,RKI,20,18,2,1588636800000,02000,Hamburg,4844,255,4589,1841179,2505
DE-HH,06-05-2020,RKI,20,19,1,1588723200000,02000,Hamburg,4864,256,4608,1841179,2505
DE-HH,07-05-2020,RKI,16,16,0,1588809600000,02000,Hamburg,4880,256,4624,1841179,2505
DE-HH,08-05-2020,RKI,10,10,0,1588896000000,02000,Hamburg,4890,256,4634,1841179,2505
DE-HH,09-05-2020,RKI,8,8,0,1588982400000,02000,Hamburg,4898,256,4642,1841179,2505
DE-HH,10-05-2020,RKI,2,2,0,1589068800000,02000,Hamburg,4900,256,4644,1841179,2505
DE-HH,11-05-2020,RKI,3,2,1,1589155200000,02000,Hamburg,4903,257,4646,1841179,2505
DE-HH,12-05-2020,RKI,1,1,0,1589241600000,02000,Hamburg,4904,257,4647,1841179,2505
DE-HH,13-05-2020,RKI,13,13,0,1589328000000,02000,Hamburg,4917,257,4660,1841179,2505
DE-HH,14-05-2020,RKI,9,8,1,1589414400000,02000,Hamburg,4926,258,4668,1841179,2505
DE-HH,15-05-2020,RKI,11,11,0,1589500800000,02000,Hamburg,4937,258,4679,1841179,2505
DE-HH,16-05-2020,RKI,5,5,0,1589587200000,02000,Hamburg,4942,258,4684,1841179,2505
DE-HH,17-05-2020,RKI,0,0,0,1589673600000,02000,Hamburg,4942,258,4684,1841179,2505
DE-HH,18-05-2020,RKI,0,0,0,1589760000000,02000,Hamburg,4942,258,4684,1841179,2505
DE-HH,19-05-2020,RKI,2,2,0,1589846400000,02000,Hamburg,4944,258,4686,1841179,2505
DE-HH,20-05-2020,RKI,12,12,0,1589932800000,02000,Hamburg,4956,258,4698,1841179,2505
DE-HH,21-05-2020,RKI,1,1,0,1590019200000,02000,Hamburg,4957,258,4699,1841179,2505
DE-HH,22-05-2020,RKI,2,2,0,1590105600000,02000,Hamburg,4959,258,4701,1841179,2505
DE-HH,23-05-2020,RKI,2,2,0,1590192000000,02000,Hamburg,4961,258,4703,1841179,2505
DE-HH,25-05-2020,RKI,0,0,0,1590364800000,02000,Hamburg,4961,258,4703,1841179,2505
DE-HH,26-05-2020,RKI,2,2,0,1590451200000,02000,Hamburg,4963,258,4705,1841179,2505
DE-HH,27-05-2020,RKI,0,0,0,1590537600000,02000,Hamburg,4963,258,4705,1841179,2505
DE-HH,29-05-2020,RKI,4,4,0,1590710400000,02000,Hamburg,4967,258,4709,1841179,2505
DE-HH,30-05-2020,RKI,0,0,0,1590796800000,02000,Hamburg,4967,258,4709,1841179,2505
DE-HH,31-05-2020,RKI,5,5,0,1590883200000,02000,Hamburg,4972,258,4714,1841179,2505
DE-HH,01-06-2020,RKI,1,1,0,1590969600000,02000,Hamburg,4973,258,4715,1841179,2505
DE-HH,02-06-2020,RKI,1,1,0,1591056000000,02000,Hamburg,4974,258,4716,1841179,2505
DE-HH,03-06-2020,RKI,9,9,0,1591142400000,02000,Hamburg,4983,258,4725,1841179,2505
DE-HH,04-06-2020,RKI,4,4,0,1591228800000,02000,Hamburg,4987,258,4729,1841179,2505
DE-HH,05-06-2020,RKI,4,4,0,1591315200000,02000,Hamburg,4991,258,4733,1841179,2505
DE-HH,06-06-2020,RKI,0,0,0,1591401600000,02000,Hamburg,4991,258,4733,1841179,2505
DE-HH,07-06-2020,RKI,0,0,0,1591488000000,02000,Hamburg,4991,258,4733,1841179,2505
DE-HH,08-06-2020,RKI,2,2,0,1591574400000,02000,Hamburg,4993,258,4735,1841179,2505
DE-HH,09-06-2020,RKI,1,1,0,1591660800000,02000,Hamburg,4994,258,4736,1841179,2505
DE-HH,10-06-2020,RKI,3,3,0,1591747200000,02000,Hamburg,4997,258,4739,1841179,2505
DE-HH,11-06-2020,RKI,6,6,0,1591833600000,02000,Hamburg,5003,258,4745,1841179,2505
DE-HH,12-06-2020,RKI,3,3,0,1591920000000,02000,Hamburg,5006,258,4748,1841179,2505
DE-HH,13-06-2020,RKI,2,2,0,1592006400000,02000,Hamburg,5008,258,4750,1841179,2505
DE-HH,14-06-2020,RKI,0,0,0,1592092800000,02000,Hamburg,5008,258,4750,1841179,2505
DE-HH,15-06-2020,RKI,0,0,0,1592179200000,02000,Hamburg,5008,258,4750,1841179,2505
DE-HH,16-06-2020,RKI,2,2,0,1592265600000,02000,Hamburg,5010,258,4752,1841179,2505
DE-HH,17-06-2020,RKI,6,6,0,1592352000000,02000,Hamburg,5016,258,4758,1841179,2505
DE-HH,18-06-2020,RKI,7,7,0,1592438400000,02000,Hamburg,5023,258,4765,1841179,2505
DE-HH,19-06-2020,RKI,3,3,0,1592524800000,02000,Hamburg,5026,258,4768,1841179,2505
DE-HH,20-06-2020,RKI,3,3,0,1592611200000,02000,Hamburg,5029,258,4771,1841179,2505
DE-HH,21-06-2020,RKI,3,1,0,1592697600000,02000,Hamburg,5032,258,4772,1841179,2505
DE-HH,22-06-2020,RKI,2,2,0,1592784000000,02000,Hamburg,5034,258,4774,1841179,2505
DE-HH,23-06-2020,RKI,8,3,0,1592870400000,02000,Hamburg,5042,258,4777,1841179,2505
DE-HH,24-06-2020,RKI,10,5,0,1592956800000,02000,Hamburg,5052,258,4782,1841179,2505
DE-HH,25-06-2020,RKI,3,3,0,1593043200000,02000,Hamburg,5055,258,4785,1841179,2505
DE-HH,26-06-2020,RKI,7,1,0,1593129600000,02000,Hamburg,5062,258,4786,1841179,2505
DE-HH,27-06-2020,RKI,1,0,0,1593216000000,02000,Hamburg,5063,258,4786,1841179,2505
DE-HH,28-06-2020,RKI,5,5,0,1593302400000,02000,Hamburg,5068,258,4791,1841179,2505
DE-HH,29-06-2020,RKI,0,0,0,1593388800000,02000,Hamburg,5068,258,4791,1841179,2505
DE-HH,30-06-2020,RKI,2,1,0,1593475200000,02000,Hamburg,5070,258,4792,1841179,2505
DE-HH,01-07-2020,RKI,8,7,0,1593561600000,02000,Hamburg,5078,258,4799,1841179,2505
DE-HH,02-07-2020,RKI,1,0,0,1593648000000,02000,Hamburg,5079,258,4799,1841179,2505
DE-HH,03-07-2020,RKI,1,1,0,1593734400000,02000,Hamburg,5080,258,4800,1841179,2505
DE-HH,04-07-2020,RKI,0,0,0,1593820800000,02000,Hamburg,5080,258,4800,1841179,2505
DE-HH,05-07-2020,RKI,1,0,0,1593907200000,02000,Hamburg,5081,258,4800,1841179,2505
DE-HH,06-07-2020,RKI,2,0,0,1593993600000,02000,Hamburg,5083,258,4800,1841179,2505
DE-HH,07-07-2020,RKI,3,0,0,1594080000000,02000,Hamburg,5086,258,4800,1841179,2505
DE-HH,08-07-2020,RKI,2,0,0,1594166400000,02000,Hamburg,5088,258,4800,1841179,2505
DE-HH,09-07-2020,RKI,1,0,0,1594252800000,02000,Hamburg,5089,258,4800,1841179,2505
DE-HH,10-07-2020,RKI,1,0,0,1594339200000,02000,Hamburg,5090,258,4800,1841179,2505
DE-HH,13-07-2020,RKI,0,0,0,1594598400000,02000,Hamburg,5090,258,4800,1841179,2505
DE-HH,14-07-2020,RKI,2,0,0,1594684800000,02000,Hamburg,5092,258,4800,1841179,2505
DE-HE,16-03-2020,RKI,5,5,0,1584316800000,06411,Darmstadt,6,0,6,159207,1304
DE-HE,17-03-2020,RKI,0,0,0,1584403200000,06411,Darmstadt,6,0,6,159207,1304
DE-HE,18-03-2020,RKI,5,5,0,1584489600000,06411,Darmstadt,11,0,11,159207,1304
DE-HE,19-03-2020,RKI,1,1,0,1584576000000,06411,Darmstadt,12,0,12,159207,1304
DE-HE,20-03-2020,RKI,5,5,0,1584662400000,06411,Darmstadt,17,0,17,159207,1304
DE-HE,21-03-2020,RKI,3,3,0,1584748800000,06411,Darmstadt,20,0,20,159207,1304
DE-HE,24-03-2020,RKI,2,2,0,1585008000000,06411,Darmstadt,22,0,22,159207,1304
DE-HE,25-03-2020,RKI,7,7,0,1585094400000,06411,Darmstadt,29,0,29,159207,1304
DE-HE,26-03-2020,RKI,9,9,0,1585180800000,06411,Darmstadt,38,0,38,159207,1304
DE-HE,27-03-2020,RKI,11,11,0,1585267200000,06411,Darmstadt,49,0,49,159207,1304
DE-HE,28-03-2020,RKI,0,0,0,1585353600000,06411,Darmstadt,49,0,49,159207,1304
DE-HE,29-03-2020,RKI,2,2,0,1585440000000,06411,Darmstadt,51,0,51,159207,1304
DE-HE,30-03-2020,RKI,5,5,0,1585526400000,06411,Darmstadt,56,0,56,159207,1304
DE-HE,31-03-2020,RKI,1,1,0,1585612800000,06411,Darmstadt,57,0,57,159207,1304
DE-HE,01-04-2020,RKI,6,6,0,1585699200000,06411,Darmstadt,63,0,63,159207,1304
DE-HE,02-04-2020,RKI,3,3,0,1585785600000,06411,Darmstadt,66,0,66,159207,1304
DE-HE,03-04-2020,RKI,3,2,1,1585872000000,06411,Darmstadt,69,1,68,159207,1304
DE-HE,04-04-2020,RKI,6,6,0,1585958400000,06411,Darmstadt,75,1,74,159207,1304
DE-HE,05-04-2020,RKI,0,0,0,1586044800000,06411,Darmstadt,75,1,74,159207,1304
DE-HE,06-04-2020,RKI,0,0,0,1586131200000,06411,Darmstadt,75,1,74,159207,1304
DE-HE,07-04-2020,RKI,3,3,0,1586217600000,06411,Darmstadt,78,1,77,159207,1304
DE-HE,08-04-2020,RKI,8,8,0,1586304000000,06411,Darmstadt,86,1,85,159207,1304
DE-HE,09-04-2020,RKI,5,4,1,1586390400000,06411,Darmstadt,91,2,89,159207,1304
DE-HE,10-04-2020,RKI,5,4,1,1586476800000,06411,Darmstadt,96,3,93,159207,1304
DE-HE,11-04-2020,RKI,1,1,0,1586563200000,06411,Darmstadt,97,3,94,159207,1304
DE-HE,12-04-2020,RKI,1,0,1,1586649600000,06411,Darmstadt,98,4,94,159207,1304
DE-HE,13-04-2020,RKI,0,0,0,1586736000000,06411,Darmstadt,98,4,94,159207,1304
DE-HE,14-04-2020,RKI,0,0,0,1586822400000,06411,Darmstadt,98,4,94,159207,1304
DE-HE,15-04-2020,RKI,3,3,0,1586908800000,06411,Darmstadt,101,4,97,159207,1304
DE-HE,16-04-2020,RKI,6,4,2,1586995200000,06411,Darmstadt,107,6,101,159207,1304
DE-HE,17-04-2020,RKI,2,1,1,1587081600000,06411,Darmstadt,109,7,102,159207,1304
DE-HE,18-04-2020,RKI,3,3,0,1587168000000,06411,Darmstadt,112,7,105,159207,1304
DE-HE,19-04-2020,RKI,20,17,3,1587254400000,06411,Darmstadt,132,10,122,159207,1304
DE-HE,20-04-2020,RKI,0,0,0,1587340800000,06411,Darmstadt,132,10,122,159207,1304
DE-HE,21-04-2020,RKI,4,3,1,1587427200000,06411,Darmstadt,136,11,125,159207,1304
DE-HE,22-04-2020,RKI,12,11,1,1587513600000,06411,Darmstadt,148,12,136,159207,1304
DE-HE,23-04-2020,RKI,3,3,0,1587600000000,06411,Darmstadt,151,12,139,159207,1304
DE-HE,24-04-2020,RKI,1,0,1,1587686400000,06411,Darmstadt,152,13,139,159207,1304
DE-HE,25-04-2020,RKI,1,1,0,1587772800000,06411,Darmstadt,153,13,140,159207,1304
DE-HE,27-04-2020,RKI,3,3,0,1587945600000,06411,Darmstadt,156,13,143,159207,1304
DE-HE,28-04-2020,RKI,1,1,0,1588032000000,06411,Darmstadt,157,13,144,159207,1304
DE-HE,29-04-2020,RKI,0,0,0,1588118400000,06411,Darmstadt,157,13,144,159207,1304
DE-HE,30-04-2020,RKI,2,1,1,1588204800000,06411,Darmstadt,159,14,145,159207,1304
DE-HE,03-05-2020,RKI,1,1,0,1588464000000,06411,Darmstadt,160,14,146,159207,1304
DE-HE,05-05-2020,RKI,1,1,0,1588636800000,06411,Darmstadt,161,14,147,159207,1304
DE-HE,06-05-2020,RKI,4,4,0,1588723200000,06411,Darmstadt,165,14,151,159207,1304
DE-HE,09-05-2020,RKI,2,2,0,1588982400000,06411,Darmstadt,167,14,153,159207,1304
DE-HE,11-05-2020,RKI,0,0,0,1589155200000,06411,Darmstadt,167,14,153,159207,1304
DE-HE,13-05-2020,RKI,0,0,0,1589328000000,06411,Darmstadt,167,14,153,159207,1304
DE-HE,14-05-2020,RKI,1,1,0,1589414400000,06411,Darmstadt,168,14,154,159207,1304
DE-HE,15-05-2020,RKI,0,0,0,1589500800000,06411,Darmstadt,168,14,154,159207,1304
DE-HE,19-05-2020,RKI,1,1,0,1589846400000,06411,Darmstadt,169,14,155,159207,1304
DE-HE,08-06-2020,RKI,0,0,0,1591574400000,06411,Darmstadt,169,14,155,159207,1304
DE-HE,20-06-2020,RKI,0,0,0,1592611200000,06411,Darmstadt,169,14,155,159207,1304
DE-HE,22-06-2020,RKI,1,1,0,1592784000000,06411,Darmstadt,170,14,156,159207,1304
DE-HE,25-06-2020,RKI,0,0,0,1593043200000,06411,Darmstadt,170,14,156,159207,1304
DE-HE,26-06-2020,RKI,0,0,0,1593129600000,06411,Darmstadt,170,14,156,159207,1304
DE-HE,03-07-2020,RKI,0,0,0,1593734400000,06411,Darmstadt,170,14,156,159207,1304
DE-HE,07-07-2020,RKI,0,0,0,1594080000000,06411,Darmstadt,170,14,156,159207,1304
DE-HE,09-07-2020,RKI,1,1,0,1594252800000,06411,Darmstadt,171,14,157,159207,1304
DE-HE,11-07-2020,RKI,2,0,0,1594425600000,06411,Darmstadt,173,14,157,159207,1304
DE-HE,13-07-2020,RKI,2,0,0,1594598400000,06411,Darmstadt,175,14,157,159207,1304
DE-HE,14-07-2020,RKI,5,0,0,1594684800000,06411,Darmstadt,180,14,157,159207,1304
DE-HE,04-03-2020,RKI,0,0,0,1583280000000,06412,Frankfurt am Main,1,0,1,753056,3033
DE-HE,05-03-2020,RKI,1,1,0,1583366400000,06412,Frankfurt am Main,2,0,2,753056,3033
DE-HE,09-03-2020,RKI,0,0,0,1583712000000,06412,Frankfurt am Main,2,0,2,753056,3033
DE-HE,10-03-2020,RKI,2,2,0,1583798400000,06412,Frankfurt am Main,4,0,4,753056,3033
DE-HE,11-03-2020,RKI,2,2,0,1583884800000,06412,Frankfurt am Main,6,0,6,753056,3033
DE-HE,12-03-2020,RKI,1,1,0,1583971200000,06412,Frankfurt am Main,7,0,7,753056,3033
DE-HE,13-03-2020,RKI,10,10,0,1584057600000,06412,Frankfurt am Main,17,0,17,753056,3033
DE-HE,14-03-2020,RKI,9,9,0,1584144000000,06412,Frankfurt am Main,26,0,26,753056,3033
DE-HE,16-03-2020,RKI,14,14,0,1584316800000,06412,Frankfurt am Main,40,0,40,753056,3033
DE-HE,17-03-2020,RKI,30,30,0,1584403200000,06412,Frankfurt am Main,70,0,70,753056,3033
DE-HE,18-03-2020,RKI,13,13,0,1584489600000,06412,Frankfurt am Main,83,0,83,753056,3033
DE-HE,19-03-2020,RKI,23,23,0,1584576000000,06412,Frankfurt am Main,106,0,106,753056,3033
DE-HE,20-03-2020,RKI,25,25,0,1584662400000,06412,Frankfurt am Main,131,0,131,753056,3033
DE-HE,21-03-2020,RKI,10,10,0,1584748800000,06412,Frankfurt am Main,141,0,141,753056,3033
DE-HE,22-03-2020,RKI,3,3,0,1584835200000,06412,Frankfurt am Main,144,0,144,753056,3033
DE-HE,23-03-2020,RKI,31,30,1,1584921600000,06412,Frankfurt am Main,175,1,174,753056,3033
DE-HE,24-03-2020,RKI,21,21,0,1585008000000,06412,Frankfurt am Main,196,1,195,753056,3033
DE-HE,25-03-2020,RKI,21,21,0,1585094400000,06412,Frankfurt am Main,217,1,216,753056,3033
DE-HE,26-03-2020,RKI,47,44,3,1585180800000,06412,Frankfurt am Main,264,4,260,753056,3033
DE-HE,27-03-2020,RKI,32,31,1,1585267200000,06412,Frankfurt am Main,296,5,291,753056,3033
DE-HE,28-03-2020,RKI,8,8,0,1585353600000,06412,Frankfurt am Main,304,5,299,753056,3033
DE-HE,29-03-2020,RKI,39,34,5,1585440000000,06412,Frankfurt am Main,343,10,333,753056,3033
DE-HE,30-03-2020,RKI,22,18,4,1585526400000,06412,Frankfurt am Main,365,14,351,753056,3033
DE-HE,31-03-2020,RKI,37,36,1,1585612800000,06412,Frankfurt am Main,402,15,387,753056,3033
DE-HE,01-04-2020,RKI,44,43,1,1585699200000,06412,Frankfurt am Main,446,16,430,753056,3033
DE-HE,02-04-2020,RKI,39,38,1,1585785600000,06412,Frankfurt am Main,485,17,468,753056,3033
DE-HE,03-04-2020,RKI,30,29,1,1585872000000,06412,Frankfurt am Main,515,18,497,753056,3033
DE-HE,04-04-2020,RKI,35,33,2,1585958400000,06412,Frankfurt am Main,550,20,530,753056,3033
DE-HE,05-04-2020,RKI,25,24,1,1586044800000,06412,Frankfurt am Main,575,21,554,753056,3033
DE-HE,06-04-2020,RKI,27,25,2,1586131200000,06412,Frankfurt am Main,602,23,579,753056,3033
DE-HE,07-04-2020,RKI,41,39,2,1586217600000,06412,Frankfurt am Main,643,25,618,753056,3033
DE-HE,08-04-2020,RKI,57,50,7,1586304000000,06412,Frankfurt am Main,700,32,668,753056,3033
DE-HE,09-04-2020,RKI,56,51,5,1586390400000,06412,Frankfurt am Main,756,37,719,753056,3033
DE-HE,10-04-2020,RKI,15,14,1,1586476800000,06412,Frankfurt am Main,771,38,733,753056,3033
DE-HE,11-04-2020,RKI,32,31,1,1586563200000,06412,Frankfurt am Main,803,39,764,753056,3033
DE-HE,12-04-2020,RKI,14,12,2,1586649600000,06412,Frankfurt am Main,817,41,776,753056,3033
DE-HE,13-04-2020,RKI,14,13,1,1586736000000,06412,Frankfurt am Main,831,42,789,753056,3033
DE-HE,14-04-2020,RKI,51,48,3,1586822400000,06412,Frankfurt am Main,882,45,837,753056,3033
DE-HE,15-04-2020,RKI,38,35,3,1586908800000,06412,Frankfurt am Main,920,48,872,753056,3033
DE-HE,16-04-2020,RKI,29,27,2,1586995200000,06412,Frankfurt am Main,949,50,899,753056,3033
DE-HE,17-04-2020,RKI,36,34,2,1587081600000,06412,Frankfurt am Main,985,52,933,753056,3033
DE-HE,18-04-2020,RKI,14,14,0,1587168000000,06412,Frankfurt am Main,999,52,947,753056,3033
DE-HE,19-04-2020,RKI,11,11,0,1587254400000,06412,Frankfurt am Main,1010,52,958,753056,3033
DE-HE,20-04-2020,RKI,29,24,5,1587340800000,06412,Frankfurt am Main,1039,57,982,753056,3033
DE-HE,21-04-2020,RKI,22,22,0,1587427200000,06412,Frankfurt am Main,1061,57,1004,753056,3033
DE-HE,22-04-2020,RKI,27,26,1,1587513600000,06412,Frankfurt am Main,1088,58,1030,753056,3033
DE-HE,23-04-2020,RKI,24,23,1,1587600000000,06412,Frankfurt am Main,1112,59,1053,753056,3033
DE-HE,24-04-2020,RKI,16,16,0,1587686400000,06412,Frankfurt am Main,1128,59,1069,753056,3033
DE-HE,25-04-2020,RKI,18,17,1,1587772800000,06412,Frankfurt am Main,1146,60,1086,753056,3033
DE-HE,26-04-2020,RKI,4,3,1,1587859200000,06412,Frankfurt am Main,1150,61,1089,753056,3033
DE-HE,27-04-2020,RKI,8,7,1,1587945600000,06412,Frankfurt am Main,1158,62,1096,753056,3033
DE-HE,28-04-2020,RKI,14,14,0,1588032000000,06412,Frankfurt am Main,1172,62,1110,753056,3033
DE-HE,29-04-2020,RKI,26,26,0,1588118400000,06412,Frankfurt am Main,1198,62,1136,753056,3033
DE-HE,30-04-2020,RKI,19,19,0,1588204800000,06412,Frankfurt am Main,1217,62,1155,753056,3033
DE-HE,01-05-2020,RKI,8,8,0,1588291200000,06412,Frankfurt am Main,1225,62,1163,753056,3033
DE-HE,02-05-2020,RKI,5,5,0,1588377600000,06412,Frankfurt am Main,1230,62,1168,753056,3033
DE-HE,03-05-2020,RKI,4,4,0,1588464000000,06412,Frankfurt am Main,1234,62,1172,753056,3033
DE-HE,04-05-2020,RKI,4,4,0,1588550400000,06412,Frankfurt am Main,1238,62,1176,753056,3033
DE-HE,05-05-2020,RKI,11,11,0,1588636800000,06412,Frankfurt am Main,1249,62,1187,753056,3033
DE-HE,06-05-2020,RKI,15,15,0,1588723200000,06412,Frankfurt am Main,1264,62,1202,753056,3033
DE-HE,07-05-2020,RKI,10,9,1,1588809600000,06412,Frankfurt am Main,1274,63,1211,753056,3033
DE-HE,08-05-2020,RKI,9,8,1,1588896000000,06412,Frankfurt am Main,1283,64,1219,753056,3033
DE-HE,09-05-2020,RKI,2,2,0,1588982400000,06412,Frankfurt am Main,1285,64,1221,753056,3033
DE-HE,10-05-2020,RKI,1,1,0,1589068800000,06412,Frankfurt am Main,1286,64,1222,753056,3033
DE-HE,11-05-2020,RKI,2,2,0,1589155200000,06412,Frankfurt am Main,1288,64,1224,753056,3033
DE-HE,12-05-2020,RKI,10,10,0,1589241600000,06412,Frankfurt am Main,1298,64,1234,753056,3033
DE-HE,13-05-2020,RKI,8,8,0,1589328000000,06412,Frankfurt am Main,1306,64,1242,753056,3033
DE-HE,14-05-2020,RKI,10,10,0,1589414400000,06412,Frankfurt am Main,1316,64,1252,753056,3033
DE-HE,15-05-2020,RKI,16,15,1,1589500800000,06412,Frankfurt am Main,1332,65,1267,753056,3033
DE-HE,16-05-2020,RKI,8,8,0,1589587200000,06412,Frankfurt am Main,1340,65,1275,753056,3033
DE-HE,17-05-2020,RKI,54,54,0,1589673600000,06412,Frankfurt am Main,1394,65,1329,753056,3033
DE-HE,18-05-2020,RKI,12,12,0,1589760000000,06412,Frankfurt am Main,1406,65,1341,753056,3033
DE-HE,19-05-2020,RKI,21,21,0,1589846400000,06412,Frankfurt am Main,1427,65,1362,753056,3033
DE-HE,20-05-2020,RKI,13,13,0,1589932800000,06412,Frankfurt am Main,1440,65,1375,753056,3033
DE-HE,22-05-2020,RKI,19,19,0,1590105600000,06412,Frankfurt am Main,1459,65,1394,753056,3033
DE-HE,23-05-2020,RKI,9,9,0,1590192000000,06412,Frankfurt am Main,1468,65,1403,753056,3033
DE-HE,24-05-2020,RKI,1,1,0,1590278400000,06412,Frankfurt am Main,1469,65,1404,753056,3033
DE-HE,25-05-2020,RKI,0,0,0,1590364800000,06412,Frankfurt am Main,1469,65,1404,753056,3033
DE-HE,26-05-2020,RKI,15,15,0,1590451200000,06412,Frankfurt am Main,1484,65,1419,753056,3033
DE-HE,27-05-2020,RKI,4,4,0,1590537600000,06412,Frankfurt am Main,1488,65,1423,753056,3033
DE-HE,28-05-2020,RKI,21,21,0,1590624000000,06412,Frankfurt am Main,1509,65,1444,753056,3033
DE-HE,29-05-2020,RKI,10,10,0,1590710400000,06412,Frankfurt am Main,1519,65,1454,753056,3033
DE-HE,30-05-2020,RKI,8,8,0,1590796800000,06412,Frankfurt am Main,1527,65,1462,753056,3033
DE-HE,31-05-2020,RKI,4,4,0,1590883200000,06412,Frankfurt am Main,1531,65,1466,753056,3033
DE-HE,01-06-2020,RKI,0,0,0,1590969600000,06412,Frankfurt am Main,1531,65,1466,753056,3033
DE-HE,02-06-2020,RKI,1,1,0,1591056000000,06412,Frankfurt am Main,1532,65,1467,753056,3033
DE-HE,03-06-2020,RKI,1,1,0,1591142400000,06412,Frankfurt am Main,1533,65,1468,753056,3033
DE-HE,04-06-2020,RKI,4,3,1,1591228800000,06412,Frankfurt am Main,1537,66,1471,753056,3033
DE-HE,05-06-2020,RKI,2,2,0,1591315200000,06412,Frankfurt am Main,1539,66,1473,753056,3033
DE-HE,06-06-2020,RKI,9,9,0,1591401600000,06412,Frankfurt am Main,1548,66,1482,753056,3033
DE-HE,08-06-2020,RKI,2,2,0,1591574400000,06412,Frankfurt am Main,1550,66,1484,753056,3033
DE-HE,09-06-2020,RKI,3,3,0,1591660800000,06412,Frankfurt am Main,1553,66,1487,753056,3033
DE-HE,10-06-2020,RKI,3,3,0,1591747200000,06412,Frankfurt am Main,1556,66,1490,753056,3033
DE-HE,11-06-2020,RKI,3,3,0,1591833600000,06412,Frankfurt am Main,1559,66,1493,753056,3033
DE-HE,12-06-2020,RKI,14,14,0,1591920000000,06412,Frankfurt am Main,1573,66,1507,753056,3033
DE-HE,13-06-2020,RKI,1,1,0,1592006400000,06412,Frankfurt am Main,1574,66,1508,753056,3033
DE-HE,14-06-2020,RKI,0,0,0,1592092800000,06412,Frankfurt am Main,1574,66,1508,753056,3033
DE-HE,15-06-2020,RKI,0,0,0,1592179200000,06412,Frankfurt am Main,1574,66,1508,753056,3033
DE-HE,16-06-2020,RKI,3,2,1,1592265600000,06412,Frankfurt am Main,1577,67,1510,753056,3033
DE-HE,17-06-2020,RKI,11,11,0,1592352000000,06412,Frankfurt am Main,1588,67,1521,753056,3033
DE-HE,18-06-2020,RKI,7,7,0,1592438400000,06412,Frankfurt am Main,1595,67,1528,753056,3033
DE-HE,19-06-2020,RKI,22,21,1,1592524800000,06412,Frankfurt am Main,1617,68,1549,753056,3033
DE-HE,20-06-2020,RKI,1,1,0,1592611200000,06412,Frankfurt am Main,1618,68,1550,753056,3033
DE-HE,21-06-2020,RKI,3,3,0,1592697600000,06412,Frankfurt am Main,1621,68,1553,753056,3033
DE-HE,23-06-2020,RKI,8,4,0,1592870400000,06412,Frankfurt am Main,1629,68,1557,753056,3033
DE-HE,24-06-2020,RKI,1,0,0,1592956800000,06412,Frankfurt am Main,1630,68,1557,753056,3033
DE-HE,25-06-2020,RKI,10,6,0,1593043200000,06412,Frankfurt am Main,1640,68,1563,753056,3033
DE-HE,26-06-2020,RKI,4,1,0,1593129600000,06412,Frankfurt am Main,1644,68,1564,753056,3033
DE-HE,27-06-2020,RKI,2,2,0,1593216000000,06412,Frankfurt am Main,1646,68,1566,753056,3033
DE-HE,28-06-2020,RKI,0,0,0,1593302400000,06412,Frankfurt am Main,1646,68,1566,753056,3033
DE-HE,30-06-2020,RKI,1,1,0,1593475200000,06412,Frankfurt am Main,1647,68,1567,753056,3033
DE-HE,02-07-2020,RKI,5,5,0,1593648000000,06412,Frankfurt am Main,1652,68,1572,753056,3033
DE-HE,03-07-2020,RKI,1,0,0,1593734400000,06412,Frankfurt am Main,1653,68,1572,753056,3033
DE-HE,04-07-2020,RKI,5,3,0,1593820800000,06412,Frankfurt am Main,1658,68,1575,753056,3033
DE-HE,05-07-2020,RKI,3,1,0,1593907200000,06412,Frankfurt am Main,1661,68,1576,753056,3033
DE-HE,06-07-2020,RKI,5,3,0,1593993600000,06412,Frankfurt am Main,1666,68,1579,753056,3033
DE-HE,07-07-2020,RKI,7,3,0,1594080000000,06412,Frankfurt am Main,1673,68,1582,753056,3033
DE-HE,08-07-2020,RKI,10,2,0,1594166400000,06412,Frankfurt am Main,1683,68,1584,753056,3033
DE-HE,09-07-2020,RKI,6,2,0,1594252800000,06412,Frankfurt am Main,1689,68,1586,753056,3033
DE-HE,10-07-2020,RKI,12,1,0,1594339200000,06412,Frankfurt am Main,1701,68,1587,753056,3033
DE-HE,11-07-2020,RKI,9,0,0,1594425600000,06412,Frankfurt am Main,1710,68,1587,753056,3033
DE-HE,12-07-2020,RKI,1,0,0,1594512000000,06412,Frankfurt am Main,1711,68,1587,753056,3033
DE-HE,13-07-2020,RKI,3,1,0,1594598400000,06412,Frankfurt am Main,1714,68,1588,753056,3033
DE-HE,14-07-2020,RKI,3,0,0,1594684800000,06412,Frankfurt am Main,1717,68,1588,753056,3033
DE-HE,15-07-2020,RKI,18,0,0,1594771200000,06412,Frankfurt am Main,1735,68,1588,753056,3033
DE-HE,11-03-2020,RKI,3,3,0,1583884800000,06414,Wiesbaden,3,0,3,278342,1365
DE-HE,12-03-2020,RKI,0,0,0,1583971200000,06414,Wiesbaden,3,0,3,278342,1365
DE-HE,13-03-2020,RKI,0,0,0,1584057600000,06414,Wiesbaden,3,0,3,278342,1365
DE-HE,16-03-2020,RKI,12,12,0,1584316800000,06414,Wiesbaden,15,0,15,278342,1365
DE-HE,17-03-2020,RKI,1,1,0,1584403200000,06414,Wiesbaden,16,0,16,278342,1365
DE-HE,18-03-2020,RKI,11,10,1,1584489600000,06414,Wiesbaden,27,1,26,278342,1365
DE-HE,19-03-2020,RKI,11,11,0,1584576000000,06414,Wiesbaden,38,1,37,278342,1365
DE-HE,20-03-2020,RKI,12,12,0,1584662400000,06414,Wiesbaden,50,1,49,278342,1365
DE-HE,23-03-2020,RKI,33,32,1,1584921600000,06414,Wiesbaden,83,2,81,278342,1365
DE-HE,24-03-2020,RKI,6,6,0,1585008000000,06414,Wiesbaden,89,2,87,278342,1365
DE-HE,25-03-2020,RKI,9,9,0,1585094400000,06414,Wiesbaden,98,2,96,278342,1365
DE-HE,26-03-2020,RKI,17,17,0,1585180800000,06414,Wiesbaden,115,2,113,278342,1365
DE-HE,27-03-2020,RKI,17,17,0,1585267200000,06414,Wiesbaden,132,2,130,278342,1365
DE-HE,30-03-2020,RKI,25,25,0,1585526400000,06414,Wiesbaden,157,2,155,278342,1365
DE-HE,31-03-2020,RKI,6,5,1,1585612800000,06414,Wiesbaden,163,3,160,278342,1365
DE-HE,01-04-2020,RKI,7,6,1,1585699200000,06414,Wiesbaden,170,4,166,278342,1365
DE-HE,02-04-2020,RKI,4,3,1,1585785600000,06414,Wiesbaden,174,5,169,278342,1365
DE-HE,03-04-2020,RKI,3,2,1,1585872000000,06414,Wiesbaden,177,6,171,278342,1365
DE-HE,04-04-2020,RKI,6,5,1,1585958400000,06414,Wiesbaden,183,7,176,278342,1365
DE-HE,05-04-2020,RKI,3,3,0,1586044800000,06414,Wiesbaden,186,7,179,278342,1365
DE-HE,06-04-2020,RKI,0,0,0,1586131200000,06414,Wiesbaden,186,7,179,278342,1365
DE-HE,07-04-2020,RKI,6,5,1,1586217600000,06414,Wiesbaden,192,8,184,278342,1365
DE-HE,08-04-2020,RKI,10,10,0,1586304000000,06414,Wiesbaden,202,8,194,278342,1365
DE-HE,09-04-2020,RKI,11,9,2,1586390400000,06414,Wiesbaden,213,10,203,278342,1365
DE-HE,10-04-2020,RKI,4,4,0,1586476800000,06414,Wiesbaden,217,10,207,278342,1365
DE-HE,11-04-2020,RKI,2,1,1,1586563200000,06414,Wiesbaden,219,11,208,278342,1365
DE-HE,12-04-2020,RKI,0,0,0,1586649600000,06414,Wiesbaden,219,11,208,278342,1365
DE-HE,13-04-2020,RKI,0,0,0,1586736000000,06414,Wiesbaden,219,11,208,278342,1365
DE-HE,14-04-2020,RKI,3,3,0,1586822400000,06414,Wiesbaden,222,11,211,278342,1365
DE-HE,15-04-2020,RKI,5,5,0,1586908800000,06414,Wiesbaden,227,11,216,278342,1365
DE-HE,16-04-2020,RKI,8,8,0,1586995200000,06414,Wiesbaden,235,11,224,278342,1365
DE-HE,17-04-2020,RKI,6,6,0,1587081600000,06414,Wiesbaden,241,11,230,278342,1365
DE-HE,18-04-2020,RKI,0,0,0,1587168000000,06414,Wiesbaden,241,11,230,278342,1365
DE-HE,19-04-2020,RKI,3,3,0,1587254400000,06414,Wiesbaden,244,11,233,278342,1365
DE-HE,20-04-2020,RKI,0,0,0,1587340800000,06414,Wiesbaden,244,11,233,278342,1365
DE-HE,21-04-2020,RKI,6,6,0,1587427200000,06414,Wiesbaden,250,11,239,278342,1365
DE-HE,22-04-2020,RKI,0,0,0,1587513600000,06414,Wiesbaden,250,11,239,278342,1365
DE-HE,23-04-2020,RKI,1,0,1,1587600000000,06414,Wiesbaden,251,12,239,278342,1365
DE-HE,24-04-2020,RKI,0,0,0,1587686400000,06414,Wiesbaden,251,12,239,278342,1365
DE-HE,25-04-2020,RKI,6,6,0,1587772800000,06414,Wiesbaden,257,12,245,278342,1365
DE-HE,26-04-2020,RKI,0,0,0,1587859200000,06414,Wiesbaden,257,12,245,278342,1365
DE-HE,27-04-2020,RKI,0,0,0,1587945600000,06414,Wiesbaden,257,12,245,278342,1365
DE-HE,28-04-2020,RKI,7,6,1,1588032000000,06414,Wiesbaden,264,13,251,278342,1365
DE-HE,29-04-2020,RKI,1,1,0,1588118400000,06414,Wiesbaden,265,13,252,278342,1365
DE-HE,30-04-2020,RKI,3,3,0,1588204800000,06414,Wiesbaden,268,13,255,278342,1365
DE-HE,01-05-2020,RKI,8,8,0,1588291200000,06414,Wiesbaden,276,13,263,278342,1365
DE-HE,04-05-2020,RKI,1,1,0,1588550400000,06414,Wiesbaden,277,13,264,278342,1365
DE-HE,05-05-2020,RKI,3,3,0,1588636800000,06414,Wiesbaden,280,13,267,278342,1365
DE-HE,06-05-2020,RKI,10,10,0,1588723200000,06414,Wiesbaden,290,13,277,278342,1365
DE-HE,07-05-2020,RKI,5,5,0,1588809600000,06414,Wiesbaden,295,13,282,278342,1365
DE-HE,09-05-2020,RKI,2,2,0,1588982400000,06414,Wiesbaden,297,13,284,278342,1365
DE-HE,10-05-2020,RKI,0,0,0,1589068800000,06414,Wiesbaden,297,13,284,278342,1365
DE-HE,11-05-2020,RKI,0,0,0,1589155200000,06414,Wiesbaden,297,13,284,278342,1365
DE-HE,12-05-2020,RKI,4,4,0,1589241600000,06414,Wiesbaden,301,13,288,278342,1365
DE-HE,13-05-2020,RKI,7,7,0,1589328000000,06414,Wiesbaden,308,13,295,278342,1365
DE-HE,14-05-2020,RKI,4,4,0,1589414400000,06414,Wiesbaden,312,13,299,278342,1365
DE-HE,15-05-2020,RKI,3,2,1,1589500800000,06414,Wiesbaden,315,14,301,278342,1365
DE-HE,16-05-2020,RKI,6,6,0,1589587200000,06414,Wiesbaden,321,14,307,278342,1365
DE-HE,17-05-2020,RKI,7,5,2,1589673600000,06414,Wiesbaden,328,16,312,278342,1365
DE-HE,18-05-2020,RKI,2,2,0,1589760000000,06414,Wiesbaden,330,16,314,278342,1365
DE-HE,19-05-2020,RKI,1,1,0,1589846400000,06414,Wiesbaden,331,16,315,278342,1365
DE-HE,20-05-2020,RKI,6,5,1,1589932800000,06414,Wiesbaden,337,17,320,278342,1365
DE-HE,21-05-2020,RKI,2,2,0,1590019200000,06414,Wiesbaden,339,17,322,278342,1365
DE-HE,22-05-2020,RKI,0,0,0,1590105600000,06414,Wiesbaden,339,17,322,278342,1365
DE-HE,23-05-2020,RKI,19,16,3,1590192000000,06414,Wiesbaden,358,20,338,278342,1365
DE-HE,24-05-2020,RKI,0,0,0,1590278400000,06414,Wiesbaden,358,20,338,278342,1365
DE-HE,25-05-2020,RKI,0,0,0,1590364800000,06414,Wiesbaden,358,20,338,278342,1365
DE-HE,26-05-2020,RKI,3,3,0,1590451200000,06414,Wiesbaden,361,20,341,278342,1365
DE-HE,27-05-2020,RKI,5,5,0,1590537600000,06414,Wiesbaden,366,20,346,278342,1365
DE-HE,28-05-2020,RKI,0,0,0,1590624000000,06414,Wiesbaden,366,20,346,278342,1365
DE-HE,29-05-2020,RKI,1,1,0,1590710400000,06414,Wiesbaden,367,20,347,278342,1365
DE-HE,30-05-2020,RKI,0,0,0,1590796800000,06414,Wiesbaden,367,20,347,278342,1365
DE-HE,01-06-2020,RKI,0,0,0,1590969600000,06414,Wiesbaden,367,20,347,278342,1365
DE-HE,02-06-2020,RKI,0,0,0,1591056000000,06414,Wiesbaden,367,20,347,278342,1365
DE-HE,03-06-2020,RKI,1,1,0,1591142400000,06414,Wiesbaden,368,20,348,278342,1365
DE-HE,06-06-2020,RKI,2,2,0,1591401600000,06414,Wiesbaden,370,20,350,278342,1365
DE-HE,08-06-2020,RKI,0,0,0,1591574400000,06414,Wiesbaden,370,20,350,278342,1365
DE-HE,09-06-2020,RKI,0,0,0,1591660800000,06414,Wiesbaden,370,20,350,278342,1365
DE-HE,10-06-2020,RKI,4,4,0,1591747200000,06414,Wiesbaden,374,20,354,278342,1365
DE-HE,13-06-2020,RKI,1,1,0,1592006400000,06414,Wiesbaden,375,20,355,278342,1365
DE-HE,16-06-2020,RKI,3,3,0,1592265600000,06414,Wiesbaden,378,20,358,278342,1365
DE-HE,17-06-2020,RKI,1,1,0,1592352000000,06414,Wiesbaden,379,20,359,278342,1365
DE-HE,23-06-2020,RKI,0,0,0,1592870400000,06414,Wiesbaden,379,20,359,278342,1365
DE-HE,26-06-2020,RKI,0,0,0,1593129600000,06414,Wiesbaden,379,20,359,278342,1365
DE-HE,29-06-2020,RKI,0,0,0,1593388800000,06414,Wiesbaden,379,20,359,278342,1365
DE-HE,30-06-2020,RKI,0,0,0,1593475200000,06414,Wiesbaden,379,20,359,278342,1365
DE-HE,01-07-2020,RKI,3,3,0,1593561600000,06414,Wiesbaden,382,20,362,278342,1365
DE-HE,02-07-2020,RKI,1,1,0,1593648000000,06414,Wiesbaden,383,20,363,278342,1365
DE-HE,03-07-2020,RKI,2,2,0,1593734400000,06414,Wiesbaden,385,20,365,278342,1365
DE-HE,04-07-2020,RKI,2,0,0,1593820800000,06414,Wiesbaden,387,20,365,278342,1365
DE-HE,07-07-2020,RKI,0,0,0,1594080000000,06414,Wiesbaden,387,20,365,278342,1365
DE-HE,08-07-2020,RKI,0,0,0,1594166400000,06414,Wiesbaden,387,20,365,278342,1365
DE-HE,09-07-2020,RKI,2,0,0,1594252800000,06414,Wiesbaden,389,20,365,278342,1365
DE-HE,13-07-2020,RKI,0,0,0,1594598400000,06414,Wiesbaden,389,20,365,278342,1365
DE-HE,15-07-2020,RKI,2,0,0,1594771200000,06414,Wiesbaden,391,20,365,278342,1365
DE-HE,16-07-2020,RKI,4,0,0,1594857600000,06414,Wiesbaden,395,20,365,278342,1365
DE-HE,09-03-2020,RKI,0,0,0,1583712000000,06431,Bergstraße,2,0,2,269694,375
DE-HE,10-03-2020,RKI,0,0,0,1583798400000,06431,Bergstraße,2,0,2,269694,375
DE-HE,11-03-2020,RKI,0,0,0,1583884800000,06431,Bergstraße,2,0,2,269694,375
DE-HE,12-03-2020,RKI,0,0,0,1583971200000,06431,Bergstraße,2,0,2,269694,375
DE-HE,16-03-2020,RKI,11,11,0,1584316800000,06431,Bergstraße,13,0,13,269694,375
DE-HE,17-03-2020,RKI,5,5,0,1584403200000,06431,Bergstraße,18,0,18,269694,375
DE-HE,18-03-2020,RKI,3,3,0,1584489600000,06431,Bergstraße,21,0,21,269694,375
DE-HE,19-03-2020,RKI,6,6,0,1584576000000,06431,Bergstraße,27,0,27,269694,375
DE-HE,20-03-2020,RKI,3,3,0,1584662400000,06431,Bergstraße,30,0,30,269694,375
DE-HE,23-03-2020,RKI,28,28,0,1584921600000,06431,Bergstraße,58,0,58,269694,375
DE-HE,24-03-2020,RKI,23,21,2,1585008000000,06431,Bergstraße,81,2,79,269694,375
DE-HE,25-03-2020,RKI,8,8,0,1585094400000,06431,Bergstraße,89,2,87,269694,375
DE-HE,26-03-2020,RKI,10,10,0,1585180800000,06431,Bergstraße,99,2,97,269694,375
DE-HE,27-03-2020,RKI,20,20,0,1585267200000,06431,Bergstraße,119,2,117,269694,375
DE-HE,29-03-2020,RKI,19,18,1,1585440000000,06431,Bergstraße,138,3,135,269694,375
DE-HE,30-03-2020,RKI,14,14,0,1585526400000,06431,Bergstraße,152,3,149,269694,375
DE-HE,31-03-2020,RKI,8,8,0,1585612800000,06431,Bergstraße,160,3,157,269694,375
DE-HE,01-04-2020,RKI,10,10,0,1585699200000,06431,Bergstraße,170,3,167,269694,375
DE-HE,02-04-2020,RKI,13,13,0,1585785600000,06431,Bergstraße,183,3,180,269694,375
DE-HE,03-04-2020,RKI,2,2,0,1585872000000,06431,Bergstraße,185,3,182,269694,375
DE-HE,04-04-2020,RKI,13,13,0,1585958400000,06431,Bergstraße,198,3,195,269694,375
DE-HE,05-04-2020,RKI,4,4,0,1586044800000,06431,Bergstraße,202,3,199,269694,375
DE-HE,06-04-2020,RKI,1,1,0,1586131200000,06431,Bergstraße,203,3,200,269694,375
DE-HE,07-04-2020,RKI,8,8,0,1586217600000,06431,Bergstraße,211,3,208,269694,375
DE-HE,08-04-2020,RKI,12,12,0,1586304000000,06431,Bergstraße,223,3,220,269694,375
DE-HE,09-04-2020,RKI,5,5,0,1586390400000,06431,Bergstraße,228,3,225,269694,375
DE-HE,10-04-2020,RKI,3,3,0,1586476800000,06431,Bergstraße,231,3,228,269694,375
DE-HE,11-04-2020,RKI,2,2,0,1586563200000,06431,Bergstraße,233,3,230,269694,375
DE-HE,12-04-2020,RKI,4,4,0,1586649600000,06431,Bergstraße,237,3,234,269694,375
DE-HE,13-04-2020,RKI,0,0,0,1586736000000,06431,Bergstraße,237,3,234,269694,375
DE-HE,14-04-2020,RKI,3,3,0,1586822400000,06431,Bergstraße,240,3,237,269694,375
DE-HE,15-04-2020,RKI,8,8,0,1586908800000,06431,Bergstraße,248,3,245,269694,375
DE-HE,16-04-2020,RKI,2,2,0,1586995200000,06431,Bergstraße,250,3,247,269694,375
DE-HE,17-04-2020,RKI,1,1,0,1587081600000,06431,Bergstraße,251,3,248,269694,375
DE-HE,18-04-2020,RKI,1,1,0,1587168000000,06431,Bergstraße,252,3,249,269694,375
DE-HE,20-04-2020,RKI,0,0,0,1587340800000,06431,Bergstraße,252,3,249,269694,375
DE-HE,21-04-2020,RKI,1,1,0,1587427200000,06431,Bergstraße,253,3,250,269694,375
DE-HE,22-04-2020,RKI,3,3,0,1587513600000,06431,Bergstraße,256,3,253,269694,375
DE-HE,23-04-2020,RKI,0,0,0,1587600000000,06431,Bergstraße,256,3,253,269694,375
DE-HE,24-04-2020,RKI,1,1,0,1587686400000,06431,Bergstraße,257,3,254,269694,375
DE-HE,27-04-2020,RKI,2,2,0,1587945600000,06431,Bergstraße,259,3,256,269694,375
DE-HE,28-04-2020,RKI,2,2,0,1588032000000,06431,Bergstraße,261,3,258,269694,375
DE-HE,29-04-2020,RKI,4,4,0,1588118400000,06431,Bergstraße,265,3,262,269694,375
DE-HE,30-04-2020,RKI,1,1,0,1588204800000,06431,Bergstraße,266,3,263,269694,375
DE-HE,05-05-2020,RKI,2,2,0,1588636800000,06431,Bergstraße,268,3,265,269694,375
DE-HE,06-05-2020,RKI,2,2,0,1588723200000,06431,Bergstraße,270,3,267,269694,375
DE-HE,07-05-2020,RKI,2,2,0,1588809600000,06431,Bergstraße,272,3,269,269694,375
DE-HE,08-05-2020,RKI,2,2,0,1588896000000,06431,Bergstraße,274,3,271,269694,375
DE-HE,11-05-2020,RKI,1,1,0,1589155200000,06431,Bergstraße,275,3,272,269694,375
DE-HE,12-05-2020,RKI,4,4,0,1589241600000,06431,Bergstraße,279,3,276,269694,375
DE-HE,13-05-2020,RKI,1,1,0,1589328000000,06431,Bergstraße,280,3,277,269694,375
DE-HE,14-05-2020,RKI,0,0,0,1589414400000,06431,Bergstraße,280,3,277,269694,375
DE-HE,15-05-2020,RKI,0,0,0,1589500800000,06431,Bergstraße,280,3,277,269694,375
DE-HE,18-05-2020,RKI,4,4,0,1589760000000,06431,Bergstraße,284,3,281,269694,375
DE-HE,21-05-2020,RKI,0,0,0,1590019200000,06431,Bergstraße,284,3,281,269694,375
DE-HE,22-05-2020,RKI,0,0,0,1590105600000,06431,Bergstraße,284,3,281,269694,375
DE-HE,25-05-2020,RKI,7,7,0,1590364800000,06431,Bergstraße,291,3,288,269694,375
DE-HE,28-05-2020,RKI,0,0,0,1590624000000,06431,Bergstraße,291,3,288,269694,375
DE-HE,29-05-2020,RKI,1,1,0,1590710400000,06431,Bergstraße,292,3,289,269694,375
DE-HE,31-05-2020,RKI,0,0,0,1590883200000,06431,Bergstraße,292,3,289,269694,375
DE-HE,03-06-2020,RKI,0,0,0,1591142400000,06431,Bergstraße,292,3,289,269694,375
DE-HE,08-06-2020,RKI,1,1,0,1591574400000,06431,Bergstraße,293,3,290,269694,375
DE-HE,14-06-2020,RKI,0,0,0,1592092800000,06431,Bergstraße,293,3,290,269694,375
DE-HE,16-06-2020,RKI,0,0,0,1592265600000,06431,Bergstraße,293,3,290,269694,375
DE-HE,17-06-2020,RKI,1,1,0,1592352000000,06431,Bergstraße,294,3,291,269694,375
DE-HE,19-06-2020,RKI,2,2,0,1592524800000,06431,Bergstraße,296,3,293,269694,375
DE-HE,20-06-2020,RKI,0,0,0,1592611200000,06431,Bergstraße,296,3,293,269694,375
DE-HE,23-06-2020,RKI,0,0,0,1592870400000,06431,Bergstraße,296,3,293,269694,375
DE-HE,25-06-2020,RKI,0,0,0,1593043200000,06431,Bergstraße,296,3,293,269694,375
DE-HE,01-07-2020,RKI,0,0,0,1593561600000,06431,Bergstraße,296,3,293,269694,375
DE-HE,02-07-2020,RKI,0,0,0,1593648000000,06431,Bergstraße,296,3,293,269694,375
DE-HE,06-07-2020,RKI,4,1,0,1593993600000,06431,Bergstraße,300,3,294,269694,375
DE-HE,07-07-2020,RKI,0,0,0,1594080000000,06431,Bergstraße,300,3,294,269694,375
DE-HE,08-07-2020,RKI,1,0,0,1594166400000,06431,Bergstraße,301,3,294,269694,375
DE-HE,09-07-2020,RKI,3,0,0,1594252800000,06431,Bergstraße,304,3,294,269694,375
DE-HE,13-07-2020,RKI,0,0,0,1594598400000,06431,Bergstraße,304,3,294,269694,375
DE-HE,15-07-2020,RKI,0,0,0,1594771200000,06431,Bergstraße,304,3,294,269694,375
DE-HE,16-07-2020,RKI,0,0,0,1594857600000,06431,Bergstraße,304,3,294,269694,375
DE-HE,13-03-2020,RKI,0,0,0,1584057600000,06432,Darmstadt-Dieburg,2,0,2,297399,452
DE-HE,16-03-2020,RKI,3,3,0,1584316800000,06432,Darmstadt-Dieburg,5,0,5,297399,452
DE-HE,17-03-2020,RKI,9,9,0,1584403200000,06432,Darmstadt-Dieburg,14,0,14,297399,452
DE-HE,18-03-2020,RKI,3,3,0,1584489600000,06432,Darmstadt-Dieburg,17,0,17,297399,452
DE-HE,19-03-2020,RKI,16,16,0,1584576000000,06432,Darmstadt-Dieburg,33,0,33,297399,452
DE-HE,20-03-2020,RKI,23,23,0,1584662400000,06432,Darmstadt-Dieburg,56,0,56,297399,452
DE-HE,21-03-2020,RKI,9,8,1,1584748800000,06432,Darmstadt-Dieburg,65,1,64,297399,452
DE-HE,22-03-2020,RKI,1,1,0,1584835200000,06432,Darmstadt-Dieburg,66,1,65,297399,452
DE-HE,23-03-2020,RKI,2,2,0,1584921600000,06432,Darmstadt-Dieburg,68,1,67,297399,452
DE-HE,24-03-2020,RKI,10,9,1,1585008000000,06432,Darmstadt-Dieburg,78,2,76,297399,452
DE-HE,25-03-2020,RKI,21,21,0,1585094400000,06432,Darmstadt-Dieburg,99,2,97,297399,452
DE-HE,26-03-2020,RKI,18,16,2,1585180800000,06432,Darmstadt-Dieburg,117,4,113,297399,452
DE-HE,27-03-2020,RKI,16,16,0,1585267200000,06432,Darmstadt-Dieburg,133,4,129,297399,452
DE-HE,28-03-2020,RKI,8,8,0,1585353600000,06432,Darmstadt-Dieburg,141,4,137,297399,452
DE-HE,29-03-2020,RKI,4,2,2,1585440000000,06432,Darmstadt-Dieburg,145,6,139,297399,452
DE-HE,30-03-2020,RKI,15,14,1,1585526400000,06432,Darmstadt-Dieburg,160,7,153,297399,452
DE-HE,31-03-2020,RKI,17,17,0,1585612800000,06432,Darmstadt-Dieburg,177,7,170,297399,452
DE-HE,01-04-2020,RKI,11,10,1,1585699200000,06432,Darmstadt-Dieburg,188,8,180,297399,452
DE-HE,02-04-2020,RKI,7,7,0,1585785600000,06432,Darmstadt-Dieburg,195,8,187,297399,452
DE-HE,03-04-2020,RKI,7,6,1,1585872000000,06432,Darmstadt-Dieburg,202,9,193,297399,452
DE-HE,04-04-2020,RKI,4,4,0,1585958400000,06432,Darmstadt-Dieburg,206,9,197,297399,452
DE-HE,05-04-2020,RKI,5,5,0,1586044800000,06432,Darmstadt-Dieburg,211,9,202,297399,452
DE-HE,06-04-2020,RKI,6,5,1,1586131200000,06432,Darmstadt-Dieburg,217,10,207,297399,452
DE-HE,07-04-2020,RKI,8,7,1,1586217600000,06432,Darmstadt-Dieburg,225,11,214,297399,452
DE-HE,08-04-2020,RKI,11,11,0,1586304000000,06432,Darmstadt-Dieburg,236,11,225,297399,452
DE-HE,09-04-2020,RKI,14,12,2,1586390400000,06432,Darmstadt-Dieburg,250,13,237,297399,452
DE-HE,10-04-2020,RKI,4,3,1,1586476800000,06432,Darmstadt-Dieburg,254,14,240,297399,452
DE-HE,11-04-2020,RKI,1,1,0,1586563200000,06432,Darmstadt-Dieburg,255,14,241,297399,452
DE-HE,12-04-2020,RKI,3,3,0,1586649600000,06432,Darmstadt-Dieburg,258,14,244,297399,452
DE-HE,13-04-2020,RKI,0,0,0,1586736000000,06432,Darmstadt-Dieburg,258,14,244,297399,452
DE-HE,14-04-2020,RKI,8,7,1,1586822400000,06432,Darmstadt-Dieburg,266,15,251,297399,452
DE-HE,15-04-2020,RKI,7,7,0,1586908800000,06432,Darmstadt-Dieburg,273,15,258,297399,452
DE-HE,16-04-2020,RKI,8,8,0,1586995200000,06432,Darmstadt-Dieburg,281,15,266,297399,452
DE-HE,17-04-2020,RKI,3,3,0,1587081600000,06432,Darmstadt-Dieburg,284,15,269,297399,452
DE-HE,18-04-2020,RKI,6,6,0,1587168000000,06432,Darmstadt-Dieburg,290,15,275,297399,452
DE-HE,20-04-2020,RKI,1,0,1,1587340800000,06432,Darmstadt-Dieburg,291,16,275,297399,452
DE-HE,21-04-2020,RKI,4,4,0,1587427200000,06432,Darmstadt-Dieburg,295,16,279,297399,452
DE-HE,22-04-2020,RKI,3,2,1,1587513600000,06432,Darmstadt-Dieburg,298,17,281,297399,452
DE-HE,23-04-2020,RKI,2,2,0,1587600000000,06432,Darmstadt-Dieburg,300,17,283,297399,452
DE-HE,24-04-2020,RKI,0,0,0,1587686400000,06432,Darmstadt-Dieburg,300,17,283,297399,452
DE-HE,26-04-2020,RKI,1,1,0,1587859200000,06432,Darmstadt-Dieburg,301,17,284,297399,452
DE-HE,27-04-2020,RKI,9,9,0,1587945600000,06432,Darmstadt-Dieburg,310,17,293,297399,452
DE-HE,28-04-2020,RKI,0,0,0,1588032000000,06432,Darmstadt-Dieburg,310,17,293,297399,452
DE-HE,29-04-2020,RKI,0,0,0,1588118400000,06432,Darmstadt-Dieburg,310,17,293,297399,452
DE-HE,30-04-2020,RKI,3,2,1,1588204800000,06432,Darmstadt-Dieburg,313,18,295,297399,452
DE-HE,01-05-2020,RKI,0,0,0,1588291200000,06432,Darmstadt-Dieburg,313,18,295,297399,452
DE-HE,02-05-2020,RKI,0,0,0,1588377600000,06432,Darmstadt-Dieburg,313,18,295,297399,452
DE-HE,04-05-2020,RKI,0,0,0,1588550400000,06432,Darmstadt-Dieburg,313,18,295,297399,452
DE-HE,05-05-2020,RKI,1,1,0,1588636800000,06432,Darmstadt-Dieburg,314,18,296,297399,452
DE-HE,08-05-2020,RKI,1,1,0,1588896000000,06432,Darmstadt-Dieburg,315,18,297,297399,452
DE-HE,09-05-2020,RKI,3,3,0,1588982400000,06432,Darmstadt-Dieburg,318,18,300,297399,452
DE-HE,10-05-2020,RKI,0,0,0,1589068800000,06432,Darmstadt-Dieburg,318,18,300,297399,452
DE-HE,11-05-2020,RKI,0,0,0,1589155200000,06432,Darmstadt-Dieburg,318,18,300,297399,452
DE-HE,12-05-2020,RKI,2,1,1,1589241600000,06432,Darmstadt-Dieburg,320,19,301,297399,452
DE-HE,13-05-2020,RKI,3,3,0,1589328000000,06432,Darmstadt-Dieburg,323,19,304,297399,452
DE-HE,14-05-2020,RKI,2,2,0,1589414400000,06432,Darmstadt-Dieburg,325,19,306,297399,452
DE-HE,15-05-2020,RKI,1,1,0,1589500800000,06432,Darmstadt-Dieburg,326,19,307,297399,452
DE-HE,16-05-2020,RKI,3,3,0,1589587200000,06432,Darmstadt-Dieburg,329,19,310,297399,452
DE-HE,18-05-2020,RKI,0,0,0,1589760000000,06432,Darmstadt-Dieburg,329,19,310,297399,452
DE-HE,19-05-2020,RKI,6,6,0,1589846400000,06432,Darmstadt-Dieburg,335,19,316,297399,452
DE-HE,20-05-2020,RKI,3,3,0,1589932800000,06432,Darmstadt-Dieburg,338,19,319,297399,452
DE-HE,21-05-2020,RKI,1,1,0,1590019200000,06432,Darmstadt-Dieburg,339,19,320,297399,452
DE-HE,22-05-2020,RKI,1,1,0,1590105600000,06432,Darmstadt-Dieburg,340,19,321,297399,452
DE-HE,25-05-2020,RKI,3,3,0,1590364800000,06432,Darmstadt-Dieburg,343,19,324,297399,452
DE-HE,27-05-2020,RKI,0,0,0,1590537600000,06432,Darmstadt-Dieburg,343,19,324,297399,452
DE-HE,28-05-2020,RKI,1,1,0,1590624000000,06432,Darmstadt-Dieburg,344,19,325,297399,452
DE-HE,29-05-2020,RKI,1,1,0,1590710400000,06432,Darmstadt-Dieburg,345,19,326,297399,452
DE-HE,30-05-2020,RKI,1,1,0,1590796800000,06432,Darmstadt-Dieburg,346,19,327,297399,452
DE-HE,02-06-2020,RKI,2,2,0,1591056000000,06432,Darmstadt-Dieburg,348,19,329,297399,452
DE-HE,05-06-2020,RKI,2,2,0,1591315200000,06432,Darmstadt-Dieburg,350,19,331,297399,452
DE-HE,11-06-2020,RKI,0,0,0,1591833600000,06432,Darmstadt-Dieburg,350,19,331,297399,452
DE-HE,15-06-2020,RKI,0,0,0,1592179200000,06432,Darmstadt-Dieburg,350,19,331,297399,452
DE-HE,20-06-2020,RKI,0,0,0,1592611200000,06432,Darmstadt-Dieburg,350,19,331,297399,452
DE-HE,22-06-2020,RKI,0,0,0,1592784000000,06432,Darmstadt-Dieburg,350,19,331,297399,452
DE-HE,25-06-2020,RKI,2,2,0,1593043200000,06432,Darmstadt-Dieburg,352,19,333,297399,452
DE-HE,29-06-2020,RKI,0,0,0,1593388800000,06432,Darmstadt-Dieburg,352,19,333,297399,452
DE-HE,02-07-2020,RKI,0,0,0,1593648000000,06432,Darmstadt-Dieburg,352,19,333,297399,452
DE-HE,06-07-2020,RKI,1,1,0,1593993600000,06432,Darmstadt-Dieburg,353,19,334,297399,452
DE-HE,08-07-2020,RKI,0,0,0,1594166400000,06432,Darmstadt-Dieburg,353,19,334,297399,452
DE-HE,10-07-2020,RKI,0,0,0,1594339200000,06432,Darmstadt-Dieburg,353,19,334,297399,452
DE-HE,14-07-2020,RKI,1,0,0,1594684800000,06432,Darmstadt-Dieburg,354,19,334,297399,452
DE-HE,11-03-2020,RKI,0,0,0,1583884800000,06433,Groß-Gerau,0,0,0,274526,606
DE-HE,12-03-2020,RKI,0,0,0,1583971200000,06433,Groß-Gerau,0,0,0,274526,606
DE-HE,13-03-2020,RKI,0,0,0,1584057600000,06433,Groß-Gerau,0,0,0,274526,606
DE-HE,16-03-2020,RKI,6,6,0,1584316800000,06433,Groß-Gerau,6,0,6,274526,606
DE-HE,17-03-2020,RKI,0,0,0,1584403200000,06433,Groß-Gerau,6,0,6,274526,606
DE-HE,18-03-2020,RKI,8,8,0,1584489600000,06433,Groß-Gerau,14,0,14,274526,606
DE-HE,19-03-2020,RKI,10,10,0,1584576000000,06433,Groß-Gerau,24,0,24,274526,606
DE-HE,20-03-2020,RKI,23,23,0,1584662400000,06433,Groß-Gerau,47,0,47,274526,606
DE-HE,21-03-2020,RKI,14,14,0,1584748800000,06433,Groß-Gerau,61,0,61,274526,606
DE-HE,22-03-2020,RKI,11,11,0,1584835200000,06433,Groß-Gerau,72,0,72,274526,606
DE-HE,23-03-2020,RKI,15,14,1,1584921600000,06433,Groß-Gerau,87,1,86,274526,606
DE-HE,24-03-2020,RKI,17,17,0,1585008000000,06433,Groß-Gerau,104,1,103,274526,606
DE-HE,25-03-2020,RKI,4,4,0,1585094400000,06433,Groß-Gerau,108,1,107,274526,606
DE-HE,26-03-2020,RKI,13,13,0,1585180800000,06433,Groß-Gerau,121,1,120,274526,606
DE-HE,27-03-2020,RKI,12,11,1,1585267200000,06433,Groß-Gerau,133,2,131,274526,606
DE-HE,28-03-2020,RKI,18,18,0,1585353600000,06433,Groß-Gerau,151,2,149,274526,606
DE-HE,29-03-2020,RKI,14,14,0,1585440000000,06433,Groß-Gerau,165,2,163,274526,606
DE-HE,30-03-2020,RKI,5,5,0,1585526400000,06433,Groß-Gerau,170,2,168,274526,606
DE-HE,31-03-2020,RKI,4,3,1,1585612800000,06433,Groß-Gerau,174,3,171,274526,606
DE-HE,01-04-2020,RKI,18,17,1,1585699200000,06433,Groß-Gerau,192,4,188,274526,606
DE-HE,02-04-2020,RKI,8,8,0,1585785600000,06433,Groß-Gerau,200,4,196,274526,606
DE-HE,03-04-2020,RKI,10,9,1,1585872000000,06433,Groß-Gerau,210,5,205,274526,606
DE-HE,04-04-2020,RKI,7,6,1,1585958400000,06433,Groß-Gerau,217,6,211,274526,606
DE-HE,06-04-2020,RKI,5,5,0,1586131200000,06433,Groß-Gerau,222,6,216,274526,606
DE-HE,07-04-2020,RKI,7,7,0,1586217600000,06433,Groß-Gerau,229,6,223,274526,606
DE-HE,08-04-2020,RKI,9,9,0,1586304000000,06433,Groß-Gerau,238,6,232,274526,606
DE-HE,09-04-2020,RKI,10,10,0,1586390400000,06433,Groß-Gerau,248,6,242,274526,606
DE-HE,10-04-2020,RKI,16,15,1,1586476800000,06433,Groß-Gerau,264,7,257,274526,606
DE-HE,11-04-2020,RKI,0,0,0,1586563200000,06433,Groß-Gerau,264,7,257,274526,606
DE-HE,12-04-2020,RKI,3,3,0,1586649600000,06433,Groß-Gerau,267,7,260,274526,606
DE-HE,15-04-2020,RKI,12,12,0,1586908800000,06433,Groß-Gerau,279,7,272,274526,606
DE-HE,16-04-2020,RKI,12,11,1,1586995200000,06433,Groß-Gerau,291,8,283,274526,606
DE-HE,17-04-2020,RKI,13,13,0,1587081600000,06433,Groß-Gerau,304,8,296,274526,606
DE-HE,18-04-2020,RKI,3,3,0,1587168000000,06433,Groß-Gerau,307,8,299,274526,606
DE-HE,19-04-2020,RKI,0,0,0,1587254400000,06433,Groß-Gerau,307,8,299,274526,606
DE-HE,20-04-2020,RKI,3,3,0,1587340800000,06433,Groß-Gerau,310,8,302,274526,606
DE-HE,21-04-2020,RKI,11,11,0,1587427200000,06433,Groß-Gerau,321,8,313,274526,606
DE-HE,22-04-2020,RKI,4,3,1,1587513600000,06433,Groß-Gerau,325,9,316,274526,606
DE-HE,23-04-2020,RKI,10,8,2,1587600000000,06433,Groß-Gerau,335,11,324,274526,606
DE-HE,24-04-2020,RKI,6,6,0,1587686400000,06433,Groß-Gerau,341,11,330,274526,606
DE-HE,26-04-2020,RKI,3,2,1,1587859200000,06433,Groß-Gerau,344,12,332,274526,606
DE-HE,27-04-2020,RKI,1,1,0,1587945600000,06433,Groß-Gerau,345,12,333,274526,606
DE-HE,28-04-2020,RKI,8,8,0,1588032000000,06433,Groß-Gerau,353,12,341,274526,606
DE-HE,29-04-2020,RKI,8,8,0,1588118400000,06433,Groß-Gerau,361,12,349,274526,606
DE-HE,30-04-2020,RKI,6,6,0,1588204800000,06433,Groß-Gerau,367,12,355,274526,606
DE-HE,01-05-2020,RKI,3,3,0,1588291200000,06433,Groß-Gerau,370,12,358,274526,606
DE-HE,02-05-2020,RKI,1,1,0,1588377600000,06433,Groß-Gerau,371,12,359,274526,606
DE-HE,04-05-2020,RKI,0,0,0,1588550400000,06433,Groß-Gerau,371,12,359,274526,606
DE-HE,05-05-2020,RKI,8,8,0,1588636800000,06433,Groß-Gerau,379,12,367,274526,606
DE-HE,06-05-2020,RKI,4,3,1,1588723200000,06433,Groß-Gerau,383,13,370,274526,606
DE-HE,07-05-2020,RKI,6,5,1,1588809600000,06433,Groß-Gerau,389,14,375,274526,606
DE-HE,08-05-2020,RKI,10,10,0,1588896000000,06433,Groß-Gerau,399,14,385,274526,606
DE-HE,09-05-2020,RKI,1,1,0,1588982400000,06433,Groß-Gerau,400,14,386,274526,606
DE-HE,10-05-2020,RKI,0,0,0,1589068800000,06433,Groß-Gerau,400,14,386,274526,606
DE-HE,12-05-2020,RKI,13,13,0,1589241600000,06433,Groß-Gerau,413,14,399,274526,606
DE-HE,13-05-2020,RKI,1,1,0,1589328000000,06433,Groß-Gerau,414,14,400,274526,606
DE-HE,14-05-2020,RKI,0,0,0,1589414400000,06433,Groß-Gerau,414,14,400,274526,606
DE-HE,15-05-2020,RKI,2,2,0,1589500800000,06433,Groß-Gerau,416,14,402,274526,606
DE-HE,16-05-2020,RKI,3,3,0,1589587200000,06433,Groß-Gerau,419,14,405,274526,606
DE-HE,18-05-2020,RKI,2,2,0,1589760000000,06433,Groß-Gerau,421,14,407,274526,606
DE-HE,19-05-2020,RKI,2,2,0,1589846400000,06433,Groß-Gerau,423,14,409,274526,606
DE-HE,20-05-2020,RKI,2,2,0,1589932800000,06433,Groß-Gerau,425,14,411,274526,606
DE-HE,22-05-2020,RKI,0,0,0,1590105600000,06433,Groß-Gerau,425,14,411,274526,606
DE-HE,23-05-2020,RKI,3,3,0,1590192000000,06433,Groß-Gerau,428,14,414,274526,606
DE-HE,24-05-2020,RKI,1,1,0,1590278400000,06433,Groß-Gerau,429,14,415,274526,606
DE-HE,25-05-2020,RKI,0,0,0,1590364800000,06433,Groß-Gerau,429,14,415,274526,606
DE-HE,26-05-2020,RKI,3,3,0,1590451200000,06433,Groß-Gerau,432,14,418,274526,606
DE-HE,27-05-2020,RKI,4,4,0,1590537600000,06433,Groß-Gerau,436,14,422,274526,606
DE-HE,28-05-2020,RKI,0,0,0,1590624000000,06433,Groß-Gerau,436,14,422,274526,606
DE-HE,29-05-2020,RKI,0,0,0,1590710400000,06433,Groß-Gerau,436,14,422,274526,606
DE-HE,02-06-2020,RKI,0,0,0,1591056000000,06433,Groß-Gerau,436,14,422,274526,606
DE-HE,03-06-2020,RKI,1,1,0,1591142400000,06433,Groß-Gerau,437,14,423,274526,606
DE-HE,05-06-2020,RKI,1,1,0,1591315200000,06433,Groß-Gerau,438,14,424,274526,606
DE-HE,08-06-2020,RKI,0,0,0,1591574400000,06433,Groß-Gerau,438,14,424,274526,606
DE-HE,10-06-2020,RKI,0,0,0,1591747200000,06433,Groß-Gerau,438,14,424,274526,606
DE-HE,12-06-2020,RKI,0,0,0,1591920000000,06433,Groß-Gerau,438,14,424,274526,606
DE-HE,15-06-2020,RKI,0,0,0,1592179200000,06433,Groß-Gerau,438,14,424,274526,606
DE-HE,16-06-2020,RKI,2,2,0,1592265600000,06433,Groß-Gerau,440,14,426,274526,606
DE-HE,17-06-2020,RKI,2,2,0,1592352000000,06433,Groß-Gerau,442,14,428,274526,606
DE-HE,18-06-2020,RKI,0,0,0,1592438400000,06433,Groß-Gerau,442,14,428,274526,606
DE-HE,19-06-2020,RKI,3,3,0,1592524800000,06433,Groß-Gerau,445,14,431,274526,606
DE-HE,22-06-2020,RKI,2,2,0,1592784000000,06433,Groß-Gerau,447,14,433,274526,606
DE-HE,30-06-2020,RKI,0,0,0,1593475200000,06433,Groß-Gerau,447,14,433,274526,606
DE-HE,01-07-2020,RKI,2,0,0,1593561600000,06433,Groß-Gerau,449,14,433,274526,606
DE-HE,03-07-2020,RKI,1,1,0,1593734400000,06433,Groß-Gerau,450,14,434,274526,606
DE-HE,06-07-2020,RKI,3,0,0,1593993600000,06433,Groß-Gerau,453,14,434,274526,606
DE-HE,07-07-2020,RKI,0,0,0,1594080000000,06433,Groß-Gerau,453,14,434,274526,606
DE-HE,08-07-2020,RKI,6,0,0,1594166400000,06433,Groß-Gerau,459,14,434,274526,606
DE-HE,09-07-2020,RKI,0,0,0,1594252800000,06433,Groß-Gerau,459,14,434,274526,606
DE-HE,10-07-2020,RKI,7,2,0,1594339200000,06433,Groß-Gerau,466,14,436,274526,606
DE-HE,13-07-2020,RKI,0,0,0,1594598400000,06433,Groß-Gerau,466,14,436,274526,606
DE-HE,14-07-2020,RKI,0,0,0,1594684800000,06433,Groß-Gerau,466,14,436,274526,606
DE-HE,15-07-2020,RKI,1,0,0,1594771200000,06433,Groß-Gerau,467,14,436,274526,606
DE-HE,16-07-2020,RKI,3,0,0,1594857600000,06433,Groß-Gerau,470,14,436,274526,606
DE-HE,04-03-2020,RKI,0,0,0,1583280000000,06434,Hochtaunuskreis,0,0,0,236564,491
DE-HE,09-03-2020,RKI,0,0,0,1583712000000,06434,Hochtaunuskreis,0,0,0,236564,491
DE-HE,12-03-2020,RKI,0,0,0,1583971200000,06434,Hochtaunuskreis,0,0,0,236564,491
DE-HE,13-03-2020,RKI,1,1,0,1584057600000,06434,Hochtaunuskreis,1,0,1,236564,491
DE-HE,14-03-2020,RKI,2,2,0,1584144000000,06434,Hochtaunuskreis,3,0,3,236564,491
DE-HE,15-03-2020,RKI,1,1,0,1584230400000,06434,Hochtaunuskreis,4,0,4,236564,491
DE-HE,16-03-2020,RKI,8,8,0,1584316800000,06434,Hochtaunuskreis,12,0,12,236564,491
DE-HE,17-03-2020,RKI,3,3,0,1584403200000,06434,Hochtaunuskreis,15,0,15,236564,491
DE-HE,18-03-2020,RKI,8,8,0,1584489600000,06434,Hochtaunuskreis,23,0,23,236564,491
DE-HE,19-03-2020,RKI,13,13,0,1584576000000,06434,Hochtaunuskreis,36,0,36,236564,491
DE-HE,20-03-2020,RKI,8,8,0,1584662400000,06434,Hochtaunuskreis,44,0,44,236564,491
DE-HE,21-03-2020,RKI,7,7,0,1584748800000,06434,Hochtaunuskreis,51,0,51,236564,491
DE-HE,22-03-2020,RKI,1,1,0,1584835200000,06434,Hochtaunuskreis,52,0,52,236564,491
DE-HE,23-03-2020,RKI,1,1,0,1584921600000,06434,Hochtaunuskreis,53,0,53,236564,491
DE-HE,24-03-2020,RKI,15,14,1,1585008000000,06434,Hochtaunuskreis,68,1,67,236564,491
DE-HE,25-03-2020,RKI,20,19,1,1585094400000,06434,Hochtaunuskreis,88,2,86,236564,491
DE-HE,26-03-2020,RKI,4,3,1,1585180800000,06434,Hochtaunuskreis,92,3,89,236564,491
DE-HE,27-03-2020,RKI,12,12,0,1585267200000,06434,Hochtaunuskreis,104,3,101,236564,491
DE-HE,28-03-2020,RKI,3,3,0,1585353600000,06434,Hochtaunuskreis,107,3,104,236564,491
DE-HE,29-03-2020,RKI,3,3,0,1585440000000,06434,Hochtaunuskreis,110,3,107,236564,491
DE-HE,30-03-2020,RKI,4,4,0,1585526400000,06434,Hochtaunuskreis,114,3,111,236564,491
DE-HE,31-03-2020,RKI,13,13,0,1585612800000,06434,Hochtaunuskreis,127,3,124,236564,491
DE-HE,01-04-2020,RKI,6,5,1,1585699200000,06434,Hochtaunuskreis,133,4,129,236564,491
DE-HE,02-04-2020,RKI,4,4,0,1585785600000,06434,Hochtaunuskreis,137,4,133,236564,491
DE-HE,03-04-2020,RKI,9,9,0,1585872000000,06434,Hochtaunuskreis,146,4,142,236564,491
DE-HE,04-04-2020,RKI,4,4,0,1585958400000,06434,Hochtaunuskreis,150,4,146,236564,491
DE-HE,05-04-2020,RKI,0,0,0,1586044800000,06434,Hochtaunuskreis,150,4,146,236564,491
DE-HE,06-04-2020,RKI,2,2,0,1586131200000,06434,Hochtaunuskreis,152,4,148,236564,491
DE-HE,07-04-2020,RKI,6,6,0,1586217600000,06434,Hochtaunuskreis,158,4,154,236564,491
DE-HE,08-04-2020,RKI,11,11,0,1586304000000,06434,Hochtaunuskreis,169,4,165,236564,491
DE-HE,09-04-2020,RKI,1,1,0,1586390400000,06434,Hochtaunuskreis,170,4,166,236564,491
DE-HE,10-04-2020,RKI,3,3,0,1586476800000,06434,Hochtaunuskreis,173,4,169,236564,491
DE-HE,13-04-2020,RKI,0,0,0,1586736000000,06434,Hochtaunuskreis,173,4,169,236564,491
DE-HE,14-04-2020,RKI,0,0,0,1586822400000,06434,Hochtaunuskreis,173,4,169,236564,491
DE-HE,15-04-2020,RKI,2,2,0,1586908800000,06434,Hochtaunuskreis,175,4,171,236564,491
DE-HE,16-04-2020,RKI,1,1,0,1586995200000,06434,Hochtaunuskreis,176,4,172,236564,491
DE-HE,17-04-2020,RKI,1,1,0,1587081600000,06434,Hochtaunuskreis,177,4,173,236564,491
DE-HE,18-04-2020,RKI,1,0,1,1587168000000,06434,Hochtaunuskreis,178,5,173,236564,491
DE-HE,20-04-2020,RKI,0,0,0,1587340800000,06434,Hochtaunuskreis,178,5,173,236564,491
DE-HE,21-04-2020,RKI,2,2,0,1587427200000,06434,Hochtaunuskreis,180,5,175,236564,491
DE-HE,22-04-2020,RKI,2,2,0,1587513600000,06434,Hochtaunuskreis,182,5,177,236564,491
DE-HE,23-04-2020,RKI,1,1,0,1587600000000,06434,Hochtaunuskreis,183,5,178,236564,491
DE-HE,26-04-2020,RKI,0,0,0,1587859200000,06434,Hochtaunuskreis,183,5,178,236564,491
DE-HE,27-04-2020,RKI,0,0,0,1587945600000,06434,Hochtaunuskreis,183,5,178,236564,491
DE-HE,29-04-2020,RKI,4,4,0,1588118400000,06434,Hochtaunuskreis,187,5,182,236564,491
DE-HE,30-04-2020,RKI,2,2,0,1588204800000,06434,Hochtaunuskreis,189,5,184,236564,491
DE-HE,01-05-2020,RKI,0,0,0,1588291200000,06434,Hochtaunuskreis,189,5,184,236564,491
DE-HE,02-05-2020,RKI,0,0,0,1588377600000,06434,Hochtaunuskreis,189,5,184,236564,491
DE-HE,04-05-2020,RKI,1,1,0,1588550400000,06434,Hochtaunuskreis,190,5,185,236564,491
DE-HE,09-05-2020,RKI,1,1,0,1588982400000,06434,Hochtaunuskreis,191,5,186,236564,491
DE-HE,10-05-2020,RKI,1,1,0,1589068800000,06434,Hochtaunuskreis,192,5,187,236564,491
DE-HE,15-05-2020,RKI,1,1,0,1589500800000,06434,Hochtaunuskreis,193,5,188,236564,491
DE-HE,17-05-2020,RKI,0,0,0,1589673600000,06434,Hochtaunuskreis,193,5,188,236564,491
DE-HE,18-05-2020,RKI,0,0,0,1589760000000,06434,Hochtaunuskreis,193,5,188,236564,491
DE-HE,19-05-2020,RKI,0,0,0,1589846400000,06434,Hochtaunuskreis,193,5,188,236564,491
DE-HE,20-05-2020,RKI,4,4,0,1589932800000,06434,Hochtaunuskreis,197,5,192,236564,491
DE-HE,22-05-2020,RKI,3,3,0,1590105600000,06434,Hochtaunuskreis,200,5,195,236564,491
DE-HE,23-05-2020,RKI,0,0,0,1590192000000,06434,Hochtaunuskreis,200,5,195,236564,491
DE-HE,25-05-2020,RKI,0,0,0,1590364800000,06434,Hochtaunuskreis,200,5,195,236564,491
DE-HE,26-05-2020,RKI,7,7,0,1590451200000,06434,Hochtaunuskreis,207,5,202,236564,491
DE-HE,27-05-2020,RKI,0,0,0,1590537600000,06434,Hochtaunuskreis,207,5,202,236564,491
DE-HE,28-05-2020,RKI,2,2,0,1590624000000,06434,Hochtaunuskreis,209,5,204,236564,491
DE-HE,29-05-2020,RKI,3,3,0,1590710400000,06434,Hochtaunuskreis,212,5,207,236564,491
DE-HE,02-06-2020,RKI,1,1,0,1591056000000,06434,Hochtaunuskreis,213,5,208,236564,491
DE-HE,03-06-2020,RKI,0,0,0,1591142400000,06434,Hochtaunuskreis,213,5,208,236564,491
DE-HE,04-06-2020,RKI,0,0,0,1591228800000,06434,Hochtaunuskreis,213,5,208,236564,491
DE-HE,08-06-2020,RKI,0,0,0,1591574400000,06434,Hochtaunuskreis,213,5,208,236564,491
DE-HE,17-06-2020,RKI,0,0,0,1592352000000,06434,Hochtaunuskreis,213,5,208,236564,491
DE-HE,24-06-2020,RKI,0,0,0,1592956800000,06434,Hochtaunuskreis,213,5,208,236564,491
DE-HE,29-06-2020,RKI,1,1,0,1593388800000,06434,Hochtaunuskreis,214,5,209,236564,491
DE-HE,02-07-2020,RKI,0,0,0,1593648000000,06434,Hochtaunuskreis,214,5,209,236564,491
DE-HE,07-07-2020,RKI,2,2,0,1594080000000,06434,Hochtaunuskreis,216,5,211,236564,491
DE-HE,14-07-2020,RKI,0,0,0,1594684800000,06434,Hochtaunuskreis,216,5,211,236564,491
DE-HE,09-03-2020,RKI,0,0,0,1583712000000,06435,Main-Kinzig-Kreis,0,0,0,418950,300
DE-HE,10-03-2020,RKI,0,0,0,1583798400000,06435,Main-Kinzig-Kreis,0,0,0,418950,300
DE-HE,11-03-2020,RKI,5,5,0,1583884800000,06435,Main-Kinzig-Kreis,5,0,5,418950,300
DE-HE,12-03-2020,RKI,7,7,0,1583971200000,06435,Main-Kinzig-Kreis,12,0,12,418950,300
DE-HE,13-03-2020,RKI,9,9,0,1584057600000,06435,Main-Kinzig-Kreis,21,0,21,418950,300
DE-HE,14-03-2020,RKI,9,9,0,1584144000000,06435,Main-Kinzig-Kreis,30,0,30,418950,300
DE-HE,16-03-2020,RKI,2,2,0,1584316800000,06435,Main-Kinzig-Kreis,32,0,32,418950,300
DE-HE,17-03-2020,RKI,13,13,0,1584403200000,06435,Main-Kinzig-Kreis,45,0,45,418950,300
DE-HE,18-03-2020,RKI,12,12,0,1584489600000,06435,Main-Kinzig-Kreis,57,0,57,418950,300
DE-HE,19-03-2020,RKI,3,3,0,1584576000000,06435,Main-Kinzig-Kreis,60,0,60,418950,300
DE-HE,20-03-2020,RKI,6,6,0,1584662400000,06435,Main-Kinzig-Kreis,66,0,66,418950,300
DE-HE,21-03-2020,RKI,2,2,0,1584748800000,06435,Main-Kinzig-Kreis,68,0,68,418950,300
DE-HE,22-03-2020,RKI,1,1,0,1584835200000,06435,Main-Kinzig-Kreis,69,0,69,418950,300
DE-HE,23-03-2020,RKI,8,7,1,1584921600000,06435,Main-Kinzig-Kreis,77,1,76,418950,300
DE-HE,24-03-2020,RKI,5,5,0,1585008000000,06435,Main-Kinzig-Kreis,82,1,81,418950,300
DE-HE,25-03-2020,RKI,14,13,1,1585094400000,06435,Main-Kinzig-Kreis,96,2,94,418950,300
DE-HE,26-03-2020,RKI,18,18,0,1585180800000,06435,Main-Kinzig-Kreis,114,2,112,418950,300
DE-HE,27-03-2020,RKI,15,15,0,1585267200000,06435,Main-Kinzig-Kreis,129,2,127,418950,300
DE-HE,28-03-2020,RKI,15,15,0,1585353600000,06435,Main-Kinzig-Kreis,144,2,142,418950,300
DE-HE,29-03-2020,RKI,3,1,2,1585440000000,06435,Main-Kinzig-Kreis,147,4,143,418950,300
DE-HE,30-03-2020,RKI,16,12,4,1585526400000,06435,Main-Kinzig-Kreis,163,8,155,418950,300
DE-HE,31-03-2020,RKI,16,15,1,1585612800000,06435,Main-Kinzig-Kreis,179,9,170,418950,300
DE-HE,01-04-2020,RKI,21,20,1,1585699200000,06435,Main-Kinzig-Kreis,200,10,190,418950,300
DE-HE,02-04-2020,RKI,13,13,0,1585785600000,06435,Main-Kinzig-Kreis,213,10,203,418950,300
DE-HE,03-04-2020,RKI,21,20,1,1585872000000,06435,Main-Kinzig-Kreis,234,11,223,418950,300
DE-HE,04-04-2020,RKI,13,13,0,1585958400000,06435,Main-Kinzig-Kreis,247,11,236,418950,300
DE-HE,05-04-2020,RKI,0,0,0,1586044800000,06435,Main-Kinzig-Kreis,247,11,236,418950,300
DE-HE,06-04-2020,RKI,12,9,3,1586131200000,06435,Main-Kinzig-Kreis,259,14,245,418950,300
DE-HE,07-04-2020,RKI,22,19,3,1586217600000,06435,Main-Kinzig-Kreis,281,17,264,418950,300
DE-HE,08-04-2020,RKI,18,18,0,1586304000000,06435,Main-Kinzig-Kreis,299,17,282,418950,300
DE-HE,09-04-2020,RKI,12,11,1,1586390400000,06435,Main-Kinzig-Kreis,311,18,293,418950,300
DE-HE,10-04-2020,RKI,9,8,1,1586476800000,06435,Main-Kinzig-Kreis,320,19,301,418950,300
DE-HE,11-04-2020,RKI,21,17,4,1586563200000,06435,Main-Kinzig-Kreis,341,23,318,418950,300
DE-HE,12-04-2020,RKI,4,4,0,1586649600000,06435,Main-Kinzig-Kreis,345,23,322,418950,300
DE-HE,13-04-2020,RKI,3,2,1,1586736000000,06435,Main-Kinzig-Kreis,348,24,324,418950,300
DE-HE,14-04-2020,RKI,11,9,2,1586822400000,06435,Main-Kinzig-Kreis,359,26,333,418950,300
DE-HE,15-04-2020,RKI,24,23,1,1586908800000,06435,Main-Kinzig-Kreis,383,27,356,418950,300
DE-HE,16-04-2020,RKI,21,18,3,1586995200000,06435,Main-Kinzig-Kreis,404,30,374,418950,300
DE-HE,17-04-2020,RKI,22,18,4,1587081600000,06435,Main-Kinzig-Kreis,426,34,392,418950,300
DE-HE,18-04-2020,RKI,22,17,5,1587168000000,06435,Main-Kinzig-Kreis,448,39,409,418950,300
DE-HE,19-04-2020,RKI,1,0,1,1587254400000,06435,Main-Kinzig-Kreis,449,40,409,418950,300
DE-HE,20-04-2020,RKI,10,10,0,1587340800000,06435,Main-Kinzig-Kreis,459,40,419,418950,300
DE-HE,21-04-2020,RKI,26,24,2,1587427200000,06435,Main-Kinzig-Kreis,485,42,443,418950,300
DE-HE,22-04-2020,RKI,17,17,0,1587513600000,06435,Main-Kinzig-Kreis,502,42,460,418950,300
DE-HE,23-04-2020,RKI,1,1,0,1587600000000,06435,Main-Kinzig-Kreis,503,42,461,418950,300
DE-HE,24-04-2020,RKI,9,9,0,1587686400000,06435,Main-Kinzig-Kreis,512,42,470,418950,300
DE-HE,25-04-2020,RKI,10,9,1,1587772800000,06435,Main-Kinzig-Kreis,522,43,479,418950,300
DE-HE,26-04-2020,RKI,4,4,0,1587859200000,06435,Main-Kinzig-Kreis,526,43,483,418950,300
DE-HE,27-04-2020,RKI,2,2,0,1587945600000,06435,Main-Kinzig-Kreis,528,43,485,418950,300
DE-HE,28-04-2020,RKI,15,13,2,1588032000000,06435,Main-Kinzig-Kreis,543,45,498,418950,300
DE-HE,29-04-2020,RKI,8,8,0,1588118400000,06435,Main-Kinzig-Kreis,551,45,506,418950,300
DE-HE,30-04-2020,RKI,8,7,1,1588204800000,06435,Main-Kinzig-Kreis,559,46,513,418950,300
DE-HE,01-05-2020,RKI,13,13,0,1588291200000,06435,Main-Kinzig-Kreis,572,46,526,418950,300
DE-HE,02-05-2020,RKI,0,0,0,1588377600000,06435,Main-Kinzig-Kreis,572,46,526,418950,300
DE-HE,03-05-2020,RKI,1,1,0,1588464000000,06435,Main-Kinzig-Kreis,573,46,527,418950,300
DE-HE,04-05-2020,RKI,1,1,0,1588550400000,06435,Main-Kinzig-Kreis,574,46,528,418950,300
DE-HE,05-05-2020,RKI,1,1,0,1588636800000,06435,Main-Kinzig-Kreis,575,46,529,418950,300
DE-HE,06-05-2020,RKI,5,4,1,1588723200000,06435,Main-Kinzig-Kreis,580,47,533,418950,300
DE-HE,07-05-2020,RKI,3,3,0,1588809600000,06435,Main-Kinzig-Kreis,583,47,536,418950,300
DE-HE,08-05-2020,RKI,10,9,1,1588896000000,06435,Main-Kinzig-Kreis,593,48,545,418950,300
DE-HE,09-05-2020,RKI,4,4,0,1588982400000,06435,Main-Kinzig-Kreis,597,48,549,418950,300
DE-HE,11-05-2020,RKI,2,2,0,1589155200000,06435,Main-Kinzig-Kreis,599,48,551,418950,300
DE-HE,12-05-2020,RKI,5,4,1,1589241600000,06435,Main-Kinzig-Kreis,604,49,555,418950,300
DE-HE,13-05-2020,RKI,6,6,0,1589328000000,06435,Main-Kinzig-Kreis,610,49,561,418950,300
DE-HE,14-05-2020,RKI,3,3,0,1589414400000,06435,Main-Kinzig-Kreis,613,49,564,418950,300
DE-HE,15-05-2020,RKI,3,3,0,1589500800000,06435,Main-Kinzig-Kreis,616,49,567,418950,300
DE-HE,16-05-2020,RKI,0,0,0,1589587200000,06435,Main-Kinzig-Kreis,616,49,567,418950,300
DE-HE,17-05-2020,RKI,3,3,0,1589673600000,06435,Main-Kinzig-Kreis,619,49,570,418950,300
DE-HE,18-05-2020,RKI,5,5,0,1589760000000,06435,Main-Kinzig-Kreis,624,49,575,418950,300
DE-HE,20-05-2020,RKI,8,8,0,1589932800000,06435,Main-Kinzig-Kreis,632,49,583,418950,300
DE-HE,21-05-2020,RKI,3,3,0,1590019200000,06435,Main-Kinzig-Kreis,635,49,586,418950,300
DE-HE,22-05-2020,RKI,7,7,0,1590105600000,06435,Main-Kinzig-Kreis,642,49,593,418950,300
DE-HE,23-05-2020,RKI,4,4,0,1590192000000,06435,Main-Kinzig-Kreis,646,49,597,418950,300
DE-HE,26-05-2020,RKI,14,14,0,1590451200000,06435,Main-Kinzig-Kreis,660,49,611,418950,300
DE-HE,28-05-2020,RKI,4,4,0,1590624000000,06435,Main-Kinzig-Kreis,664,49,615,418950,300
DE-HE,29-05-2020,RKI,6,6,0,1590710400000,06435,Main-Kinzig-Kreis,670,49,621,418950,300
DE-HE,30-05-2020,RKI,0,0,0,1590796800000,06435,Main-Kinzig-Kreis,670,49,621,418950,300
DE-HE,03-06-2020,RKI,0,0,0,1591142400000,06435,Main-Kinzig-Kreis,670,49,621,418950,300
DE-HE,04-06-2020,RKI,0,0,0,1591228800000,06435,Main-Kinzig-Kreis,670,49,621,418950,300
DE-HE,06-06-2020,RKI,0,0,0,1591401600000,06435,Main-Kinzig-Kreis,670,49,621,418950,300
DE-HE,07-06-2020,RKI,0,0,0,1591488000000,06435,Main-Kinzig-Kreis,670,49,621,418950,300
DE-HE,09-06-2020,RKI,0,0,0,1591660800000,06435,Main-Kinzig-Kreis,670,49,621,418950,300
DE-HE,11-06-2020,RKI,0,0,0,1591833600000,06435,Main-Kinzig-Kreis,670,49,621,418950,300
DE-HE,13-06-2020,RKI,0,0,0,1592006400000,06435,Main-Kinzig-Kreis,670,49,621,418950,300
DE-HE,19-06-2020,RKI,2,2,0,1592524800000,06435,Main-Kinzig-Kreis,672,49,623,418950,300
DE-HE,23-06-2020,RKI,7,7,0,1592870400000,06435,Main-Kinzig-Kreis,679,49,630,418950,300
DE-HE,24-06-2020,RKI,0,0,0,1592956800000,06435,Main-Kinzig-Kreis,679,49,630,418950,300
DE-HE,25-06-2020,RKI,1,1,0,1593043200000,06435,Main-Kinzig-Kreis,680,49,631,418950,300
DE-HE,26-06-2020,RKI,2,1,0,1593129600000,06435,Main-Kinzig-Kreis,682,49,632,418950,300
DE-HE,27-06-2020,RKI,4,3,0,1593216000000,06435,Main-Kinzig-Kreis,686,49,635,418950,300
DE-HE,30-06-2020,RKI,3,3,0,1593475200000,06435,Main-Kinzig-Kreis,689,49,638,418950,300
DE-HE,01-07-2020,RKI,7,5,0,1593561600000,06435,Main-Kinzig-Kreis,696,49,643,418950,300
DE-HE,02-07-2020,RKI,3,3,0,1593648000000,06435,Main-Kinzig-Kreis,699,49,646,418950,300
DE-HE,03-07-2020,RKI,3,2,1,1593734400000,06435,Main-Kinzig-Kreis,702,50,648,418950,300
DE-HE,04-07-2020,RKI,0,0,0,1593820800000,06435,Main-Kinzig-Kreis,702,50,648,418950,300
DE-HE,06-07-2020,RKI,0,0,0,1593993600000,06435,Main-Kinzig-Kreis,702,50,648,418950,300
DE-HE,07-07-2020,RKI,0,0,0,1594080000000,06435,Main-Kinzig-Kreis,702,50,648,418950,300
DE-HE,08-07-2020,RKI,3,2,0,1594166400000,06435,Main-Kinzig-Kreis,705,50,650,418950,300
DE-HE,09-07-2020,RKI,1,0,0,1594252800000,06435,Main-Kinzig-Kreis,706,50,650,418950,300
DE-HE,10-07-2020,RKI,0,0,0,1594339200000,06435,Main-Kinzig-Kreis,706,50,650,418950,300
DE-HE,12-07-2020,RKI,0,0,0,1594512000000,06435,Main-Kinzig-Kreis,706,50,650,418950,300
DE-HE,13-07-2020,RKI,0,0,0,1594598400000,06435,Main-Kinzig-Kreis,706,50,650,418950,300
DE-HE,14-07-2020,RKI,0,0,0,1594684800000,06435,Main-Kinzig-Kreis,706,50,650,418950,300
DE-HE,15-07-2020,RKI,4,0,0,1594771200000,06435,Main-Kinzig-Kreis,710,50,650,418950,300
DE-HE,11-03-2020,RKI,0,0,0,1583884800000,06436,Main-Taunus-Kreis,1,0,1,237735,1069
DE-HE,12-03-2020,RKI,0,0,0,1583971200000,06436,Main-Taunus-Kreis,1,0,1,237735,1069
DE-HE,13-03-2020,RKI,6,6,0,1584057600000,06436,Main-Taunus-Kreis,7,0,7,237735,1069
DE-HE,16-03-2020,RKI,4,4,0,1584316800000,06436,Main-Taunus-Kreis,11,0,11,237735,1069
DE-HE,17-03-2020,RKI,1,1,0,1584403200000,06436,Main-Taunus-Kreis,12,0,12,237735,1069
DE-HE,18-03-2020,RKI,8,8,0,1584489600000,06436,Main-Taunus-Kreis,20,0,20,237735,1069
DE-HE,19-03-2020,RKI,11,10,1,1584576000000,06436,Main-Taunus-Kreis,31,1,30,237735,1069
DE-HE,20-03-2020,RKI,13,12,1,1584662400000,06436,Main-Taunus-Kreis,44,2,42,237735,1069
DE-HE,21-03-2020,RKI,0,0,0,1584748800000,06436,Main-Taunus-Kreis,44,2,42,237735,1069
DE-HE,23-03-2020,RKI,11,11,0,1584921600000,06436,Main-Taunus-Kreis,55,2,53,237735,1069
DE-HE,24-03-2020,RKI,15,15,0,1585008000000,06436,Main-Taunus-Kreis,70,2,68,237735,1069
DE-HE,25-03-2020,RKI,4,4,0,1585094400000,06436,Main-Taunus-Kreis,74,2,72,237735,1069
DE-HE,26-03-2020,RKI,9,9,0,1585180800000,06436,Main-Taunus-Kreis,83,2,81,237735,1069
DE-HE,27-03-2020,RKI,12,12,0,1585267200000,06436,Main-Taunus-Kreis,95,2,93,237735,1069
DE-HE,28-03-2020,RKI,5,5,0,1585353600000,06436,Main-Taunus-Kreis,100,2,98,237735,1069
DE-HE,30-03-2020,RKI,13,13,0,1585526400000,06436,Main-Taunus-Kreis,113,2,111,237735,1069
DE-HE,31-03-2020,RKI,6,6,0,1585612800000,06436,Main-Taunus-Kreis,119,2,117,237735,1069
DE-HE,01-04-2020,RKI,5,5,0,1585699200000,06436,Main-Taunus-Kreis,124,2,122,237735,1069
DE-HE,02-04-2020,RKI,5,4,1,1585785600000,06436,Main-Taunus-Kreis,129,3,126,237735,1069
DE-HE,03-04-2020,RKI,5,5,0,1585872000000,06436,Main-Taunus-Kreis,134,3,131,237735,1069
DE-HE,04-04-2020,RKI,5,5,0,1585958400000,06436,Main-Taunus-Kreis,139,3,136,237735,1069
DE-HE,06-04-2020,RKI,2,2,0,1586131200000,06436,Main-Taunus-Kreis,141,3,138,237735,1069
DE-HE,07-04-2020,RKI,2,2,0,1586217600000,06436,Main-Taunus-Kreis,143,3,140,237735,1069
DE-HE,08-04-2020,RKI,4,4,0,1586304000000,06436,Main-Taunus-Kreis,147,3,144,237735,1069
DE-HE,09-04-2020,RKI,6,6,0,1586390400000,06436,Main-Taunus-Kreis,153,3,150,237735,1069
DE-HE,11-04-2020,RKI,5,5,0,1586563200000,06436,Main-Taunus-Kreis,158,3,155,237735,1069
DE-HE,14-04-2020,RKI,3,3,0,1586822400000,06436,Main-Taunus-Kreis,161,3,158,237735,1069
DE-HE,15-04-2020,RKI,5,4,1,1586908800000,06436,Main-Taunus-Kreis,166,4,162,237735,1069
DE-HE,16-04-2020,RKI,4,4,0,1586995200000,06436,Main-Taunus-Kreis,170,4,166,237735,1069
DE-HE,17-04-2020,RKI,0,0,0,1587081600000,06436,Main-Taunus-Kreis,170,4,166,237735,1069
DE-HE,18-04-2020,RKI,5,5,0,1587168000000,06436,Main-Taunus-Kreis,175,4,171,237735,1069
DE-HE,20-04-2020,RKI,0,0,0,1587340800000,06436,Main-Taunus-Kreis,175,4,171,237735,1069
DE-HE,21-04-2020,RKI,7,7,0,1587427200000,06436,Main-Taunus-Kreis,182,4,178,237735,1069
DE-HE,22-04-2020,RKI,11,10,1,1587513600000,06436,Main-Taunus-Kreis,193,5,188,237735,1069
DE-HE,23-04-2020,RKI,6,6,0,1587600000000,06436,Main-Taunus-Kreis,199,5,194,237735,1069
DE-HE,24-04-2020,RKI,2,2,0,1587686400000,06436,Main-Taunus-Kreis,201,5,196,237735,1069
DE-HE,25-04-2020,RKI,2,2,0,1587772800000,06436,Main-Taunus-Kreis,203,5,198,237735,1069
DE-HE,27-04-2020,RKI,7,7,0,1587945600000,06436,Main-Taunus-Kreis,210,5,205,237735,1069
DE-HE,28-04-2020,RKI,4,4,0,1588032000000,06436,Main-Taunus-Kreis,214,5,209,237735,1069
DE-HE,29-04-2020,RKI,0,0,0,1588118400000,06436,Main-Taunus-Kreis,214,5,209,237735,1069
DE-HE,30-04-2020,RKI,1,0,1,1588204800000,06436,Main-Taunus-Kreis,215,6,209,237735,1069
DE-HE,01-05-2020,RKI,0,0,0,1588291200000,06436,Main-Taunus-Kreis,215,6,209,237735,1069
DE-HE,02-05-2020,RKI,4,4,0,1588377600000,06436,Main-Taunus-Kreis,219,6,213,237735,1069
DE-HE,04-05-2020,RKI,0,0,0,1588550400000,06436,Main-Taunus-Kreis,219,6,213,237735,1069
DE-HE,05-05-2020,RKI,0,0,0,1588636800000,06436,Main-Taunus-Kreis,219,6,213,237735,1069
DE-HE,06-05-2020,RKI,0,0,0,1588723200000,06436,Main-Taunus-Kreis,219,6,213,237735,1069
DE-HE,08-05-2020,RKI,2,2,0,1588896000000,06436,Main-Taunus-Kreis,221,6,215,237735,1069
DE-HE,13-05-2020,RKI,2,2,0,1589328000000,06436,Main-Taunus-Kreis,223,6,217,237735,1069
DE-HE,14-05-2020,RKI,1,1,0,1589414400000,06436,Main-Taunus-Kreis,224,6,218,237735,1069
DE-HE,15-05-2020,RKI,0,0,0,1589500800000,06436,Main-Taunus-Kreis,224,6,218,237735,1069
DE-HE,18-05-2020,RKI,6,6,0,1589760000000,06436,Main-Taunus-Kreis,230,6,224,237735,1069
DE-HE,19-05-2020,RKI,4,4,0,1589846400000,06436,Main-Taunus-Kreis,234,6,228,237735,1069
DE-HE,20-05-2020,RKI,11,11,0,1589932800000,06436,Main-Taunus-Kreis,245,6,239,237735,1069
DE-HE,22-05-2020,RKI,4,4,0,1590105600000,06436,Main-Taunus-Kreis,249,6,243,237735,1069
DE-HE,25-05-2020,RKI,7,7,0,1590364800000,06436,Main-Taunus-Kreis,256,6,250,237735,1069
DE-HE,27-05-2020,RKI,1,1,0,1590537600000,06436,Main-Taunus-Kreis,257,6,251,237735,1069
DE-HE,28-05-2020,RKI,4,4,0,1590624000000,06436,Main-Taunus-Kreis,261,6,255,237735,1069
DE-HE,29-05-2020,RKI,0,0,0,1590710400000,06436,Main-Taunus-Kreis,261,6,255,237735,1069
DE-HE,02-06-2020,RKI,2,2,0,1591056000000,06436,Main-Taunus-Kreis,263,6,257,237735,1069
DE-HE,05-06-2020,RKI,1,1,0,1591315200000,06436,Main-Taunus-Kreis,264,6,258,237735,1069
DE-HE,08-06-2020,RKI,0,0,0,1591574400000,06436,Main-Taunus-Kreis,264,6,258,237735,1069
DE-HE,09-06-2020,RKI,1,1,0,1591660800000,06436,Main-Taunus-Kreis,265,6,259,237735,1069
DE-HE,10-06-2020,RKI,0,0,0,1591747200000,06436,Main-Taunus-Kreis,265,6,259,237735,1069
DE-HE,17-06-2020,RKI,3,3,0,1592352000000,06436,Main-Taunus-Kreis,268,6,262,237735,1069
DE-HE,18-06-2020,RKI,0,0,0,1592438400000,06436,Main-Taunus-Kreis,268,6,262,237735,1069
DE-HE,19-06-2020,RKI,1,1,0,1592524800000,06436,Main-Taunus-Kreis,269,6,263,237735,1069
DE-HE,22-06-2020,RKI,2,2,0,1592784000000,06436,Main-Taunus-Kreis,271,6,265,237735,1069
DE-HE,23-06-2020,RKI,1,0,0,1592870400000,06436,Main-Taunus-Kreis,272,6,265,237735,1069
DE-HE,24-06-2020,RKI,3,0,0,1592956800000,06436,Main-Taunus-Kreis,275,6,265,237735,1069
DE-HE,25-06-2020,RKI,0,0,0,1593043200000,06436,Main-Taunus-Kreis,275,6,265,237735,1069
DE-HE,26-06-2020,RKI,0,0,0,1593129600000,06436,Main-Taunus-Kreis,275,6,265,237735,1069
DE-HE,29-06-2020,RKI,1,0,0,1593388800000,06436,Main-Taunus-Kreis,276,6,265,237735,1069
DE-HE,01-07-2020,RKI,1,1,0,1593561600000,06436,Main-Taunus-Kreis,277,6,266,237735,1069
DE-HE,02-07-2020,RKI,0,0,0,1593648000000,06436,Main-Taunus-Kreis,277,6,266,237735,1069
DE-HE,03-07-2020,RKI,0,0,0,1593734400000,06436,Main-Taunus-Kreis,277,6,266,237735,1069
DE-HE,07-07-2020,RKI,1,0,0,1594080000000,06436,Main-Taunus-Kreis,278,6,266,237735,1069
DE-HE,08-07-2020,RKI,3,0,0,1594166400000,06436,Main-Taunus-Kreis,281,6,266,237735,1069
DE-HE,09-07-2020,RKI,0,0,0,1594252800000,06436,Main-Taunus-Kreis,281,6,266,237735,1069
DE-HE,13-07-2020,RKI,0,0,0,1594598400000,06436,Main-Taunus-Kreis,281,6,266,237735,1069
DE-HE,16-07-2020,RKI,0,0,0,1594857600000,06436,Main-Taunus-Kreis,281,6,266,237735,1069
DE-MV,11-03-2020,RKI,0,0,0,1583884800000,13003,Rostock,0,0,0,208886,1152
DE-MV,12-03-2020,RKI,2,2,0,1583971200000,13003,Rostock,2,0,2,208886,1152
DE-MV,13-03-2020,RKI,0,0,0,1584057600000,13003,Rostock,2,0,2,208886,1152
DE-MV,16-03-2020,RKI,1,1,0,1584316800000,13003,Rostock,3,0,3,208886,1152
DE-MV,17-03-2020,RKI,5,5,0,1584403200000,13003,Rostock,8,0,8,208886,1152
DE-MV,18-03-2020,RKI,4,4,0,1584489600000,13003,Rostock,12,0,12,208886,1152
DE-MV,19-03-2020,RKI,1,1,0,1584576000000,13003,Rostock,13,0,13,208886,1152
DE-MV,20-03-2020,RKI,0,0,0,1584662400000,13003,Rostock,13,0,13,208886,1152
DE-MV,23-03-2020,RKI,4,4,0,1584921600000,13003,Rostock,17,0,17,208886,1152
DE-MV,24-03-2020,RKI,4,4,0,1585008000000,13003,Rostock,21,0,21,208886,1152
DE-MV,25-03-2020,RKI,4,4,0,1585094400000,13003,Rostock,25,0,25,208886,1152
DE-MV,26-03-2020,RKI,6,6,0,1585180800000,13003,Rostock,31,0,31,208886,1152
DE-MV,27-03-2020,RKI,3,3,0,1585267200000,13003,Rostock,34,0,34,208886,1152
DE-MV,28-03-2020,RKI,2,2,0,1585353600000,13003,Rostock,36,0,36,208886,1152
DE-MV,29-03-2020,RKI,2,2,0,1585440000000,13003,Rostock,38,0,38,208886,1152
DE-MV,30-03-2020,RKI,1,1,0,1585526400000,13003,Rostock,39,0,39,208886,1152
DE-MV,31-03-2020,RKI,1,1,0,1585612800000,13003,Rostock,40,0,40,208886,1152
DE-MV,02-04-2020,RKI,0,0,0,1585785600000,13003,Rostock,40,0,40,208886,1152
DE-MV,03-04-2020,RKI,0,0,0,1585872000000,13003,Rostock,40,0,40,208886,1152
DE-MV,04-04-2020,RKI,1,1,0,1585958400000,13003,Rostock,41,0,41,208886,1152
DE-MV,06-04-2020,RKI,0,0,0,1586131200000,13003,Rostock,41,0,41,208886,1152
DE-MV,07-04-2020,RKI,5,4,1,1586217600000,13003,Rostock,46,1,45,208886,1152
DE-MV,09-04-2020,RKI,0,0,0,1586390400000,13003,Rostock,46,1,45,208886,1152
DE-MV,14-04-2020,RKI,0,0,0,1586822400000,13003,Rostock,46,1,45,208886,1152
DE-MV,15-04-2020,RKI,0,0,0,1586908800000,13003,Rostock,46,1,45,208886,1152
DE-MV,20-04-2020,RKI,0,0,0,1587340800000,13003,Rostock,46,1,45,208886,1152
DE-MV,04-05-2020,RKI,0,0,0,1588550400000,13003,Rostock,46,1,45,208886,1152
DE-MV,05-05-2020,RKI,1,1,0,1588636800000,13003,Rostock,47,1,46,208886,1152
DE-MV,06-05-2020,RKI,1,1,0,1588723200000,13003,Rostock,48,1,47,208886,1152
DE-MV,07-05-2020,RKI,0,0,0,1588809600000,13003,Rostock,48,1,47,208886,1152
DE-MV,09-05-2020,RKI,0,0,0,1588982400000,13003,Rostock,48,1,47,208886,1152
DE-MV,10-05-2020,RKI,0,0,0,1589068800000,13003,Rostock,48,1,47,208886,1152
DE-MV,11-05-2020,RKI,0,0,0,1589155200000,13003,Rostock,48,1,47,208886,1152
DE-MV,12-05-2020,RKI,1,1,0,1589241600000,13003,Rostock,49,1,48,208886,1152
DE-MV,13-05-2020,RKI,0,0,0,1589328000000,13003,Rostock,49,1,48,208886,1152
DE-MV,17-05-2020,RKI,0,0,0,1589673600000,13003,Rostock,49,1,48,208886,1152
DE-MV,19-05-2020,RKI,0,0,0,1589846400000,13003,Rostock,49,1,48,208886,1152
DE-MV,20-05-2020,RKI,7,7,0,1589932800000,13003,Rostock,56,1,55,208886,1152
DE-MV,06-06-2020,RKI,0,0,0,1591401600000,13003,Rostock,56,1,55,208886,1152
DE-MV,11-06-2020,RKI,0,0,0,1591833600000,13003,Rostock,56,1,55,208886,1152
DE-MV,12-06-2020,RKI,0,0,0,1591920000000,13003,Rostock,56,1,55,208886,1152
DE-MV,16-06-2020,RKI,0,0,0,1592265600000,13003,Rostock,56,1,55,208886,1152
DE-MV,24-06-2020,RKI,0,0,0,1592956800000,13003,Rostock,56,1,55,208886,1152
DE-MV,26-06-2020,RKI,0,0,0,1593129600000,13003,Rostock,56,1,55,208886,1152
DE-MV,30-06-2020,RKI,0,0,0,1593475200000,13003,Rostock,56,1,55,208886,1152
DE-MV,12-03-2020,RKI,0,0,0,1583971200000,13004,Schwerin,0,0,0,95818,734
DE-MV,13-03-2020,RKI,1,1,0,1584057600000,13004,Schwerin,1,0,1,95818,734
DE-MV,16-03-2020,RKI,2,2,0,1584316800000,13004,Schwerin,3,0,3,95818,734
DE-MV,17-03-2020,RKI,3,3,0,1584403200000,13004,Schwerin,6,0,6,95818,734
DE-MV,18-03-2020,RKI,7,7,0,1584489600000,13004,Schwerin,13,0,13,95818,734
DE-MV,19-03-2020,RKI,9,9,0,1584576000000,13004,Schwerin,22,0,22,95818,734
DE-MV,20-03-2020,RKI,3,3,0,1584662400000,13004,Schwerin,25,0,25,95818,734
DE-MV,23-03-2020,RKI,4,4,0,1584921600000,13004,Schwerin,29,0,29,95818,734
DE-MV,24-03-2020,RKI,8,8,0,1585008000000,13004,Schwerin,37,0,37,95818,734
DE-MV,26-03-2020,RKI,2,2,0,1585180800000,13004,Schwerin,39,0,39,95818,734
DE-MV,27-03-2020,RKI,2,2,0,1585267200000,13004,Schwerin,41,0,41,95818,734
DE-MV,28-03-2020,RKI,3,3,0,1585353600000,13004,Schwerin,44,0,44,95818,734
DE-MV,29-03-2020,RKI,1,1,0,1585440000000,13004,Schwerin,45,0,45,95818,734
DE-MV,31-03-2020,RKI,7,7,0,1585612800000,13004,Schwerin,52,0,52,95818,734
DE-MV,01-04-2020,RKI,1,1,0,1585699200000,13004,Schwerin,53,0,53,95818,734
DE-MV,02-04-2020,RKI,1,1,0,1585785600000,13004,Schwerin,54,0,54,95818,734
DE-MV,03-04-2020,RKI,0,0,0,1585872000000,13004,Schwerin,54,0,54,95818,734
DE-MV,04-04-2020,RKI,0,0,0,1585958400000,13004,Schwerin,54,0,54,95818,734
DE-MV,07-04-2020,RKI,5,5,0,1586217600000,13004,Schwerin,59,0,59,95818,734
DE-MV,09-04-2020,RKI,1,1,0,1586390400000,13004,Schwerin,60,0,60,95818,734
DE-MV,15-04-2020,RKI,1,1,0,1586908800000,13004,Schwerin,61,0,61,95818,734
DE-MV,16-04-2020,RKI,0,0,0,1586995200000,13004,Schwerin,61,0,61,95818,734
DE-MV,18-04-2020,RKI,0,0,0,1587168000000,13004,Schwerin,61,0,61,95818,734
DE-MV,24-04-2020,RKI,0,0,0,1587686400000,13004,Schwerin,61,0,61,95818,734
DE-MV,05-06-2020,RKI,0,0,0,1591315200000,13004,Schwerin,61,0,61,95818,734
DE-MV,09-03-2020,RKI,2,2,0,1583712000000,13071,Mecklenburgische Seenplatte,2,0,2,259130,47
DE-MV,11-03-2020,RKI,1,1,0,1583884800000,13071,Mecklenburgische Seenplatte,3,0,3,259130,47
DE-MV,12-03-2020,RKI,0,0,0,1583971200000,13071,Mecklenburgische Seenplatte,3,0,3,259130,47
DE-MV,16-03-2020,RKI,1,1,0,1584316800000,13071,Mecklenburgische Seenplatte,4,0,4,259130,47
DE-MV,17-03-2020,RKI,3,3,0,1584403200000,13071,Mecklenburgische Seenplatte,7,0,7,259130,47
DE-MV,18-03-2020,RKI,6,6,0,1584489600000,13071,Mecklenburgische Seenplatte,13,0,13,259130,47
DE-MV,19-03-2020,RKI,0,0,0,1584576000000,13071,Mecklenburgische Seenplatte,13,0,13,259130,47
DE-MV,20-03-2020,RKI,2,2,0,1584662400000,13071,Mecklenburgische Seenplatte,15,0,15,259130,47
DE-MV,21-03-2020,RKI,3,3,0,1584748800000,13071,Mecklenburgische Seenplatte,18,0,18,259130,47
DE-MV,22-03-2020,RKI,0,0,0,1584835200000,13071,Mecklenburgische Seenplatte,18,0,18,259130,47
DE-MV,23-03-2020,RKI,0,0,0,1584921600000,13071,Mecklenburgische Seenplatte,18,0,18,259130,47
DE-MV,24-03-2020,RKI,8,8,0,1585008000000,13071,Mecklenburgische Seenplatte,26,0,26,259130,47
DE-MV,25-03-2020,RKI,1,1,0,1585094400000,13071,Mecklenburgische Seenplatte,27,0,27,259130,47
DE-MV,26-03-2020,RKI,0,0,0,1585180800000,13071,Mecklenburgische Seenplatte,27,0,27,259130,47
DE-MV,27-03-2020,RKI,12,11,1,1585267200000,13071,Mecklenburgische Seenplatte,39,1,38,259130,47
DE-MV,28-03-2020,RKI,1,1,0,1585353600000,13071,Mecklenburgische Seenplatte,40,1,39,259130,47
DE-MV,29-03-2020,RKI,1,1,0,1585440000000,13071,Mecklenburgische Seenplatte,41,1,40,259130,47
DE-MV,31-03-2020,RKI,12,11,1,1585612800000,13071,Mecklenburgische Seenplatte,53,2,51,259130,47
DE-MV,01-04-2020,RKI,7,6,1,1585699200000,13071,Mecklenburgische Seenplatte,60,3,57,259130,47
DE-MV,02-04-2020,RKI,2,2,0,1585785600000,13071,Mecklenburgische Seenplatte,62,3,59,259130,47
DE-MV,03-04-2020,RKI,6,6,0,1585872000000,13071,Mecklenburgische Seenplatte,68,3,65,259130,47
DE-MV,04-04-2020,RKI,2,2,0,1585958400000,13071,Mecklenburgische Seenplatte,70,3,67,259130,47
DE-MV,07-04-2020,RKI,2,2,0,1586217600000,13071,Mecklenburgische Seenplatte,72,3,69,259130,47
DE-MV,08-04-2020,RKI,1,1,0,1586304000000,13071,Mecklenburgische Seenplatte,73,3,70,259130,47
DE-MV,09-04-2020,RKI,1,1,0,1586390400000,13071,Mecklenburgische Seenplatte,74,3,71,259130,47
DE-MV,10-04-2020,RKI,0,0,0,1586476800000,13071,Mecklenburgische Seenplatte,74,3,71,259130,47
DE-MV,13-04-2020,RKI,1,1,0,1586736000000,13071,Mecklenburgische Seenplatte,75,3,72,259130,47
DE-MV,14-04-2020,RKI,0,0,0,1586822400000,13071,Mecklenburgische Seenplatte,75,3,72,259130,47
DE-MV,15-04-2020,RKI,1,1,0,1586908800000,13071,Mecklenburgische Seenplatte,76,3,73,259130,47
DE-MV,20-04-2020,RKI,0,0,0,1587340800000,13071,Mecklenburgische Seenplatte,76,3,73,259130,47
DE-MV,24-04-2020,RKI,0,0,0,1587686400000,13071,Mecklenburgische Seenplatte,76,3,73,259130,47
DE-MV,30-04-2020,RKI,0,0,0,1588204800000,13071,Mecklenburgische Seenplatte,76,3,73,259130,47
DE-MV,01-05-2020,RKI,0,0,0,1588291200000,13071,Mecklenburgische Seenplatte,76,3,73,259130,47
DE-MV,07-05-2020,RKI,1,1,0,1588809600000,13071,Mecklenburgische Seenplatte,77,3,74,259130,47
DE-MV,09-05-2020,RKI,1,1,0,1588982400000,13071,Mecklenburgische Seenplatte,78,3,75,259130,47
DE-MV,10-05-2020,RKI,0,0,0,1589068800000,13071,Mecklenburgische Seenplatte,78,3,75,259130,47
DE-MV,14-05-2020,RKI,0,0,0,1589414400000,13071,Mecklenburgische Seenplatte,78,3,75,259130,47
DE-MV,15-05-2020,RKI,1,1,0,1589500800000,13071,Mecklenburgische Seenplatte,79,3,76,259130,47
DE-MV,25-05-2020,RKI,0,0,0,1590364800000,13071,Mecklenburgische Seenplatte,79,3,76,259130,47
DE-MV,28-05-2020,RKI,0,0,0,1590624000000,13071,Mecklenburgische Seenplatte,79,3,76,259130,47
DE-MV,03-06-2020,RKI,1,1,0,1591142400000,13071,Mecklenburgische Seenplatte,80,3,77,259130,47
DE-MV,05-06-2020,RKI,0,0,0,1591315200000,13071,Mecklenburgische Seenplatte,80,3,77,259130,47
DE-MV,26-06-2020,RKI,0,0,0,1593129600000,13071,Mecklenburgische Seenplatte,80,3,77,259130,47
DE-MV,09-03-2020,RKI,0,0,0,1583712000000,13072,Rostock,1,0,1,215113,63
DE-MV,11-03-2020,RKI,2,2,0,1583884800000,13072,Rostock,3,0,3,215113,63
DE-MV,12-03-2020,RKI,0,0,0,1583971200000,13072,Rostock,3,0,3,215113,63
DE-MV,13-03-2020,RKI,2,2,0,1584057600000,13072,Rostock,5,0,5,215113,63
DE-MV,14-03-2020,RKI,0,0,0,1584144000000,13072,Rostock,5,0,5,215113,63
DE-MV,17-03-2020,RKI,0,0,0,1584403200000,13072,Rostock,5,0,5,215113,63
DE-MV,18-03-2020,RKI,1,1,0,1584489600000,13072,Rostock,6,0,6,215113,63
DE-MV,19-03-2020,RKI,1,1,0,1584576000000,13072,Rostock,7,0,7,215113,63
DE-MV,20-03-2020,RKI,1,1,0,1584662400000,13072,Rostock,8,0,8,215113,63
DE-MV,24-03-2020,RKI,2,2,0,1585008000000,13072,Rostock,10,0,10,215113,63
DE-MV,25-03-2020,RKI,2,2,0,1585094400000,13072,Rostock,12,0,12,215113,63
DE-MV,26-03-2020,RKI,0,0,0,1585180800000,13072,Rostock,12,0,12,215113,63
DE-MV,28-03-2020,RKI,0,0,0,1585353600000,13072,Rostock,12,0,12,215113,63
DE-MV,29-03-2020,RKI,0,0,0,1585440000000,13072,Rostock,12,0,12,215113,63
DE-MV,30-03-2020,RKI,2,2,0,1585526400000,13072,Rostock,14,0,14,215113,63
DE-MV,31-03-2020,RKI,1,0,1,1585612800000,13072,Rostock,15,1,14,215113,63
DE-MV,01-04-2020,RKI,0,0,0,1585699200000,13072,Rostock,15,1,14,215113,63
DE-MV,02-04-2020,RKI,6,5,1,1585785600000,13072,Rostock,21,2,19,215113,63
DE-MV,03-04-2020,RKI,1,1,0,1585872000000,13072,Rostock,22,2,20,215113,63
DE-MV,04-04-2020,RKI,2,2,0,1585958400000,13072,Rostock,24,2,22,215113,63
DE-MV,07-04-2020,RKI,0,0,0,1586217600000,13072,Rostock,24,2,22,215113,63
DE-MV,08-04-2020,RKI,3,3,0,1586304000000,13072,Rostock,27,2,25,215113,63
DE-MV,09-04-2020,RKI,1,1,0,1586390400000,13072,Rostock,28,2,26,215113,63
DE-MV,11-04-2020,RKI,1,1,0,1586563200000,13072,Rostock,29,2,27,215113,63
DE-MV,25-04-2020,RKI,0,0,0,1587772800000,13072,Rostock,29,2,27,215113,63
DE-MV,28-04-2020,RKI,1,1,0,1588032000000,13072,Rostock,30,2,28,215113,63
DE-MV,29-04-2020,RKI,1,1,0,1588118400000,13072,Rostock,31,2,29,215113,63
DE-MV,30-04-2020,RKI,1,1,0,1588204800000,13072,Rostock,32,2,30,215113,63
DE-MV,01-05-2020,RKI,0,0,0,1588291200000,13072,Rostock,32,2,30,215113,63
DE-MV,02-05-2020,RKI,1,1,0,1588377600000,13072,Rostock,33,2,31,215113,63
DE-MV,04-05-2020,RKI,2,2,0,1588550400000,13072,Rostock,35,2,33,215113,63
DE-MV,10-05-2020,RKI,0,0,0,1589068800000,13072,Rostock,35,2,33,215113,63
DE-MV,11-05-2020,RKI,1,1,0,1589155200000,13072,Rostock,36,2,34,215113,63
DE-MV,12-05-2020,RKI,1,1,0,1589241600000,13072,Rostock,37,2,35,215113,63
DE-MV,13-05-2020,RKI,0,0,0,1589328000000,13072,Rostock,37,2,35,215113,63
DE-MV,14-05-2020,RKI,1,1,0,1589414400000,13072,Rostock,38,2,36,215113,63
DE-MV,09-06-2020,RKI,0,0,0,1591660800000,13072,Rostock,38,2,36,215113,63
DE-MV,05-03-2020,RKI,0,0,0,1583366400000,13073,Vorpommern-Rügen,0,0,0,224684,70
DE-MV,11-03-2020,RKI,0,0,0,1583884800000,13073,Vorpommern-Rügen,0,0,0,224684,70
DE-MV,12-03-2020,RKI,1,1,0,1583971200000,13073,Vorpommern-Rügen,1,0,1,224684,70
DE-MV,13-03-2020,RKI,0,0,0,1584057600000,13073,Vorpommern-Rügen,1,0,1,224684,70
DE-MV,18-03-2020,RKI,2,2,0,1584489600000,13073,Vorpommern-Rügen,3,0,3,224684,70
DE-MV,19-03-2020,RKI,2,2,0,1584576000000,13073,Vorpommern-Rügen,5,0,5,224684,70
DE-MV,20-03-2020,RKI,0,0,0,1584662400000,13073,Vorpommern-Rügen,5,0,5,224684,70
DE-MV,21-03-2020,RKI,1,1,0,1584748800000,13073,Vorpommern-Rügen,6,0,6,224684,70
DE-MV,24-03-2020,RKI,2,2,0,1585008000000,13073,Vorpommern-Rügen,8,0,8,224684,70
DE-MV,25-03-2020,RKI,5,5,0,1585094400000,13073,Vorpommern-Rügen,13,0,13,224684,70
DE-MV,26-03-2020,RKI,1,1,0,1585180800000,13073,Vorpommern-Rügen,14,0,14,224684,70
DE-MV,27-03-2020,RKI,5,5,0,1585267200000,13073,Vorpommern-Rügen,19,0,19,224684,70
DE-MV,28-03-2020,RKI,0,0,0,1585353600000,13073,Vorpommern-Rügen,19,0,19,224684,70
DE-MV,29-03-2020,RKI,2,2,0,1585440000000,13073,Vorpommern-Rügen,21,0,21,224684,70
DE-MV,31-03-2020,RKI,6,6,0,1585612800000,13073,Vorpommern-Rügen,27,0,27,224684,70
DE-MV,01-04-2020,RKI,7,6,1,1585699200000,13073,Vorpommern-Rügen,34,1,33,224684,70
DE-MV,02-04-2020,RKI,3,2,1,1585785600000,13073,Vorpommern-Rügen,37,2,35,224684,70
DE-MV,03-04-2020,RKI,1,1,0,1585872000000,13073,Vorpommern-Rügen,38,2,36,224684,70
DE-MV,04-04-2020,RKI,0,0,0,1585958400000,13073,Vorpommern-Rügen,38,2,36,224684,70
DE-MV,05-04-2020,RKI,1,1,0,1586044800000,13073,Vorpommern-Rügen,39,2,37,224684,70
DE-MV,06-04-2020,RKI,0,0,0,1586131200000,13073,Vorpommern-Rügen,39,2,37,224684,70
DE-MV,07-04-2020,RKI,1,1,0,1586217600000,13073,Vorpommern-Rügen,40,2,38,224684,70
DE-MV,09-04-2020,RKI,2,2,0,1586390400000,13073,Vorpommern-Rügen,42,2,40,224684,70
DE-MV,10-04-2020,RKI,1,1,0,1586476800000,13073,Vorpommern-Rügen,43,2,41,224684,70
DE-MV,11-04-2020,RKI,3,3,0,1586563200000,13073,Vorpommern-Rügen,46,2,44,224684,70
DE-MV,16-04-2020,RKI,0,0,0,1586995200000,13073,Vorpommern-Rügen,46,2,44,224684,70
DE-MV,17-04-2020,RKI,0,0,0,1587081600000,13073,Vorpommern-Rügen,46,2,44,224684,70
DE-MV,25-04-2020,RKI,0,0,0,1587772800000,13073,Vorpommern-Rügen,46,2,44,224684,70
DE-MV,28-04-2020,RKI,0,0,0,1588032000000,13073,Vorpommern-Rügen,46,2,44,224684,70
DE-MV,29-04-2020,RKI,1,1,0,1588118400000,13073,Vorpommern-Rügen,47,2,45,224684,70
DE-MV,05-06-2020,RKI,0,0,0,1591315200000,13073,Vorpommern-Rügen,47,2,45,224684,70
DE-MV,06-06-2020,RKI,5,5,0,1591401600000,13073,Vorpommern-Rügen,52,2,50,224684,70
DE-MV,09-06-2020,RKI,1,1,0,1591660800000,13073,Vorpommern-Rügen,53,2,51,224684,70
DE-MV,11-06-2020,RKI,0,0,0,1591833600000,13073,Vorpommern-Rügen,53,2,51,224684,70
DE-MV,19-06-2020,RKI,0,0,0,1592524800000,13073,Vorpommern-Rügen,53,2,51,224684,70
DE-MV,23-06-2020,RKI,0,0,0,1592870400000,13073,Vorpommern-Rügen,53,2,51,224684,70
DE-MV,25-06-2020,RKI,0,0,0,1593043200000,13073,Vorpommern-Rügen,53,2,51,224684,70
DE-MV,17-03-2020,RKI,4,4,0,1584403200000,13074,Nordwestmecklenburg,6,0,6,156729,74
DE-MV,18-03-2020,RKI,4,4,0,1584489600000,13074,Nordwestmecklenburg,10,0,10,156729,74
DE-MV,19-03-2020,RKI,3,3,0,1584576000000,13074,Nordwestmecklenburg,13,0,13,156729,74
DE-MV,21-03-2020,RKI,0,0,0,1584748800000,13074,Nordwestmecklenburg,13,0,13,156729,74
DE-MV,24-03-2020,RKI,2,2,0,1585008000000,13074,Nordwestmecklenburg,15,0,15,156729,74
DE-MV,25-03-2020,RKI,2,2,0,1585094400000,13074,Nordwestmecklenburg,17,0,17,156729,74
DE-MV,27-03-2020,RKI,0,0,0,1585267200000,13074,Nordwestmecklenburg,17,0,17,156729,74
DE-MV,28-03-2020,RKI,2,1,1,1585353600000,13074,Nordwestmecklenburg,19,1,18,156729,74
DE-MV,31-03-2020,RKI,7,7,0,1585612800000,13074,Nordwestmecklenburg,26,1,25,156729,74
DE-MV,01-04-2020,RKI,1,1,0,1585699200000,13074,Nordwestmecklenburg,27,1,26,156729,74
DE-MV,02-04-2020,RKI,5,5,0,1585785600000,13074,Nordwestmecklenburg,32,1,31,156729,74
DE-MV,03-04-2020,RKI,6,6,0,1585872000000,13074,Nordwestmecklenburg,38,1,37,156729,74
DE-MV,07-04-2020,RKI,2,2,0,1586217600000,13074,Nordwestmecklenburg,40,1,39,156729,74
DE-MV,08-04-2020,RKI,0,0,0,1586304000000,13074,Nordwestmecklenburg,40,1,39,156729,74
DE-MV,09-04-2020,RKI,3,3,0,1586390400000,13074,Nordwestmecklenburg,43,1,42,156729,74
DE-MV,10-04-2020,RKI,0,0,0,1586476800000,13074,Nordwestmecklenburg,43,1,42,156729,74
DE-MV,12-04-2020,RKI,2,2,0,1586649600000,13074,Nordwestmecklenburg,45,1,44,156729,74
DE-MV,15-04-2020,RKI,0,0,0,1586908800000,13074,Nordwestmecklenburg,45,1,44,156729,74
DE-MV,16-04-2020,RKI,2,2,0,1586995200000,13074,Nordwestmecklenburg,47,1,46,156729,74
DE-MV,18-04-2020,RKI,0,0,0,1587168000000,13074,Nordwestmecklenburg,47,1,46,156729,74
DE-MV,21-04-2020,RKI,0,0,0,1587427200000,13074,Nordwestmecklenburg,47,1,46,156729,74
DE-MV,22-04-2020,RKI,0,0,0,1587513600000,13074,Nordwestmecklenburg,47,1,46,156729,74
DE-MV,24-04-2020,RKI,0,0,0,1587686400000,13074,Nordwestmecklenburg,47,1,46,156729,74
DE-MV,25-04-2020,RKI,0,0,0,1587772800000,13074,Nordwestmecklenburg,47,1,46,156729,74
DE-MV,28-04-2020,RKI,2,2,0,1588032000000,13074,Nordwestmecklenburg,49,1,48,156729,74
DE-MV,01-05-2020,RKI,0,0,0,1588291200000,13074,Nordwestmecklenburg,49,1,48,156729,74
DE-MV,05-05-2020,RKI,0,0,0,1588636800000,13074,Nordwestmecklenburg,49,1,48,156729,74
DE-MV,13-05-2020,RKI,0,0,0,1589328000000,13074,Nordwestmecklenburg,49,1,48,156729,74
DE-MV,24-06-2020,RKI,0,0,0,1592956800000,13074,Nordwestmecklenburg,49,1,48,156729,74
DE-MV,12-03-2020,RKI,0,0,0,1583971200000,13075,Vorpommern-Greifswald,1,0,1,236697,60
DE-MV,13-03-2020,RKI,0,0,0,1584057600000,13075,Vorpommern-Greifswald,1,0,1,236697,60
DE-MV,16-03-2020,RKI,2,2,0,1584316800000,13075,Vorpommern-Greifswald,3,0,3,236697,60
DE-MV,17-03-2020,RKI,0,0,0,1584403200000,13075,Vorpommern-Greifswald,3,0,3,236697,60
DE-MV,18-03-2020,RKI,7,7,0,1584489600000,13075,Vorpommern-Greifswald,10,0,10,236697,60
DE-MV,19-03-2020,RKI,8,8,0,1584576000000,13075,Vorpommern-Greifswald,18,0,18,236697,60
DE-MV,20-03-2020,RKI,0,0,0,1584662400000,13075,Vorpommern-Greifswald,18,0,18,236697,60
DE-MV,21-03-2020,RKI,1,1,0,1584748800000,13075,Vorpommern-Greifswald,19,0,19,236697,60
DE-MV,23-03-2020,RKI,1,1,0,1584921600000,13075,Vorpommern-Greifswald,20,0,20,236697,60
DE-MV,24-03-2020,RKI,1,1,0,1585008000000,13075,Vorpommern-Greifswald,21,0,21,236697,60
DE-MV,25-03-2020,RKI,3,2,1,1585094400000,13075,Vorpommern-Greifswald,24,1,23,236697,60
DE-MV,26-03-2020,RKI,5,5,0,1585180800000,13075,Vorpommern-Greifswald,29,1,28,236697,60
DE-MV,27-03-2020,RKI,10,10,0,1585267200000,13075,Vorpommern-Greifswald,39,1,38,236697,60
DE-MV,28-03-2020,RKI,1,1,0,1585353600000,13075,Vorpommern-Greifswald,40,1,39,236697,60
DE-MV,30-03-2020,RKI,5,5,0,1585526400000,13075,Vorpommern-Greifswald,45,1,44,236697,60
DE-MV,31-03-2020,RKI,5,5,0,1585612800000,13075,Vorpommern-Greifswald,50,1,49,236697,60
DE-MV,01-04-2020,RKI,0,0,0,1585699200000,13075,Vorpommern-Greifswald,50,1,49,236697,60
DE-MV,02-04-2020,RKI,3,2,1,1585785600000,13075,Vorpommern-Greifswald,53,2,51,236697,60
DE-MV,03-04-2020,RKI,6,6,0,1585872000000,13075,Vorpommern-Greifswald,59,2,57,236697,60
DE-MV,04-04-2020,RKI,0,0,0,1585958400000,13075,Vorpommern-Greifswald,59,2,57,236697,60
DE-MV,06-04-2020,RKI,2,2,0,1586131200000,13075,Vorpommern-Greifswald,61,2,59,236697,60
DE-MV,07-04-2020,RKI,8,7,1,1586217600000,13075,Vorpommern-Greifswald,69,3,66,236697,60
DE-MV,08-04-2020,RKI,0,0,0,1586304000000,13075,Vorpommern-Greifswald,69,3,66,236697,60
DE-MV,09-04-2020,RKI,0,0,0,1586390400000,13075,Vorpommern-Greifswald,69,3,66,236697,60
DE-MV,10-04-2020,RKI,5,4,1,1586476800000,13075,Vorpommern-Greifswald,74,4,70,236697,60
DE-MV,11-04-2020,RKI,5,5,0,1586563200000,13075,Vorpommern-Greifswald,79,4,75,236697,60
DE-MV,13-04-2020,RKI,0,0,0,1586736000000,13075,Vorpommern-Greifswald,79,4,75,236697,60
DE-MV,14-04-2020,RKI,0,0,0,1586822400000,13075,Vorpommern-Greifswald,79,4,75,236697,60
DE-MV,15-04-2020,RKI,2,2,0,1586908800000,13075,Vorpommern-Greifswald,81,4,77,236697,60
DE-MV,16-04-2020,RKI,0,0,0,1586995200000,13075,Vorpommern-Greifswald,81,4,77,236697,60
DE-MV,17-04-2020,RKI,2,2,0,1587081600000,13075,Vorpommern-Greifswald,83,4,79,236697,60
DE-MV,18-04-2020,RKI,2,1,1,1587168000000,13075,Vorpommern-Greifswald,85,5,80,236697,60
DE-MV,21-04-2020,RKI,0,0,0,1587427200000,13075,Vorpommern-Greifswald,85,5,80,236697,60
DE-MV,22-04-2020,RKI,2,2,0,1587513600000,13075,Vorpommern-Greifswald,87,5,82,236697,60
DE-MV,24-04-2020,RKI,1,1,0,1587686400000,13075,Vorpommern-Greifswald,88,5,83,236697,60
DE-MV,25-04-2020,RKI,1,0,1,1587772800000,13075,Vorpommern-Greifswald,89,6,83,236697,60
DE-MV,27-04-2020,RKI,0,0,0,1587945600000,13075,Vorpommern-Greifswald,89,6,83,236697,60
DE-MV,28-04-2020,RKI,5,5,0,1588032000000,13075,Vorpommern-Greifswald,94,6,88,236697,60
DE-MV,07-05-2020,RKI,0,0,0,1588809600000,13075,Vorpommern-Greifswald,94,6,88,236697,60
DE-MV,29-05-2020,RKI,0,0,0,1590710400000,13075,Vorpommern-Greifswald,94,6,88,236697,60
DE-MV,04-06-2020,RKI,0,0,0,1591228800000,13075,Vorpommern-Greifswald,94,6,88,236697,60
DE-MV,15-06-2020,RKI,0,0,0,1592179200000,13075,Vorpommern-Greifswald,94,6,88,236697,60
DE-MV,29-06-2020,RKI,0,0,0,1593388800000,13075,Vorpommern-Greifswald,94,6,88,236697,60
DE-MV,15-07-2020,RKI,0,0,0,1594771200000,13075,Vorpommern-Greifswald,94,6,88,236697,60
DE-MV,15-03-2020,RKI,0,0,0,1584230400000,13076,Ludwigslust-Parchim,0,0,0,212618,45
DE-MV,17-03-2020,RKI,7,7,0,1584403200000,13076,Ludwigslust-Parchim,7,0,7,212618,45
DE-MV,18-03-2020,RKI,4,4,0,1584489600000,13076,Ludwigslust-Parchim,11,0,11,212618,45
DE-MV,19-03-2020,RKI,2,2,0,1584576000000,13076,Ludwigslust-Parchim,13,0,13,212618,45
DE-MV,20-03-2020,RKI,3,3,0,1584662400000,13076,Ludwigslust-Parchim,16,0,16,212618,45
DE-MV,21-03-2020,RKI,1,1,0,1584748800000,13076,Ludwigslust-Parchim,17,0,17,212618,45
DE-MV,24-03-2020,RKI,2,1,1,1585008000000,13076,Ludwigslust-Parchim,19,1,18,212618,45
DE-MV,25-03-2020,RKI,0,0,0,1585094400000,13076,Ludwigslust-Parchim,19,1,18,212618,45
DE-MV,26-03-2020,RKI,0,0,0,1585180800000,13076,Ludwigslust-Parchim,19,1,18,212618,45
DE-MV,27-03-2020,RKI,2,2,0,1585267200000,13076,Ludwigslust-Parchim,21,1,20,212618,45
DE-MV,28-03-2020,RKI,2,1,1,1585353600000,13076,Ludwigslust-Parchim,23,2,21,212618,45
DE-MV,30-03-2020,RKI,1,1,0,1585526400000,13076,Ludwigslust-Parchim,24,2,22,212618,45
DE-MV,31-03-2020,RKI,3,3,0,1585612800000,13076,Ludwigslust-Parchim,27,2,25,212618,45
DE-MV,02-04-2020,RKI,1,1,0,1585785600000,13076,Ludwigslust-Parchim,28,2,26,212618,45
DE-MV,03-04-2020,RKI,3,3,0,1585872000000,13076,Ludwigslust-Parchim,31,2,29,212618,45
DE-MV,04-04-2020,RKI,3,3,0,1585958400000,13076,Ludwigslust-Parchim,34,2,32,212618,45
DE-MV,07-04-2020,RKI,3,3,0,1586217600000,13076,Ludwigslust-Parchim,37,2,35,212618,45
DE-MV,10-04-2020,RKI,0,0,0,1586476800000,13076,Ludwigslust-Parchim,37,2,35,212618,45
DE-MV,13-04-2020,RKI,0,0,0,1586736000000,13076,Ludwigslust-Parchim,37,2,35,212618,45
DE-MV,15-04-2020,RKI,1,1,0,1586908800000,13076,Ludwigslust-Parchim,38,2,36,212618,45
DE-MV,16-04-2020,RKI,2,2,0,1586995200000,13076,Ludwigslust-Parchim,40,2,38,212618,45
DE-MV,18-04-2020,RKI,0,0,0,1587168000000,13076,Ludwigslust-Parchim,40,2,38,212618,45
DE-MV,24-04-2020,RKI,0,0,0,1587686400000,13076,Ludwigslust-Parchim,40,2,38,212618,45
DE-MV,25-04-2020,RKI,0,0,0,1587772800000,13076,Ludwigslust-Parchim,40,2,38,212618,45
DE-MV,28-04-2020,RKI,0,0,0,1588032000000,13076,Ludwigslust-Parchim,40,2,38,212618,45
DE-MV,30-04-2020,RKI,0,0,0,1588204800000,13076,Ludwigslust-Parchim,40,2,38,212618,45
DE-MV,01-05-2020,RKI,0,0,0,1588291200000,13076,Ludwigslust-Parchim,40,2,38,212618,45
DE-MV,05-05-2020,RKI,2,2,0,1588636800000,13076,Ludwigslust-Parchim,42,2,40,212618,45
DE-MV,06-05-2020,RKI,0,0,0,1588723200000,13076,Ludwigslust-Parchim,42,2,40,212618,45
DE-MV,07-05-2020,RKI,1,1,0,1588809600000,13076,Ludwigslust-Parchim,43,2,41,212618,45
DE-MV,13-05-2020,RKI,0,0,0,1589328000000,13076,Ludwigslust-Parchim,43,2,41,212618,45
DE-MV,14-05-2020,RKI,1,1,0,1589414400000,13076,Ludwigslust-Parchim,44,2,42,212618,45
DE-MV,16-05-2020,RKI,0,0,0,1589587200000,13076,Ludwigslust-Parchim,44,2,42,212618,45
DE-MV,10-06-2020,RKI,0,0,0,1591747200000,13076,Ludwigslust-Parchim,44,2,42,212618,45
DE-MV,12-06-2020,RKI,0,0,0,1591920000000,13076,Ludwigslust-Parchim,44,2,42,212618,45
DE-MV,14-06-2020,RKI,0,0,0,1592092800000,13076,Ludwigslust-Parchim,44,2,42,212618,45
DE-MV,15-06-2020,RKI,0,0,0,1592179200000,13076,Ludwigslust-Parchim,44,2,42,212618,45
DE-MV,16-06-2020,RKI,0,0,0,1592265600000,13076,Ludwigslust-Parchim,44,2,42,212618,45
DE-MV,17-06-2020,RKI,4,4,0,1592352000000,13076,Ludwigslust-Parchim,48,2,46,212618,45
DE-MV,27-06-2020,RKI,1,1,0,1593216000000,13076,Ludwigslust-Parchim,49,2,47,212618,45
DE-MV,02-07-2020,RKI,0,0,0,1593648000000,13076,Ludwigslust-Parchim,49,2,47,212618,45
DE-NI,11-03-2020,RKI,0,0,0,1583884800000,03101,Braunschweig,0,0,0,248292,1292
DE-NI,14-03-2020,RKI,2,2,0,1584144000000,03101,Braunschweig,2,0,2,248292,1292
DE-NI,15-03-2020,RKI,2,2,0,1584230400000,03101,Braunschweig,4,0,4,248292,1292
DE-NI,17-03-2020,RKI,2,2,0,1584403200000,03101,Braunschweig,6,0,6,248292,1292
DE-NI,18-03-2020,RKI,1,1,0,1584489600000,03101,Braunschweig,7,0,7,248292,1292
DE-NI,19-03-2020,RKI,4,4,0,1584576000000,03101,Braunschweig,11,0,11,248292,1292
DE-NI,20-03-2020,RKI,7,7,0,1584662400000,03101,Braunschweig,18,0,18,248292,1292
DE-NI,21-03-2020,RKI,3,3,0,1584748800000,03101,Braunschweig,21,0,21,248292,1292
DE-NI,22-03-2020,RKI,25,25,0,1584835200000,03101,Braunschweig,46,0,46,248292,1292
DE-NI,23-03-2020,RKI,1,1,0,1584921600000,03101,Braunschweig,47,0,47,248292,1292
DE-NI,24-03-2020,RKI,15,15,0,1585008000000,03101,Braunschweig,62,0,62,248292,1292
DE-NI,25-03-2020,RKI,5,5,0,1585094400000,03101,Braunschweig,67,0,67,248292,1292
DE-NI,26-03-2020,RKI,13,12,1,1585180800000,03101,Braunschweig,80,1,79,248292,1292
DE-NI,27-03-2020,RKI,14,14,0,1585267200000,03101,Braunschweig,94,1,93,248292,1292
DE-NI,28-03-2020,RKI,28,26,2,1585353600000,03101,Braunschweig,122,3,119,248292,1292
DE-NI,29-03-2020,RKI,5,4,1,1585440000000,03101,Braunschweig,127,4,123,248292,1292
DE-NI,30-03-2020,RKI,2,1,1,1585526400000,03101,Braunschweig,129,5,124,248292,1292
DE-NI,31-03-2020,RKI,20,19,1,1585612800000,03101,Braunschweig,149,6,143,248292,1292
DE-NI,01-04-2020,RKI,17,16,1,1585699200000,03101,Braunschweig,166,7,159,248292,1292
DE-NI,02-04-2020,RKI,21,19,2,1585785600000,03101,Braunschweig,187,9,178,248292,1292
DE-NI,03-04-2020,RKI,9,9,0,1585872000000,03101,Braunschweig,196,9,187,248292,1292
DE-NI,04-04-2020,RKI,4,4,0,1585958400000,03101,Braunschweig,200,9,191,248292,1292
DE-NI,05-04-2020,RKI,5,4,1,1586044800000,03101,Braunschweig,205,10,195,248292,1292
DE-NI,06-04-2020,RKI,1,1,0,1586131200000,03101,Braunschweig,206,10,196,248292,1292
DE-NI,07-04-2020,RKI,8,7,1,1586217600000,03101,Braunschweig,214,11,203,248292,1292
DE-NI,08-04-2020,RKI,3,2,1,1586304000000,03101,Braunschweig,217,12,205,248292,1292
DE-NI,09-04-2020,RKI,22,21,1,1586390400000,03101,Braunschweig,239,13,226,248292,1292
DE-NI,10-04-2020,RKI,2,2,0,1586476800000,03101,Braunschweig,241,13,228,248292,1292
DE-NI,11-04-2020,RKI,0,0,0,1586563200000,03101,Braunschweig,241,13,228,248292,1292
DE-NI,12-04-2020,RKI,1,1,0,1586649600000,03101,Braunschweig,242,13,229,248292,1292
DE-NI,13-04-2020,RKI,1,1,0,1586736000000,03101,Braunschweig,243,13,230,248292,1292
DE-NI,14-04-2020,RKI,3,1,2,1586822400000,03101,Braunschweig,246,15,231,248292,1292
DE-NI,15-04-2020,RKI,3,3,0,1586908800000,03101,Braunschweig,249,15,234,248292,1292
DE-NI,16-04-2020,RKI,2,2,0,1586995200000,03101,Braunschweig,251,15,236,248292,1292
DE-NI,17-04-2020,RKI,1,1,0,1587081600000,03101,Braunschweig,252,15,237,248292,1292
DE-NI,18-04-2020,RKI,1,1,0,1587168000000,03101,Braunschweig,253,15,238,248292,1292
DE-NI,20-04-2020,RKI,0,0,0,1587340800000,03101,Braunschweig,253,15,238,248292,1292
DE-NI,22-04-2020,RKI,1,1,0,1587513600000,03101,Braunschweig,254,15,239,248292,1292
DE-NI,24-04-2020,RKI,4,3,1,1587686400000,03101,Braunschweig,258,16,242,248292,1292
DE-NI,25-04-2020,RKI,0,0,0,1587772800000,03101,Braunschweig,258,16,242,248292,1292
DE-NI,26-04-2020,RKI,0,0,0,1587859200000,03101,Braunschweig,258,16,242,248292,1292
DE-NI,28-04-2020,RKI,0,0,0,1588032000000,03101,Braunschweig,258,16,242,248292,1292
DE-NI,29-04-2020,RKI,2,1,1,1588118400000,03101,Braunschweig,260,17,243,248292,1292
DE-NI,01-05-2020,RKI,0,0,0,1588291200000,03101,Braunschweig,260,17,243,248292,1292
DE-NI,02-05-2020,RKI,0,0,0,1588377600000,03101,Braunschweig,260,17,243,248292,1292
DE-NI,05-05-2020,RKI,0,0,0,1588636800000,03101,Braunschweig,260,17,243,248292,1292
DE-NI,07-05-2020,RKI,3,3,0,1588809600000,03101,Braunschweig,263,17,246,248292,1292
DE-NI,08-05-2020,RKI,0,0,0,1588896000000,03101,Braunschweig,263,17,246,248292,1292
DE-NI,09-05-2020,RKI,1,1,0,1588982400000,03101,Braunschweig,264,17,247,248292,1292
DE-NI,10-05-2020,RKI,0,0,0,1589068800000,03101,Braunschweig,264,17,247,248292,1292
DE-NI,11-05-2020,RKI,2,2,0,1589155200000,03101,Braunschweig,266,17,249,248292,1292
DE-NI,12-05-2020,RKI,0,0,0,1589241600000,03101,Braunschweig,266,17,249,248292,1292
DE-NI,13-05-2020,RKI,2,2,0,1589328000000,03101,Braunschweig,268,17,251,248292,1292
DE-NI,16-05-2020,RKI,2,1,1,1589587200000,03101,Braunschweig,270,18,252,248292,1292
DE-NI,22-05-2020,RKI,0,0,0,1590105600000,03101,Braunschweig,270,18,252,248292,1292
DE-NI,27-05-2020,RKI,0,0,0,1590537600000,03101,Braunschweig,270,18,252,248292,1292
DE-NI,28-05-2020,RKI,1,1,0,1590624000000,03101,Braunschweig,271,18,253,248292,1292
DE-NI,03-06-2020,RKI,0,0,0,1591142400000,03101,Braunschweig,271,18,253,248292,1292
DE-NI,18-06-2020,RKI,0,0,0,1592438400000,03101,Braunschweig,271,18,253,248292,1292
DE-NI,20-06-2020,RKI,0,0,0,1592611200000,03101,Braunschweig,271,18,253,248292,1292
DE-NI,22-06-2020,RKI,0,0,0,1592784000000,03101,Braunschweig,271,18,253,248292,1292
DE-NI,23-06-2020,RKI,0,0,0,1592870400000,03101,Braunschweig,271,18,253,248292,1292
DE-NI,25-06-2020,RKI,0,0,0,1593043200000,03101,Braunschweig,271,18,253,248292,1292
DE-NI,27-06-2020,RKI,0,0,0,1593216000000,03101,Braunschweig,271,18,253,248292,1292
DE-NI,30-06-2020,RKI,0,0,0,1593475200000,03101,Braunschweig,271,18,253,248292,1292
DE-NI,03-07-2020,RKI,12,12,0,1593734400000,03101,Braunschweig,283,18,265,248292,1292
DE-NI,10-07-2020,RKI,0,0,0,1594339200000,03101,Braunschweig,283,18,265,248292,1292
DE-NI,13-03-2020,RKI,0,0,0,1584057600000,03102,Salzgitter,0,0,0,104948,469
DE-NI,17-03-2020,RKI,1,1,0,1584403200000,03102,Salzgitter,1,0,1,104948,469
DE-NI,18-03-2020,RKI,2,2,0,1584489600000,03102,Salzgitter,3,0,3,104948,469
DE-NI,19-03-2020,RKI,2,2,0,1584576000000,03102,Salzgitter,5,0,5,104948,469
DE-NI,20-03-2020,RKI,7,7,0,1584662400000,03102,Salzgitter,12,0,12,104948,469
DE-NI,21-03-2020,RKI,5,5,0,1584748800000,03102,Salzgitter,17,0,17,104948,469
DE-NI,22-03-2020,RKI,0,0,0,1584835200000,03102,Salzgitter,17,0,17,104948,469
DE-NI,23-03-2020,RKI,1,1,0,1584921600000,03102,Salzgitter,18,0,18,104948,469
DE-NI,24-03-2020,RKI,3,3,0,1585008000000,03102,Salzgitter,21,0,21,104948,469
DE-NI,25-03-2020,RKI,2,2,0,1585094400000,03102,Salzgitter,23,0,23,104948,469
DE-NI,26-03-2020,RKI,7,6,1,1585180800000,03102,Salzgitter,30,1,29,104948,469
DE-NI,27-03-2020,RKI,2,2,0,1585267200000,03102,Salzgitter,32,1,31,104948,469
DE-NI,29-03-2020,RKI,4,4,0,1585440000000,03102,Salzgitter,36,1,35,104948,469
DE-NI,30-03-2020,RKI,2,2,0,1585526400000,03102,Salzgitter,38,1,37,104948,469
DE-NI,31-03-2020,RKI,4,4,0,1585612800000,03102,Salzgitter,42,1,41,104948,469
DE-NI,01-04-2020,RKI,2,2,0,1585699200000,03102,Salzgitter,44,1,43,104948,469
DE-NI,02-04-2020,RKI,2,2,0,1585785600000,03102,Salzgitter,46,1,45,104948,469
DE-NI,03-04-2020,RKI,2,1,1,1585872000000,03102,Salzgitter,48,2,46,104948,469
DE-NI,04-04-2020,RKI,2,1,1,1585958400000,03102,Salzgitter,50,3,47,104948,469
DE-NI,05-04-2020,RKI,0,0,0,1586044800000,03102,Salzgitter,50,3,47,104948,469
DE-NI,07-04-2020,RKI,12,12,0,1586217600000,03102,Salzgitter,62,3,59,104948,469
DE-NI,08-04-2020,RKI,4,4,0,1586304000000,03102,Salzgitter,66,3,63,104948,469
DE-NI,09-04-2020,RKI,3,3,0,1586390400000,03102,Salzgitter,69,3,66,104948,469
DE-NI,10-04-2020,RKI,2,2,0,1586476800000,03102,Salzgitter,71,3,68,104948,469
DE-NI,13-04-2020,RKI,1,0,1,1586736000000,03102,Salzgitter,72,4,68,104948,469
DE-NI,14-04-2020,RKI,1,1,0,1586822400000,03102,Salzgitter,73,4,69,104948,469
DE-NI,15-04-2020,RKI,4,3,1,1586908800000,03102,Salzgitter,77,5,72,104948,469
DE-NI,16-04-2020,RKI,2,2,0,1586995200000,03102,Salzgitter,79,5,74,104948,469
DE-NI,17-04-2020,RKI,2,2,0,1587081600000,03102,Salzgitter,81,5,76,104948,469
DE-NI,18-04-2020,RKI,1,1,0,1587168000000,03102,Salzgitter,82,5,77,104948,469
DE-NI,19-04-2020,RKI,1,0,1,1587254400000,03102,Salzgitter,83,6,77,104948,469
DE-NI,20-04-2020,RKI,0,0,0,1587340800000,03102,Salzgitter,83,6,77,104948,469
DE-NI,21-04-2020,RKI,1,1,0,1587427200000,03102,Salzgitter,84,6,78,104948,469
DE-NI,23-04-2020,RKI,6,5,1,1587600000000,03102,Salzgitter,90,7,83,104948,469
DE-NI,27-04-2020,RKI,1,0,1,1587945600000,03102,Salzgitter,91,8,83,104948,469
DE-NI,28-04-2020,RKI,0,0,0,1588032000000,03102,Salzgitter,91,8,83,104948,469
DE-NI,01-05-2020,RKI,0,0,0,1588291200000,03102,Salzgitter,91,8,83,104948,469
DE-NI,05-05-2020,RKI,0,0,0,1588636800000,03102,Salzgitter,91,8,83,104948,469
DE-NI,08-05-2020,RKI,0,0,0,1588896000000,03102,Salzgitter,91,8,83,104948,469
DE-NI,11-05-2020,RKI,3,3,0,1589155200000,03102,Salzgitter,94,8,86,104948,469
DE-NI,12-05-2020,RKI,0,0,0,1589241600000,03102,Salzgitter,94,8,86,104948,469
DE-NI,15-05-2020,RKI,0,0,0,1589500800000,03102,Salzgitter,94,8,86,104948,469
DE-NI,18-05-2020,RKI,0,0,0,1589760000000,03102,Salzgitter,94,8,86,104948,469
DE-NI,25-05-2020,RKI,0,0,0,1590364800000,03102,Salzgitter,94,8,86,104948,469
DE-NI,26-05-2020,RKI,0,0,0,1590451200000,03102,Salzgitter,94,8,86,104948,469
DE-NI,03-06-2020,RKI,1,1,0,1591142400000,03102,Salzgitter,95,8,87,104948,469
DE-NI,19-06-2020,RKI,0,0,0,1592524800000,03102,Salzgitter,95,8,87,104948,469
DE-NI,20-06-2020,RKI,3,3,0,1592611200000,03102,Salzgitter,98,8,90,104948,469
DE-NI,25-06-2020,RKI,0,0,0,1593043200000,03102,Salzgitter,98,8,90,104948,469
DE-NI,27-06-2020,RKI,1,0,0,1593216000000,03102,Salzgitter,99,8,90,104948,469
DE-NI,29-06-2020,RKI,2,1,0,1593388800000,03102,Salzgitter,101,8,91,104948,469
DE-NI,01-07-2020,RKI,0,0,0,1593561600000,03102,Salzgitter,101,8,91,104948,469
DE-NI,02-07-2020,RKI,1,1,0,1593648000000,03102,Salzgitter,102,8,92,104948,469
DE-NI,06-07-2020,RKI,0,0,0,1593993600000,03102,Salzgitter,102,8,92,104948,469
DE-NI,14-07-2020,RKI,0,0,0,1594684800000,03102,Salzgitter,102,8,92,104948,469
DE-NI,17-03-2020,RKI,0,0,0,1584403200000,03103,Wolfsburg,2,0,2,124151,608
DE-NI,18-03-2020,RKI,3,0,3,1584489600000,03103,Wolfsburg,5,3,2,124151,608
DE-NI,19-03-2020,RKI,1,1,0,1584576000000,03103,Wolfsburg,6,3,3,124151,608
DE-NI,20-03-2020,RKI,4,2,2,1584662400000,03103,Wolfsburg,10,5,5,124151,608
DE-NI,21-03-2020,RKI,3,2,1,1584748800000,03103,Wolfsburg,13,6,7,124151,608
DE-NI,22-03-2020,RKI,6,6,0,1584835200000,03103,Wolfsburg,19,6,13,124151,608
DE-NI,23-03-2020,RKI,1,0,1,1584921600000,03103,Wolfsburg,20,7,13,124151,608
DE-NI,24-03-2020,RKI,4,4,0,1585008000000,03103,Wolfsburg,24,7,17,124151,608
DE-NI,25-03-2020,RKI,12,10,2,1585094400000,03103,Wolfsburg,36,9,27,124151,608
DE-NI,26-03-2020,RKI,5,4,1,1585180800000,03103,Wolfsburg,41,10,31,124151,608
DE-NI,27-03-2020,RKI,62,39,23,1585267200000,03103,Wolfsburg,103,33,70,124151,608
DE-NI,28-03-2020,RKI,27,23,4,1585353600000,03103,Wolfsburg,130,37,93,124151,608
DE-NI,29-03-2020,RKI,18,17,1,1585440000000,03103,Wolfsburg,148,38,110,124151,608
DE-NI,31-03-2020,RKI,18,17,1,1585612800000,03103,Wolfsburg,166,39,127,124151,608
DE-NI,01-04-2020,RKI,7,7,0,1585699200000,03103,Wolfsburg,173,39,134,124151,608
DE-NI,02-04-2020,RKI,24,20,4,1585785600000,03103,Wolfsburg,197,43,154,124151,608
DE-NI,03-04-2020,RKI,1,0,1,1585872000000,03103,Wolfsburg,198,44,154,124151,608
DE-NI,04-04-2020,RKI,2,2,0,1585958400000,03103,Wolfsburg,200,44,156,124151,608
DE-NI,06-04-2020,RKI,1,1,0,1586131200000,03103,Wolfsburg,201,44,157,124151,608
DE-NI,07-04-2020,RKI,1,1,0,1586217600000,03103,Wolfsburg,202,44,158,124151,608
DE-NI,08-04-2020,RKI,5,3,2,1586304000000,03103,Wolfsburg,207,46,161,124151,608
DE-NI,09-04-2020,RKI,8,8,0,1586390400000,03103,Wolfsburg,215,46,169,124151,608
DE-NI,10-04-2020,RKI,6,6,0,1586476800000,03103,Wolfsburg,221,46,175,124151,608
DE-NI,11-04-2020,RKI,0,0,0,1586563200000,03103,Wolfsburg,221,46,175,124151,608
DE-NI,12-04-2020,RKI,0,0,0,1586649600000,03103,Wolfsburg,221,46,175,124151,608
DE-NI,15-04-2020,RKI,2,2,0,1586908800000,03103,Wolfsburg,223,46,177,124151,608
DE-NI,16-04-2020,RKI,3,3,0,1586995200000,03103,Wolfsburg,226,46,180,124151,608
DE-NI,17-04-2020,RKI,9,8,1,1587081600000,03103,Wolfsburg,235,47,188,124151,608
DE-NI,18-04-2020,RKI,3,3,0,1587168000000,03103,Wolfsburg,238,47,191,124151,608
DE-NI,19-04-2020,RKI,0,0,0,1587254400000,03103,Wolfsburg,238,47,191,124151,608
DE-NI,21-04-2020,RKI,2,1,1,1587427200000,03103,Wolfsburg,240,48,192,124151,608
DE-NI,22-04-2020,RKI,2,2,0,1587513600000,03103,Wolfsburg,242,48,194,124151,608
DE-NI,23-04-2020,RKI,1,1,0,1587600000000,03103,Wolfsburg,243,48,195,124151,608
DE-NI,25-04-2020,RKI,0,0,0,1587772800000,03103,Wolfsburg,243,48,195,124151,608
DE-NI,28-04-2020,RKI,0,0,0,1588032000000,03103,Wolfsburg,243,48,195,124151,608
DE-NI,30-04-2020,RKI,0,0,0,1588204800000,03103,Wolfsburg,243,48,195,124151,608
DE-NI,02-05-2020,RKI,0,0,0,1588377600000,03103,Wolfsburg,243,48,195,124151,608
DE-NI,05-05-2020,RKI,1,1,0,1588636800000,03103,Wolfsburg,244,48,196,124151,608
DE-NI,08-05-2020,RKI,1,1,0,1588896000000,03103,Wolfsburg,245,48,197,124151,608
DE-NI,11-05-2020,RKI,1,1,0,1589155200000,03103,Wolfsburg,246,48,198,124151,608
DE-NI,13-05-2020,RKI,1,1,0,1589328000000,03103,Wolfsburg,247,48,199,124151,608
DE-NI,14-05-2020,RKI,0,0,0,1589414400000,03103,Wolfsburg,247,48,199,124151,608
DE-NI,22-05-2020,RKI,1,1,0,1590105600000,03103,Wolfsburg,248,48,200,124151,608
DE-NI,26-05-2020,RKI,2,2,0,1590451200000,03103,Wolfsburg,250,48,202,124151,608
DE-NI,27-05-2020,RKI,4,4,0,1590537600000,03103,Wolfsburg,254,48,206,124151,608
DE-NI,29-05-2020,RKI,4,4,0,1590710400000,03103,Wolfsburg,258,48,210,124151,608
DE-NI,03-06-2020,RKI,0,0,0,1591142400000,03103,Wolfsburg,258,48,210,124151,608
DE-NI,04-06-2020,RKI,1,1,0,1591228800000,03103,Wolfsburg,259,48,211,124151,608
DE-NI,05-06-2020,RKI,1,1,0,1591315200000,03103,Wolfsburg,260,48,212,124151,608
DE-NI,06-06-2020,RKI,1,1,0,1591401600000,03103,Wolfsburg,261,48,213,124151,608
DE-NI,08-06-2020,RKI,3,3,0,1591574400000,03103,Wolfsburg,264,48,216,124151,608
DE-NI,09-06-2020,RKI,2,2,0,1591660800000,03103,Wolfsburg,266,48,218,124151,608
DE-NI,10-06-2020,RKI,2,2,0,1591747200000,03103,Wolfsburg,268,48,220,124151,608
DE-NI,11-06-2020,RKI,3,3,0,1591833600000,03103,Wolfsburg,271,48,223,124151,608
DE-NI,12-06-2020,RKI,4,4,0,1591920000000,03103,Wolfsburg,275,48,227,124151,608
DE-NI,13-06-2020,RKI,0,0,0,1592006400000,03103,Wolfsburg,275,48,227,124151,608
DE-NI,15-06-2020,RKI,3,2,1,1592179200000,03103,Wolfsburg,278,49,229,124151,608
DE-NI,16-06-2020,RKI,4,4,0,1592265600000,03103,Wolfsburg,282,49,233,124151,608
DE-NI,17-06-2020,RKI,0,0,0,1592352000000,03103,Wolfsburg,282,49,233,124151,608
DE-NI,18-06-2020,RKI,11,11,0,1592438400000,03103,Wolfsburg,293,49,244,124151,608
DE-NI,19-06-2020,RKI,2,2,0,1592524800000,03103,Wolfsburg,295,49,246,124151,608
DE-NI,20-06-2020,RKI,0,0,0,1592611200000,03103,Wolfsburg,295,49,246,124151,608
DE-NI,23-06-2020,RKI,0,0,0,1592870400000,03103,Wolfsburg,295,49,246,124151,608
DE-NI,26-06-2020,RKI,1,1,0,1593129600000,03103,Wolfsburg,296,49,247,124151,608
DE-NI,01-07-2020,RKI,1,1,0,1593561600000,03103,Wolfsburg,297,49,248,124151,608
DE-NI,12-07-2020,RKI,0,0,0,1594512000000,03103,Wolfsburg,297,49,248,124151,608
DE-NI,12-03-2020,RKI,2,2,0,1583971200000,03151,Gifhorn,3,0,3,175920,113
DE-NI,13-03-2020,RKI,1,1,0,1584057600000,03151,Gifhorn,4,0,4,175920,113
DE-NI,16-03-2020,RKI,8,8,0,1584316800000,03151,Gifhorn,12,0,12,175920,113
DE-NI,17-03-2020,RKI,4,4,0,1584403200000,03151,Gifhorn,16,0,16,175920,113
DE-NI,18-03-2020,RKI,0,0,0,1584489600000,03151,Gifhorn,16,0,16,175920,113
DE-NI,19-03-2020,RKI,3,3,0,1584576000000,03151,Gifhorn,19,0,19,175920,113
DE-NI,20-03-2020,RKI,4,4,0,1584662400000,03151,Gifhorn,23,0,23,175920,113
DE-NI,21-03-2020,RKI,1,1,0,1584748800000,03151,Gifhorn,24,0,24,175920,113
DE-NI,22-03-2020,RKI,0,0,0,1584835200000,03151,Gifhorn,24,0,24,175920,113
DE-NI,23-03-2020,RKI,2,2,0,1584921600000,03151,Gifhorn,26,0,26,175920,113
DE-NI,24-03-2020,RKI,0,0,0,1585008000000,03151,Gifhorn,26,0,26,175920,113
DE-NI,25-03-2020,RKI,3,3,0,1585094400000,03151,Gifhorn,29,0,29,175920,113
DE-NI,26-03-2020,RKI,4,4,0,1585180800000,03151,Gifhorn,33,0,33,175920,113
DE-NI,27-03-2020,RKI,2,2,0,1585267200000,03151,Gifhorn,35,0,35,175920,113
DE-NI,28-03-2020,RKI,9,9,0,1585353600000,03151,Gifhorn,44,0,44,175920,113
DE-NI,30-03-2020,RKI,7,7,0,1585526400000,03151,Gifhorn,51,0,51,175920,113
DE-NI,31-03-2020,RKI,8,8,0,1585612800000,03151,Gifhorn,59,0,59,175920,113
DE-NI,01-04-2020,RKI,5,5,0,1585699200000,03151,Gifhorn,64,0,64,175920,113
DE-NI,02-04-2020,RKI,1,0,1,1585785600000,03151,Gifhorn,65,1,64,175920,113
DE-NI,03-04-2020,RKI,4,4,0,1585872000000,03151,Gifhorn,69,1,68,175920,113
DE-NI,04-04-2020,RKI,1,1,0,1585958400000,03151,Gifhorn,70,1,69,175920,113
DE-NI,05-04-2020,RKI,0,0,0,1586044800000,03151,Gifhorn,70,1,69,175920,113
DE-NI,06-04-2020,RKI,2,2,0,1586131200000,03151,Gifhorn,72,1,71,175920,113
DE-NI,07-04-2020,RKI,4,4,0,1586217600000,03151,Gifhorn,76,1,75,175920,113
DE-NI,08-04-2020,RKI,0,0,0,1586304000000,03151,Gifhorn,76,1,75,175920,113
DE-NI,09-04-2020,RKI,0,0,0,1586390400000,03151,Gifhorn,76,1,75,175920,113
DE-NI,12-04-2020,RKI,2,2,0,1586649600000,03151,Gifhorn,78,1,77,175920,113
DE-NI,14-04-2020,RKI,1,1,0,1586822400000,03151,Gifhorn,79,1,78,175920,113
DE-NI,15-04-2020,RKI,3,3,0,1586908800000,03151,Gifhorn,82,1,81,175920,113
DE-NI,16-04-2020,RKI,4,4,0,1586995200000,03151,Gifhorn,86,1,85,175920,113
DE-NI,17-04-2020,RKI,0,0,0,1587081600000,03151,Gifhorn,86,1,85,175920,113
DE-NI,20-04-2020,RKI,0,0,0,1587340800000,03151,Gifhorn,86,1,85,175920,113
DE-NI,21-04-2020,RKI,0,0,0,1587427200000,03151,Gifhorn,86,1,85,175920,113
DE-NI,24-04-2020,RKI,0,0,0,1587686400000,03151,Gifhorn,86,1,85,175920,113
DE-NI,27-04-2020,RKI,0,0,0,1587945600000,03151,Gifhorn,86,1,85,175920,113
DE-NI,29-04-2020,RKI,0,0,0,1588118400000,03151,Gifhorn,86,1,85,175920,113
DE-NI,12-05-2020,RKI,0,0,0,1589241600000,03151,Gifhorn,86,1,85,175920,113
DE-NI,24-05-2020,RKI,0,0,0,1590278400000,03151,Gifhorn,86,1,85,175920,113
DE-NI,26-05-2020,RKI,1,1,0,1590451200000,03151,Gifhorn,87,1,86,175920,113
DE-NI,01-06-2020,RKI,8,8,0,1590969600000,03151,Gifhorn,95,1,94,175920,113
DE-NI,03-06-2020,RKI,2,2,0,1591142400000,03151,Gifhorn,97,1,96,175920,113
DE-NI,05-06-2020,RKI,1,1,0,1591315200000,03151,Gifhorn,98,1,97,175920,113
DE-NI,09-06-2020,RKI,0,0,0,1591660800000,03151,Gifhorn,98,1,97,175920,113
DE-NI,11-06-2020,RKI,0,0,0,1591833600000,03151,Gifhorn,98,1,97,175920,113
DE-NI,14-06-2020,RKI,0,0,0,1592092800000,03151,Gifhorn,98,1,97,175920,113
DE-NI,15-06-2020,RKI,1,1,0,1592179200000,03151,Gifhorn,99,1,98,175920,113
DE-NI,16-06-2020,RKI,0,0,0,1592265600000,03151,Gifhorn,99,1,98,175920,113
DE-NI,17-06-2020,RKI,0,0,0,1592352000000,03151,Gifhorn,99,1,98,175920,113
DE-NI,19-06-2020,RKI,1,1,0,1592524800000,03151,Gifhorn,100,1,99,175920,113
DE-NI,25-06-2020,RKI,0,0,0,1593043200000,03151,Gifhorn,100,1,99,175920,113
DE-NI,27-06-2020,RKI,0,0,0,1593216000000,03151,Gifhorn,100,1,99,175920,113
DE-NI,30-06-2020,RKI,2,2,0,1593475200000,03151,Gifhorn,102,1,101,175920,113
DE-NI,01-07-2020,RKI,0,0,0,1593561600000,03151,Gifhorn,102,1,101,175920,113
DE-NI,03-07-2020,RKI,3,3,0,1593734400000,03151,Gifhorn,105,1,104,175920,113
DE-NI,14-03-2020,RKI,1,1,0,1584144000000,03153,Goslar,5,0,5,137014,142
DE-NI,17-03-2020,RKI,1,1,0,1584403200000,03153,Goslar,6,0,6,137014,142
DE-NI,18-03-2020,RKI,4,4,0,1584489600000,03153,Goslar,10,0,10,137014,142
DE-NI,19-03-2020,RKI,1,1,0,1584576000000,03153,Goslar,11,0,11,137014,142
DE-NI,20-03-2020,RKI,1,1,0,1584662400000,03153,Goslar,12,0,12,137014,142
DE-NI,21-03-2020,RKI,2,2,0,1584748800000,03153,Goslar,14,0,14,137014,142
DE-NI,23-03-2020,RKI,0,0,0,1584921600000,03153,Goslar,14,0,14,137014,142
DE-NI,24-03-2020,RKI,7,7,0,1585008000000,03153,Goslar,21,0,21,137014,142
DE-NI,25-03-2020,RKI,5,5,0,1585094400000,03153,Goslar,26,0,26,137014,142
DE-NI,26-03-2020,RKI,8,6,2,1585180800000,03153,Goslar,34,2,32,137014,142
DE-NI,27-03-2020,RKI,5,4,1,1585267200000,03153,Goslar,39,3,36,137014,142
DE-NI,30-03-2020,RKI,6,6,0,1585526400000,03153,Goslar,45,3,42,137014,142
DE-NI,31-03-2020,RKI,0,0,0,1585612800000,03153,Goslar,45,3,42,137014,142
DE-NI,01-04-2020,RKI,0,0,0,1585699200000,03153,Goslar,45,3,42,137014,142
DE-NI,02-04-2020,RKI,9,8,1,1585785600000,03153,Goslar,54,4,50,137014,142
DE-NI,03-04-2020,RKI,3,3,0,1585872000000,03153,Goslar,57,4,53,137014,142
DE-NI,04-04-2020,RKI,7,5,2,1585958400000,03153,Goslar,64,6,58,137014,142
DE-NI,05-04-2020,RKI,4,4,0,1586044800000,03153,Goslar,68,6,62,137014,142
DE-NI,07-04-2020,RKI,2,2,0,1586217600000,03153,Goslar,70,6,64,137014,142
DE-NI,08-04-2020,RKI,7,4,3,1586304000000,03153,Goslar,77,9,68,137014,142
DE-NI,09-04-2020,RKI,14,13,1,1586390400000,03153,Goslar,91,10,81,137014,142
DE-NI,14-04-2020,RKI,8,8,0,1586822400000,03153,Goslar,99,10,89,137014,142
DE-NI,15-04-2020,RKI,8,6,2,1586908800000,03153,Goslar,107,12,95,137014,142
DE-NI,16-04-2020,RKI,3,3,0,1586995200000,03153,Goslar,110,12,98,137014,142
DE-NI,17-04-2020,RKI,4,4,0,1587081600000,03153,Goslar,114,12,102,137014,142
DE-NI,20-04-2020,RKI,22,21,1,1587340800000,03153,Goslar,136,13,123,137014,142
DE-NI,21-04-2020,RKI,4,4,0,1587427200000,03153,Goslar,140,13,127,137014,142
DE-NI,22-04-2020,RKI,7,7,0,1587513600000,03153,Goslar,147,13,134,137014,142
DE-NI,23-04-2020,RKI,4,4,0,1587600000000,03153,Goslar,151,13,138,137014,142
DE-NI,24-04-2020,RKI,1,1,0,1587686400000,03153,Goslar,152,13,139,137014,142
DE-NI,27-04-2020,RKI,13,10,3,1587945600000,03153,Goslar,165,16,149,137014,142
DE-NI,28-04-2020,RKI,6,5,1,1588032000000,03153,Goslar,171,17,154,137014,142
DE-NI,29-04-2020,RKI,2,0,2,1588118400000,03153,Goslar,173,19,154,137014,142
DE-NI,30-04-2020,RKI,1,1,0,1588204800000,03153,Goslar,174,19,155,137014,142
DE-NI,04-05-2020,RKI,9,8,1,1588550400000,03153,Goslar,183,20,163,137014,142
DE-NI,05-05-2020,RKI,2,1,1,1588636800000,03153,Goslar,185,21,164,137014,142
DE-NI,06-05-2020,RKI,8,7,1,1588723200000,03153,Goslar,193,22,171,137014,142
DE-NI,07-05-2020,RKI,1,1,0,1588809600000,03153,Goslar,194,22,172,137014,142
DE-NI,11-05-2020,RKI,2,1,1,1589155200000,03153,Goslar,196,23,173,137014,142
DE-NI,13-05-2020,RKI,2,1,1,1589328000000,03153,Goslar,198,24,174,137014,142
DE-NI,15-05-2020,RKI,2,2,0,1589500800000,03153,Goslar,200,24,176,137014,142
DE-NI,18-05-2020,RKI,1,1,0,1589760000000,03153,Goslar,201,24,177,137014,142
DE-NI,19-05-2020,RKI,1,0,1,1589846400000,03153,Goslar,202,25,177,137014,142
DE-NI,20-05-2020,RKI,0,0,0,1589932800000,03153,Goslar,202,25,177,137014,142
DE-NI,22-05-2020,RKI,2,2,0,1590105600000,03153,Goslar,204,25,179,137014,142
DE-NI,25-05-2020,RKI,1,1,0,1590364800000,03153,Goslar,205,25,180,137014,142
DE-NI,26-05-2020,RKI,0,0,0,1590451200000,03153,Goslar,205,25,180,137014,142
DE-NI,27-05-2020,RKI,0,0,0,1590537600000,03153,Goslar,205,25,180,137014,142
DE-NI,01-06-2020,RKI,1,1,0,1590969600000,03153,Goslar,206,25,181,137014,142
DE-NI,02-06-2020,RKI,0,0,0,1591056000000,03153,Goslar,206,25,181,137014,142
DE-NI,16-06-2020,RKI,0,0,0,1592265600000,03153,Goslar,206,25,181,137014,142
DE-NI,17-06-2020,RKI,1,1,0,1592352000000,03153,Goslar,207,25,182,137014,142
DE-NI,29-06-2020,RKI,1,0,0,1593388800000,03153,Goslar,208,25,182,137014,142
DE-NI,30-06-2020,RKI,0,0,0,1593475200000,03153,Goslar,208,25,182,137014,142
DE-NI,13-07-2020,RKI,1,0,0,1594598400000,03153,Goslar,209,25,182,137014,142
DE-NI,18-03-2020,RKI,4,4,0,1584489600000,03154,Helmstedt,5,0,5,91307,135
DE-NI,19-03-2020,RKI,0,0,0,1584576000000,03154,Helmstedt,5,0,5,91307,135
DE-NI,20-03-2020,RKI,2,2,0,1584662400000,03154,Helmstedt,7,0,7,91307,135
DE-NI,21-03-2020,RKI,4,4,0,1584748800000,03154,Helmstedt,11,0,11,91307,135
DE-NI,22-03-2020,RKI,1,1,0,1584835200000,03154,Helmstedt,12,0,12,91307,135
DE-NI,23-03-2020,RKI,1,1,0,1584921600000,03154,Helmstedt,13,0,13,91307,135
DE-NI,24-03-2020,RKI,3,3,0,1585008000000,03154,Helmstedt,16,0,16,91307,135
DE-NI,25-03-2020,RKI,3,3,0,1585094400000,03154,Helmstedt,19,0,19,91307,135
DE-NI,26-03-2020,RKI,10,10,0,1585180800000,03154,Helmstedt,29,0,29,91307,135
DE-NI,27-03-2020,RKI,5,5,0,1585267200000,03154,Helmstedt,34,0,34,91307,135
DE-NI,28-03-2020,RKI,6,6,0,1585353600000,03154,Helmstedt,40,0,40,91307,135
DE-NI,29-03-2020,RKI,1,1,0,1585440000000,03154,Helmstedt,41,0,41,91307,135
DE-NI,30-03-2020,RKI,5,5,0,1585526400000,03154,Helmstedt,46,0,46,91307,135
DE-NI,31-03-2020,RKI,6,6,0,1585612800000,03154,Helmstedt,52,0,52,91307,135
DE-NI,01-04-2020,RKI,9,9,0,1585699200000,03154,Helmstedt,61,0,61,91307,135
DE-NI,03-04-2020,RKI,2,2,0,1585872000000,03154,Helmstedt,63,0,63,91307,135
DE-NI,04-04-2020,RKI,2,2,0,1585958400000,03154,Helmstedt,65,0,65,91307,135
DE-NI,06-04-2020,RKI,1,0,1,1586131200000,03154,Helmstedt,66,1,65,91307,135
DE-NI,07-04-2020,RKI,1,1,0,1586217600000,03154,Helmstedt,67,1,66,91307,135
DE-NI,08-04-2020,RKI,0,0,0,1586304000000,03154,Helmstedt,67,1,66,91307,135
DE-NI,10-04-2020,RKI,1,1,0,1586476800000,03154,Helmstedt,68,1,67,91307,135
DE-NI,19-04-2020,RKI,18,18,0,1587254400000,03154,Helmstedt,86,1,85,91307,135
DE-NI,20-04-2020,RKI,0,0,0,1587340800000,03154,Helmstedt,86,1,85,91307,135
DE-NI,21-04-2020,RKI,1,1,0,1587427200000,03154,Helmstedt,87,1,86,91307,135
DE-NI,23-04-2020,RKI,14,14,0,1587600000000,03154,Helmstedt,101,1,100,91307,135
DE-NI,25-04-2020,RKI,2,2,0,1587772800000,03154,Helmstedt,103,1,102,91307,135
DE-NI,27-04-2020,RKI,0,0,0,1587945600000,03154,Helmstedt,103,1,102,91307,135
DE-NI,29-04-2020,RKI,3,3,0,1588118400000,03154,Helmstedt,106,1,105,91307,135
DE-NI,09-05-2020,RKI,0,0,0,1588982400000,03154,Helmstedt,106,1,105,91307,135
DE-NI,14-05-2020,RKI,0,0,0,1589414400000,03154,Helmstedt,106,1,105,91307,135
DE-NI,26-05-2020,RKI,1,1,0,1590451200000,03154,Helmstedt,107,1,106,91307,135
DE-NI,28-05-2020,RKI,0,0,0,1590624000000,03154,Helmstedt,107,1,106,91307,135
DE-NI,12-03-2020,RKI,0,0,0,1583971200000,03155,Northeim,1,0,1,132765,105
DE-NI,17-03-2020,RKI,2,2,0,1584403200000,03155,Northeim,3,0,3,132765,105
DE-NI,18-03-2020,RKI,1,1,0,1584489600000,03155,Northeim,4,0,4,132765,105
DE-NI,19-03-2020,RKI,4,4,0,1584576000000,03155,Northeim,8,0,8,132765,105
DE-NI,20-03-2020,RKI,2,2,0,1584662400000,03155,Northeim,10,0,10,132765,105
DE-NI,23-03-2020,RKI,4,3,1,1584921600000,03155,Northeim,14,1,13,132765,105
DE-NI,24-03-2020,RKI,3,3,0,1585008000000,03155,Northeim,17,1,16,132765,105
DE-NI,26-03-2020,RKI,3,3,0,1585180800000,03155,Northeim,20,1,19,132765,105
DE-NI,27-03-2020,RKI,2,2,0,1585267200000,03155,Northeim,22,1,21,132765,105
DE-NI,29-03-2020,RKI,1,1,0,1585440000000,03155,Northeim,23,1,22,132765,105
DE-NI,30-03-2020,RKI,3,3,0,1585526400000,03155,Northeim,26,1,25,132765,105
DE-NI,31-03-2020,RKI,0,0,0,1585612800000,03155,Northeim,26,1,25,132765,105
DE-NI,01-04-2020,RKI,2,2,0,1585699200000,03155,Northeim,28,1,27,132765,105
DE-NI,02-04-2020,RKI,1,1,0,1585785600000,03155,Northeim,29,1,28,132765,105
DE-NI,03-04-2020,RKI,2,2,0,1585872000000,03155,Northeim,31,1,30,132765,105
DE-NI,04-04-2020,RKI,3,3,0,1585958400000,03155,Northeim,34,1,33,132765,105
DE-NI,06-04-2020,RKI,5,5,0,1586131200000,03155,Northeim,39,1,38,132765,105
DE-NI,08-04-2020,RKI,3,3,0,1586304000000,03155,Northeim,42,1,41,132765,105
DE-NI,09-04-2020,RKI,1,1,0,1586390400000,03155,Northeim,43,1,42,132765,105
DE-NI,10-04-2020,RKI,4,4,0,1586476800000,03155,Northeim,47,1,46,132765,105
DE-NI,11-04-2020,RKI,2,2,0,1586563200000,03155,Northeim,49,1,48,132765,105
DE-NI,12-04-2020,RKI,8,8,0,1586649600000,03155,Northeim,57,1,56,132765,105
DE-NI,13-04-2020,RKI,0,0,0,1586736000000,03155,Northeim,57,1,56,132765,105
DE-NI,14-04-2020,RKI,1,0,1,1586822400000,03155,Northeim,58,2,56,132765,105
DE-NI,15-04-2020,RKI,4,3,1,1586908800000,03155,Northeim,62,3,59,132765,105
DE-NI,16-04-2020,RKI,5,5,0,1586995200000,03155,Northeim,67,3,64,132765,105
DE-NI,17-04-2020,RKI,4,4,0,1587081600000,03155,Northeim,71,3,68,132765,105
DE-NI,18-04-2020,RKI,3,3,0,1587168000000,03155,Northeim,74,3,71,132765,105
DE-NI,19-04-2020,RKI,1,1,0,1587254400000,03155,Northeim,75,3,72,132765,105
DE-NI,21-04-2020,RKI,1,1,0,1587427200000,03155,Northeim,76,3,73,132765,105
DE-NI,22-04-2020,RKI,2,1,1,1587513600000,03155,Northeim,78,4,74,132765,105
DE-NI,23-04-2020,RKI,3,3,0,1587600000000,03155,Northeim,81,4,77,132765,105
DE-NI,25-04-2020,RKI,0,0,0,1587772800000,03155,Northeim,81,4,77,132765,105
DE-NI,26-04-2020,RKI,0,0,0,1587859200000,03155,Northeim,81,4,77,132765,105
DE-NI,29-04-2020,RKI,0,0,0,1588118400000,03155,Northeim,81,4,77,132765,105
DE-NI,30-04-2020,RKI,0,0,0,1588204800000,03155,Northeim,81,4,77,132765,105
DE-NI,14-05-2020,RKI,0,0,0,1589414400000,03155,Northeim,81,4,77,132765,105
DE-NI,19-05-2020,RKI,0,0,0,1589846400000,03155,Northeim,81,4,77,132765,105
DE-NI,20-05-2020,RKI,0,0,0,1589932800000,03155,Northeim,81,4,77,132765,105
DE-NI,29-05-2020,RKI,0,0,0,1590710400000,03155,Northeim,81,4,77,132765,105
DE-NI,30-05-2020,RKI,0,0,0,1590796800000,03155,Northeim,81,4,77,132765,105
DE-NI,05-06-2020,RKI,0,0,0,1591315200000,03155,Northeim,81,4,77,132765,105
DE-NI,06-06-2020,RKI,0,0,0,1591401600000,03155,Northeim,81,4,77,132765,105
DE-NI,10-06-2020,RKI,0,0,0,1591747200000,03155,Northeim,81,4,77,132765,105
DE-NI,15-06-2020,RKI,1,1,0,1592179200000,03155,Northeim,82,4,78,132765,105
DE-NI,17-06-2020,RKI,3,3,0,1592352000000,03155,Northeim,85,4,81,132765,105
DE-NI,19-06-2020,RKI,5,5,0,1592524800000,03155,Northeim,90,4,86,132765,105
DE-NI,24-06-2020,RKI,0,0,0,1592956800000,03155,Northeim,90,4,86,132765,105
DE-NI,25-06-2020,RKI,1,1,0,1593043200000,03155,Northeim,91,4,87,132765,105
DE-NI,29-06-2020,RKI,3,3,0,1593388800000,03155,Northeim,94,4,90,132765,105
DE-NI,06-07-2020,RKI,0,0,0,1593993600000,03155,Northeim,94,4,90,132765,105
DE-NI,08-07-2020,RKI,0,0,0,1594166400000,03155,Northeim,94,4,90,132765,105
DE-NI,09-07-2020,RKI,0,0,0,1594252800000,03155,Northeim,94,4,90,132765,105
DE-NI,14-07-2020,RKI,0,0,0,1594684800000,03155,Northeim,94,4,90,132765,105
DE-NI,17-03-2020,RKI,5,5,0,1584403200000,03157,Peine,6,0,6,133965,250
DE-NI,18-03-2020,RKI,0,0,0,1584489600000,03157,Peine,6,0,6,133965,250
DE-NI,19-03-2020,RKI,3,3,0,1584576000000,03157,Peine,9,0,9,133965,250
DE-NI,20-03-2020,RKI,1,1,0,1584662400000,03157,Peine,10,0,10,133965,250
DE-NI,21-03-2020,RKI,4,4,0,1584748800000,03157,Peine,14,0,14,133965,250
DE-NI,22-03-2020,RKI,0,0,0,1584835200000,03157,Peine,14,0,14,133965,250
DE-NI,23-03-2020,RKI,1,1,0,1584921600000,03157,Peine,15,0,15,133965,250
DE-NI,24-03-2020,RKI,1,1,0,1585008000000,03157,Peine,16,0,16,133965,250
DE-NI,25-03-2020,RKI,5,5,0,1585094400000,03157,Peine,21,0,21,133965,250
DE-NI,26-03-2020,RKI,8,8,0,1585180800000,03157,Peine,29,0,29,133965,250
DE-NI,27-03-2020,RKI,6,6,0,1585267200000,03157,Peine,35,0,35,133965,250
DE-NI,28-03-2020,RKI,11,11,0,1585353600000,03157,Peine,46,0,46,133965,250
DE-NI,29-03-2020,RKI,1,1,0,1585440000000,03157,Peine,47,0,47,133965,250
DE-NI,30-03-2020,RKI,17,12,5,1585526400000,03157,Peine,64,5,59,133965,250
DE-NI,31-03-2020,RKI,9,9,0,1585612800000,03157,Peine,73,5,68,133965,250
DE-NI,01-04-2020,RKI,4,4,0,1585699200000,03157,Peine,77,5,72,133965,250
DE-NI,02-04-2020,RKI,5,4,1,1585785600000,03157,Peine,82,6,76,133965,250
DE-NI,03-04-2020,RKI,5,5,0,1585872000000,03157,Peine,87,6,81,133965,250
DE-NI,04-04-2020,RKI,2,1,1,1585958400000,03157,Peine,89,7,82,133965,250
DE-NI,07-04-2020,RKI,6,6,0,1586217600000,03157,Peine,95,7,88,133965,250
DE-NI,08-04-2020,RKI,4,4,0,1586304000000,03157,Peine,99,7,92,133965,250
DE-NI,09-04-2020,RKI,1,1,0,1586390400000,03157,Peine,100,7,93,133965,250
DE-NI,11-04-2020,RKI,1,0,1,1586563200000,03157,Peine,101,8,93,133965,250
DE-NI,14-04-2020,RKI,0,0,0,1586822400000,03157,Peine,101,8,93,133965,250
DE-NI,15-04-2020,RKI,2,1,1,1586908800000,03157,Peine,103,9,94,133965,250
DE-NI,17-04-2020,RKI,1,1,0,1587081600000,03157,Peine,104,9,95,133965,250
DE-NI,21-04-2020,RKI,2,2,0,1587427200000,03157,Peine,106,9,97,133965,250
DE-NI,22-04-2020,RKI,0,0,0,1587513600000,03157,Peine,106,9,97,133965,250
DE-NI,24-04-2020,RKI,0,0,0,1587686400000,03157,Peine,106,9,97,133965,250
DE-NI,28-04-2020,RKI,1,1,0,1588032000000,03157,Peine,107,9,98,133965,250
DE-NI,29-04-2020,RKI,0,0,0,1588118400000,03157,Peine,107,9,98,133965,250
DE-NI,05-05-2020,RKI,0,0,0,1588636800000,03157,Peine,107,9,98,133965,250
DE-NI,21-05-2020,RKI,0,0,0,1590019200000,03157,Peine,107,9,98,133965,250
DE-NI,25-05-2020,RKI,0,0,0,1590364800000,03157,Peine,107,9,98,133965,250
DE-NI,29-05-2020,RKI,1,1,0,1590710400000,03157,Peine,108,9,99,133965,250
DE-NI,03-06-2020,RKI,1,1,0,1591142400000,03157,Peine,109,9,100,133965,250
DE-NI,04-06-2020,RKI,1,1,0,1591228800000,03157,Peine,110,9,101,133965,250
DE-NI,05-06-2020,RKI,0,0,0,1591315200000,03157,Peine,110,9,101,133965,250
DE-NI,08-06-2020,RKI,0,0,0,1591574400000,03157,Peine,110,9,101,133965,250
DE-NI,09-06-2020,RKI,2,2,0,1591660800000,03157,Peine,112,9,103,133965,250
DE-NI,11-06-2020,RKI,1,1,0,1591833600000,03157,Peine,113,9,104,133965,250
DE-NI,12-06-2020,RKI,0,0,0,1591920000000,03157,Peine,113,9,104,133965,250
DE-NI,13-06-2020,RKI,0,0,0,1592006400000,03157,Peine,113,9,104,133965,250
DE-NI,16-06-2020,RKI,0,0,0,1592265600000,03157,Peine,113,9,104,133965,250
DE-NI,17-06-2020,RKI,0,0,0,1592352000000,03157,Peine,113,9,104,133965,250
DE-NI,23-06-2020,RKI,0,0,0,1592870400000,03157,Peine,113,9,104,133965,250
DE-NI,15-07-2020,RKI,0,0,0,1594771200000,03157,Peine,113,9,104,133965,250
DE-NI,18-03-2020,RKI,0,0,0,1584489600000,03158,Wolfenbüttel,0,0,0,119960,166
DE-NI,19-03-2020,RKI,0,0,0,1584576000000,03158,Wolfenbüttel,0,0,0,119960,166
DE-NI,20-03-2020,RKI,0,0,0,1584662400000,03158,Wolfenbüttel,0,0,0,119960,166
DE-NI,23-03-2020,RKI,3,3,0,1584921600000,03158,Wolfenbüttel,3,0,3,119960,166
DE-NI,24-03-2020,RKI,7,7,0,1585008000000,03158,Wolfenbüttel,10,0,10,119960,166
DE-NI,25-03-2020,RKI,3,3,0,1585094400000,03158,Wolfenbüttel,13,0,13,119960,166
DE-NI,26-03-2020,RKI,5,5,0,1585180800000,03158,Wolfenbüttel,18,0,18,119960,166
DE-NI,27-03-2020,RKI,4,4,0,1585267200000,03158,Wolfenbüttel,22,0,22,119960,166
DE-NI,30-03-2020,RKI,2,2,0,1585526400000,03158,Wolfenbüttel,24,0,24,119960,166
DE-NI,31-03-2020,RKI,2,2,0,1585612800000,03158,Wolfenbüttel,26,0,26,119960,166
DE-NI,01-04-2020,RKI,6,6,0,1585699200000,03158,Wolfenbüttel,32,0,32,119960,166
DE-NI,02-04-2020,RKI,7,7,0,1585785600000,03158,Wolfenbüttel,39,0,39,119960,166
DE-NI,03-04-2020,RKI,6,6,0,1585872000000,03158,Wolfenbüttel,45,0,45,119960,166
DE-NI,05-04-2020,RKI,1,1,0,1586044800000,03158,Wolfenbüttel,46,0,46,119960,166
DE-NI,06-04-2020,RKI,12,12,0,1586131200000,03158,Wolfenbüttel,58,0,58,119960,166
DE-NI,07-04-2020,RKI,3,3,0,1586217600000,03158,Wolfenbüttel,61,0,61,119960,166
DE-NI,08-04-2020,RKI,3,3,0,1586304000000,03158,Wolfenbüttel,64,0,64,119960,166
DE-NI,09-04-2020,RKI,6,4,2,1586390400000,03158,Wolfenbüttel,70,2,68,119960,166
DE-NI,10-04-2020,RKI,15,13,2,1586476800000,03158,Wolfenbüttel,85,4,81,119960,166
DE-NI,11-04-2020,RKI,0,0,0,1586563200000,03158,Wolfenbüttel,85,4,81,119960,166
DE-NI,14-04-2020,RKI,4,3,1,1586822400000,03158,Wolfenbüttel,89,5,84,119960,166
DE-NI,15-04-2020,RKI,3,1,2,1586908800000,03158,Wolfenbüttel,92,7,85,119960,166
DE-NI,16-04-2020,RKI,7,5,2,1586995200000,03158,Wolfenbüttel,99,9,90,119960,166
DE-NI,17-04-2020,RKI,10,9,1,1587081600000,03158,Wolfenbüttel,109,10,99,119960,166
DE-NI,18-04-2020,RKI,0,0,0,1587168000000,03158,Wolfenbüttel,109,10,99,119960,166
DE-NI,19-04-2020,RKI,11,9,2,1587254400000,03158,Wolfenbüttel,120,12,108,119960,166
DE-NI,21-04-2020,RKI,2,2,0,1587427200000,03158,Wolfenbüttel,122,12,110,119960,166
DE-NI,22-04-2020,RKI,3,3,0,1587513600000,03158,Wolfenbüttel,125,12,113,119960,166
DE-NI,24-04-2020,RKI,4,3,1,1587686400000,03158,Wolfenbüttel,129,13,116,119960,166
DE-NI,27-04-2020,RKI,5,5,0,1587945600000,03158,Wolfenbüttel,134,13,121,119960,166
DE-NI,28-04-2020,RKI,0,0,0,1588032000000,03158,Wolfenbüttel,134,13,121,119960,166
DE-NI,29-04-2020,RKI,1,1,0,1588118400000,03158,Wolfenbüttel,135,13,122,119960,166
DE-NI,30-04-2020,RKI,0,0,0,1588204800000,03158,Wolfenbüttel,135,13,122,119960,166
DE-NI,03-05-2020,RKI,0,0,0,1588464000000,03158,Wolfenbüttel,135,13,122,119960,166
DE-NI,07-05-2020,RKI,0,0,0,1588809600000,03158,Wolfenbüttel,135,13,122,119960,166
DE-NI,08-05-2020,RKI,0,0,0,1588896000000,03158,Wolfenbüttel,135,13,122,119960,166
DE-NI,11-05-2020,RKI,0,0,0,1589155200000,03158,Wolfenbüttel,135,13,122,119960,166
DE-NI,12-05-2020,RKI,0,0,0,1589241600000,03158,Wolfenbüttel,135,13,122,119960,166
DE-NI,13-05-2020,RKI,2,2,0,1589328000000,03158,Wolfenbüttel,137,13,124,119960,166
DE-NI,14-05-2020,RKI,0,0,0,1589414400000,03158,Wolfenbüttel,137,13,124,119960,166
DE-NI,20-05-2020,RKI,0,0,0,1589932800000,03158,Wolfenbüttel,137,13,124,119960,166
DE-NI,25-05-2020,RKI,0,0,0,1590364800000,03158,Wolfenbüttel,137,13,124,119960,166
DE-NI,28-05-2020,RKI,1,1,0,1590624000000,03158,Wolfenbüttel,138,13,125,119960,166
DE-NI,30-05-2020,RKI,2,2,0,1590796800000,03158,Wolfenbüttel,140,13,127,119960,166
DE-NI,03-06-2020,RKI,0,0,0,1591142400000,03158,Wolfenbüttel,140,13,127,119960,166
DE-NI,08-06-2020,RKI,0,0,0,1591574400000,03158,Wolfenbüttel,140,13,127,119960,166
DE-NI,13-07-2020,RKI,0,0,0,1594598400000,03158,Wolfenbüttel,140,13,127,119960,166
DE-NI,13-03-2020,RKI,0,0,0,1584057600000,03159,Göttingen,2,0,2,328074,187
DE-NI,14-03-2020,RKI,1,1,0,1584144000000,03159,Göttingen,3,0,3,328074,187
DE-NI,15-03-2020,RKI,0,0,0,1584230400000,03159,Göttingen,3,0,3,328074,187
DE-NI,16-03-2020,RKI,3,3,0,1584316800000,03159,Göttingen,6,0,6,328074,187
DE-NI,17-03-2020,RKI,4,4,0,1584403200000,03159,Göttingen,10,0,10,328074,187
DE-NI,18-03-2020,RKI,17,17,0,1584489600000,03159,Göttingen,27,0,27,328074,187
DE-NI,19-03-2020,RKI,6,6,0,1584576000000,03159,Göttingen,33,0,33,328074,187
DE-NI,20-03-2020,RKI,7,7,0,1584662400000,03159,Göttingen,40,0,40,328074,187
DE-NI,21-03-2020,RKI,9,9,0,1584748800000,03159,Göttingen,49,0,49,328074,187
DE-NI,22-03-2020,RKI,3,3,0,1584835200000,03159,Göttingen,52,0,52,328074,187
DE-NI,23-03-2020,RKI,10,10,0,1584921600000,03159,Göttingen,62,0,62,328074,187
DE-NI,24-03-2020,RKI,6,6,0,1585008000000,03159,Göttingen,68,0,68,328074,187
DE-NI,25-03-2020,RKI,8,8,0,1585094400000,03159,Göttingen,76,0,76,328074,187
DE-NI,26-03-2020,RKI,14,14,0,1585180800000,03159,Göttingen,90,0,90,328074,187
DE-NI,27-03-2020,RKI,17,17,0,1585267200000,03159,Göttingen,107,0,107,328074,187
DE-NI,28-03-2020,RKI,8,7,1,1585353600000,03159,Göttingen,115,1,114,328074,187
DE-NI,29-03-2020,RKI,26,21,5,1585440000000,03159,Göttingen,141,6,135,328074,187
DE-NI,30-03-2020,RKI,11,10,1,1585526400000,03159,Göttingen,152,7,145,328074,187
DE-NI,31-03-2020,RKI,10,9,1,1585612800000,03159,Göttingen,162,8,154,328074,187
DE-NI,01-04-2020,RKI,22,19,3,1585699200000,03159,Göttingen,184,11,173,328074,187
DE-NI,02-04-2020,RKI,19,17,2,1585785600000,03159,Göttingen,203,13,190,328074,187
DE-NI,03-04-2020,RKI,22,19,3,1585872000000,03159,Göttingen,225,16,209,328074,187
DE-NI,04-04-2020,RKI,12,7,5,1585958400000,03159,Göttingen,237,21,216,328074,187
DE-NI,05-04-2020,RKI,23,20,3,1586044800000,03159,Göttingen,260,24,236,328074,187
DE-NI,06-04-2020,RKI,8,8,0,1586131200000,03159,Göttingen,268,24,244,328074,187
DE-NI,07-04-2020,RKI,19,18,1,1586217600000,03159,Göttingen,287,25,262,328074,187
DE-NI,08-04-2020,RKI,26,22,4,1586304000000,03159,Göttingen,313,29,284,328074,187
DE-NI,09-04-2020,RKI,9,9,0,1586390400000,03159,Göttingen,322,29,293,328074,187
DE-NI,10-04-2020,RKI,33,30,3,1586476800000,03159,Göttingen,355,32,323,328074,187
DE-NI,11-04-2020,RKI,10,9,1,1586563200000,03159,Göttingen,365,33,332,328074,187
DE-NI,12-04-2020,RKI,53,48,5,1586649600000,03159,Göttingen,418,38,380,328074,187
DE-NI,13-04-2020,RKI,17,15,2,1586736000000,03159,Göttingen,435,40,395,328074,187
DE-NI,14-04-2020,RKI,3,3,0,1586822400000,03159,Göttingen,438,40,398,328074,187
DE-NI,15-04-2020,RKI,48,41,7,1586908800000,03159,Göttingen,486,47,439,328074,187
DE-NI,16-04-2020,RKI,22,20,2,1586995200000,03159,Göttingen,508,49,459,328074,187
DE-NI,17-04-2020,RKI,4,4,0,1587081600000,03159,Göttingen,512,49,463,328074,187
DE-NI,18-04-2020,RKI,44,42,2,1587168000000,03159,Göttingen,556,51,505,328074,187
DE-NI,19-04-2020,RKI,3,2,1,1587254400000,03159,Göttingen,559,52,507,328074,187
DE-NI,20-04-2020,RKI,23,19,4,1587340800000,03159,Göttingen,582,56,526,328074,187
DE-NI,21-04-2020,RKI,25,23,2,1587427200000,03159,Göttingen,607,58,549,328074,187
DE-NI,22-04-2020,RKI,24,24,0,1587513600000,03159,Göttingen,631,58,573,328074,187
DE-NI,23-04-2020,RKI,21,16,5,1587600000000,03159,Göttingen,652,63,589,328074,187
DE-NI,24-04-2020,RKI,7,7,0,1587686400000,03159,Göttingen,659,63,596,328074,187
DE-NI,25-04-2020,RKI,9,7,2,1587772800000,03159,Göttingen,668,65,603,328074,187
DE-NI,26-04-2020,RKI,1,1,0,1587859200000,03159,Göttingen,669,65,604,328074,187
DE-NI,27-04-2020,RKI,10,7,3,1587945600000,03159,Göttingen,679,68,611,328074,187
DE-NI,28-04-2020,RKI,9,8,1,1588032000000,03159,Göttingen,688,69,619,328074,187
DE-NI,29-04-2020,RKI,13,12,1,1588118400000,03159,Göttingen,701,70,631,328074,187
DE-NI,30-04-2020,RKI,4,4,0,1588204800000,03159,Göttingen,705,70,635,328074,187
DE-NI,01-05-2020,RKI,4,4,0,1588291200000,03159,Göttingen,709,70,639,328074,187
DE-NI,05-05-2020,RKI,1,1,0,1588636800000,03159,Göttingen,710,70,640,328074,187
DE-NI,06-05-2020,RKI,1,0,1,1588723200000,03159,Göttingen,711,71,640,328074,187
DE-NI,08-05-2020,RKI,6,6,0,1588896000000,03159,Göttingen,717,71,646,328074,187
DE-NI,09-05-2020,RKI,3,3,0,1588982400000,03159,Göttingen,720,71,649,328074,187
DE-NI,11-05-2020,RKI,1,1,0,1589155200000,03159,Göttingen,721,71,650,328074,187
DE-NI,12-05-2020,RKI,1,0,1,1589241600000,03159,Göttingen,722,72,650,328074,187
DE-NI,13-05-2020,RKI,6,6,0,1589328000000,03159,Göttingen,728,72,656,328074,187
DE-NI,14-05-2020,RKI,0,0,0,1589414400000,03159,Göttingen,728,72,656,328074,187
DE-NI,15-05-2020,RKI,2,1,1,1589500800000,03159,Göttingen,730,73,657,328074,187
DE-NI,17-05-2020,RKI,0,0,0,1589673600000,03159,Göttingen,730,73,657,328074,187
DE-NI,18-05-2020,RKI,0,0,0,1589760000000,03159,Göttingen,730,73,657,328074,187
DE-NI,20-05-2020,RKI,3,3,0,1589932800000,03159,Göttingen,733,73,660,328074,187
DE-NI,21-05-2020,RKI,0,0,0,1590019200000,03159,Göttingen,733,73,660,328074,187
DE-NI,22-05-2020,RKI,5,5,0,1590105600000,03159,Göttingen,738,73,665,328074,187
DE-NI,23-05-2020,RKI,0,0,0,1590192000000,03159,Göttingen,738,73,665,328074,187
DE-NI,26-05-2020,RKI,0,0,0,1590451200000,03159,Göttingen,738,73,665,328074,187
DE-NI,27-05-2020,RKI,0,0,0,1590537600000,03159,Göttingen,738,73,665,328074,187
DE-NI,28-05-2020,RKI,9,8,1,1590624000000,03159,Göttingen,747,74,673,328074,187
DE-NI,30-05-2020,RKI,24,24,0,1590796800000,03159,Göttingen,771,74,697,328074,187
DE-NI,31-05-2020,RKI,2,2,0,1590883200000,03159,Göttingen,773,74,699,328074,187
DE-NI,01-06-2020,RKI,25,25,0,1590969600000,03159,Göttingen,798,74,724,328074,187
DE-NI,02-06-2020,RKI,12,12,0,1591056000000,03159,Göttingen,810,74,736,328074,187
DE-NI,03-06-2020,RKI,15,15,0,1591142400000,03159,Göttingen,825,74,751,328074,187
DE-NI,04-06-2020,RKI,17,17,0,1591228800000,03159,Göttingen,842,74,768,328074,187
DE-NI,05-06-2020,RKI,28,28,0,1591315200000,03159,Göttingen,870,74,796,328074,187
DE-NI,06-06-2020,RKI,14,14,0,1591401600000,03159,Göttingen,884,74,810,328074,187
DE-NI,07-06-2020,RKI,20,20,0,1591488000000,03159,Göttingen,904,74,830,328074,187
DE-NI,08-06-2020,RKI,1,1,0,1591574400000,03159,Göttingen,905,74,831,328074,187
DE-NI,09-06-2020,RKI,2,2,0,1591660800000,03159,Göttingen,907,74,833,328074,187
DE-NI,10-06-2020,RKI,9,9,0,1591747200000,03159,Göttingen,916,74,842,328074,187
DE-NI,11-06-2020,RKI,5,5,0,1591833600000,03159,Göttingen,921,74,847,328074,187
DE-NI,12-06-2020,RKI,10,10,0,1591920000000,03159,Göttingen,931,74,857,328074,187
DE-NI,13-06-2020,RKI,5,5,0,1592006400000,03159,Göttingen,936,74,862,328074,187
DE-NI,14-06-2020,RKI,5,5,0,1592092800000,03159,Göttingen,941,74,867,328074,187
DE-NI,15-06-2020,RKI,6,6,0,1592179200000,03159,Göttingen,947,74,873,328074,187
DE-NI,16-06-2020,RKI,5,5,0,1592265600000,03159,Göttingen,952,74,878,328074,187
DE-NI,17-06-2020,RKI,12,12,0,1592352000000,03159,Göttingen,964,74,890,328074,187
DE-NI,18-06-2020,RKI,52,52,0,1592438400000,03159,Göttingen,1016,74,942,328074,187
DE-NI,19-06-2020,RKI,38,38,0,1592524800000,03159,Göttingen,1054,74,980,328074,187
DE-NI,20-06-2020,RKI,28,27,0,1592611200000,03159,Göttingen,1082,74,1007,328074,187
DE-NI,21-06-2020,RKI,7,7,0,1592697600000,03159,Göttingen,1089,74,1014,328074,187
DE-NI,22-06-2020,RKI,4,3,0,1592784000000,03159,Göttingen,1093,74,1017,328074,187
DE-NI,23-06-2020,RKI,19,19,0,1592870400000,03159,Göttingen,1112,74,1036,328074,187
DE-NI,24-06-2020,RKI,5,5,0,1592956800000,03159,Göttingen,1117,74,1041,328074,187
DE-NI,26-06-2020,RKI,4,1,2,1593129600000,03159,Göttingen,1121,76,1042,328074,187
DE-NI,27-06-2020,RKI,19,14,0,1593216000000,03159,Göttingen,1140,76,1056,328074,187
DE-NI,28-06-2020,RKI,2,0,0,1593302400000,03159,Göttingen,1142,76,1056,328074,187
DE-NI,29-06-2020,RKI,5,3,1,1593388800000,03159,Göttingen,1147,77,1059,328074,187
DE-NI,30-06-2020,RKI,1,1,0,1593475200000,03159,Göttingen,1148,77,1060,328074,187
DE-NI,01-07-2020,RKI,6,5,0,1593561600000,03159,Göttingen,1154,77,1065,328074,187
DE-NI,04-07-2020,RKI,3,0,0,1593820800000,03159,Göttingen,1157,77,1065,328074,187
DE-NI,05-07-2020,RKI,14,3,0,1593907200000,03159,Göttingen,1171,77,1068,328074,187
DE-NI,08-07-2020,RKI,1,0,0,1594166400000,03159,Göttingen,1172,77,1068,328074,187
DE-NI,12-07-2020,RKI,0,0,0,1594512000000,03159,Göttingen,1172,77,1068,328074,187
DE-NI,14-07-2020,RKI,0,0,0,1594684800000,03159,Göttingen,1172,77,1068,328074,187
DE-NI,15-07-2020,RKI,0,0,0,1594771200000,03159,Göttingen,1172,77,1068,328074,187
DE-NI,03-03-2020,RKI,0,0,0,1583193600000,03241,Region Hannover,0,0,0,1157624,505
DE-NI,04-03-2020,RKI,0,0,0,1583280000000,03241,Region Hannover,0,0,0,1157624,505
DE-NI,06-03-2020,RKI,1,1,0,1583452800000,03241,Region Hannover,1,0,1,1157624,505
DE-NI,07-03-2020,RKI,0,0,0,1583539200000,03241,Region Hannover,1,0,1,1157624,505
DE-NI,08-03-2020,RKI,1,1,0,1583625600000,03241,Region Hannover,2,0,2,1157624,505
DE-NI,09-03-2020,RKI,0,0,0,1583712000000,03241,Region Hannover,2,0,2,1157624,505
DE-NI,10-03-2020,RKI,5,5,0,1583798400000,03241,Region Hannover,7,0,7,1157624,505
DE-NI,11-03-2020,RKI,10,10,0,1583884800000,03241,Region Hannover,17,0,17,1157624,505
DE-NI,12-03-2020,RKI,23,23,0,1583971200000,03241,Region Hannover,40,0,40,1157624,505
DE-NI,13-03-2020,RKI,9,9,0,1584057600000,03241,Region Hannover,49,0,49,1157624,505
DE-NI,14-03-2020,RKI,16,16,0,1584144000000,03241,Region Hannover,65,0,65,1157624,505
DE-NI,15-03-2020,RKI,18,18,0,1584230400000,03241,Region Hannover,83,0,83,1157624,505
DE-NI,16-03-2020,RKI,23,23,0,1584316800000,03241,Region Hannover,106,0,106,1157624,505
DE-NI,17-03-2020,RKI,32,32,0,1584403200000,03241,Region Hannover,138,0,138,1157624,505
DE-NI,18-03-2020,RKI,71,71,0,1584489600000,03241,Region Hannover,209,0,209,1157624,505
DE-NI,19-03-2020,RKI,58,58,0,1584576000000,03241,Region Hannover,267,0,267,1157624,505
DE-NI,20-03-2020,RKI,60,56,4,1584662400000,03241,Region Hannover,327,4,323,1157624,505
DE-NI,21-03-2020,RKI,29,27,2,1584748800000,03241,Region Hannover,356,6,350,1157624,505
DE-NI,22-03-2020,RKI,4,4,0,1584835200000,03241,Region Hannover,360,6,354,1157624,505
DE-NI,23-03-2020,RKI,39,37,2,1584921600000,03241,Region Hannover,399,8,391,1157624,505
DE-NI,24-03-2020,RKI,69,68,1,1585008000000,03241,Region Hannover,468,9,459,1157624,505
DE-NI,25-03-2020,RKI,100,98,2,1585094400000,03241,Region Hannover,568,11,557,1157624,505
DE-NI,26-03-2020,RKI,83,82,1,1585180800000,03241,Region Hannover,651,12,639,1157624,505
DE-NI,27-03-2020,RKI,51,50,1,1585267200000,03241,Region Hannover,702,13,689,1157624,505
DE-NI,28-03-2020,RKI,46,45,1,1585353600000,03241,Region Hannover,748,14,734,1157624,505
DE-NI,29-03-2020,RKI,48,46,2,1585440000000,03241,Region Hannover,796,16,780,1157624,505
DE-NI,30-03-2020,RKI,60,59,1,1585526400000,03241,Region Hannover,856,17,839,1157624,505
DE-NI,31-03-2020,RKI,44,39,5,1585612800000,03241,Region Hannover,900,22,878,1157624,505
DE-NI,01-04-2020,RKI,79,75,4,1585699200000,03241,Region Hannover,979,26,953,1157624,505
DE-NI,02-04-2020,RKI,50,46,4,1585785600000,03241,Region Hannover,1029,30,999,1157624,505
DE-NI,03-04-2020,RKI,56,51,5,1585872000000,03241,Region Hannover,1085,35,1050,1157624,505
DE-NI,04-04-2020,RKI,29,26,3,1585958400000,03241,Region Hannover,1114,38,1076,1157624,505
DE-NI,05-04-2020,RKI,22,22,0,1586044800000,03241,Region Hannover,1136,38,1098,1157624,505
DE-NI,06-04-2020,RKI,38,31,7,1586131200000,03241,Region Hannover,1174,45,1129,1157624,505
DE-NI,07-04-2020,RKI,76,75,1,1586217600000,03241,Region Hannover,1250,46,1204,1157624,505
DE-NI,08-04-2020,RKI,78,73,5,1586304000000,03241,Region Hannover,1328,51,1277,1157624,505
DE-NI,09-04-2020,RKI,73,66,7,1586390400000,03241,Region Hannover,1401,58,1343,1157624,505
DE-NI,10-04-2020,RKI,23,23,0,1586476800000,03241,Region Hannover,1424,58,1366,1157624,505
DE-NI,11-04-2020,RKI,19,18,1,1586563200000,03241,Region Hannover,1443,59,1384,1157624,505
DE-NI,12-04-2020,RKI,22,19,3,1586649600000,03241,Region Hannover,1465,62,1403,1157624,505
DE-NI,13-04-2020,RKI,8,6,2,1586736000000,03241,Region Hannover,1473,64,1409,1157624,505
DE-NI,14-04-2020,RKI,41,35,6,1586822400000,03241,Region Hannover,1514,70,1444,1157624,505
DE-NI,15-04-2020,RKI,23,21,2,1586908800000,03241,Region Hannover,1537,72,1465,1157624,505
DE-NI,16-04-2020,RKI,47,45,2,1586995200000,03241,Region Hannover,1584,74,1510,1157624,505
DE-NI,17-04-2020,RKI,51,46,5,1587081600000,03241,Region Hannover,1635,79,1556,1157624,505
DE-NI,18-04-2020,RKI,30,27,3,1587168000000,03241,Region Hannover,1665,82,1583,1157624,505
DE-NI,19-04-2020,RKI,12,10,2,1587254400000,03241,Region Hannover,1677,84,1593,1157624,505
DE-NI,20-04-2020,RKI,12,11,1,1587340800000,03241,Region Hannover,1689,85,1604,1157624,505
DE-NI,21-04-2020,RKI,36,32,4,1587427200000,03241,Region Hannover,1725,89,1636,1157624,505
DE-NI,22-04-2020,RKI,28,26,2,1587513600000,03241,Region Hannover,1753,91,1662,1157624,505
DE-NI,23-04-2020,RKI,29,27,2,1587600000000,03241,Region Hannover,1782,93,1689,1157624,505
DE-NI,24-04-2020,RKI,26,25,1,1587686400000,03241,Region Hannover,1808,94,1714,1157624,505
DE-NI,25-04-2020,RKI,25,24,1,1587772800000,03241,Region Hannover,1833,95,1738,1157624,505
DE-NI,26-04-2020,RKI,25,25,0,1587859200000,03241,Region Hannover,1858,95,1763,1157624,505
DE-NI,27-04-2020,RKI,1,0,1,1587945600000,03241,Region Hannover,1859,96,1763,1157624,505
DE-NI,28-04-2020,RKI,26,24,2,1588032000000,03241,Region Hannover,1885,98,1787,1157624,505
DE-NI,29-04-2020,RKI,17,15,2,1588118400000,03241,Region Hannover,1902,100,1802,1157624,505
DE-NI,30-04-2020,RKI,33,32,1,1588204800000,03241,Region Hannover,1935,101,1834,1157624,505
DE-NI,01-05-2020,RKI,11,11,0,1588291200000,03241,Region Hannover,1946,101,1845,1157624,505
DE-NI,02-05-2020,RKI,11,11,0,1588377600000,03241,Region Hannover,1957,101,1856,1157624,505
DE-NI,03-05-2020,RKI,10,10,0,1588464000000,03241,Region Hannover,1967,101,1866,1157624,505
DE-NI,04-05-2020,RKI,8,7,1,1588550400000,03241,Region Hannover,1975,102,1873,1157624,505
DE-NI,05-05-2020,RKI,18,16,2,1588636800000,03241,Region Hannover,1993,104,1889,1157624,505
DE-NI,06-05-2020,RKI,18,18,0,1588723200000,03241,Region Hannover,2011,104,1907,1157624,505
DE-NI,07-05-2020,RKI,33,32,1,1588809600000,03241,Region Hannover,2044,105,1939,1157624,505
DE-NI,08-05-2020,RKI,9,9,0,1588896000000,03241,Region Hannover,2053,105,1948,1157624,505
DE-NI,09-05-2020,RKI,8,7,1,1588982400000,03241,Region Hannover,2061,106,1955,1157624,505
DE-NI,10-05-2020,RKI,6,5,1,1589068800000,03241,Region Hannover,2067,107,1960,1157624,505
DE-NI,11-05-2020,RKI,4,4,0,1589155200000,03241,Region Hannover,2071,107,1964,1157624,505
DE-NI,12-05-2020,RKI,23,22,1,1589241600000,03241,Region Hannover,2094,108,1986,1157624,505
DE-NI,13-05-2020,RKI,18,17,1,1589328000000,03241,Region Hannover,2112,109,2003,1157624,505
DE-NI,14-05-2020,RKI,6,6,0,1589414400000,03241,Region Hannover,2118,109,2009,1157624,505
DE-NI,15-05-2020,RKI,4,4,0,1589500800000,03241,Region Hannover,2122,109,2013,1157624,505
DE-NI,16-05-2020,RKI,4,4,0,1589587200000,03241,Region Hannover,2126,109,2017,1157624,505
DE-NI,17-05-2020,RKI,4,3,1,1589673600000,03241,Region Hannover,2130,110,2020,1157624,505
DE-NI,18-05-2020,RKI,2,2,0,1589760000000,03241,Region Hannover,2132,110,2022,1157624,505
DE-NI,19-05-2020,RKI,11,9,2,1589846400000,03241,Region Hannover,2143,112,2031,1157624,505
DE-NI,20-05-2020,RKI,25,25,0,1589932800000,03241,Region Hannover,2168,112,2056,1157624,505
DE-NI,21-05-2020,RKI,15,15,0,1590019200000,03241,Region Hannover,2183,112,2071,1157624,505
DE-NI,22-05-2020,RKI,5,4,1,1590105600000,03241,Region Hannover,2188,113,2075,1157624,505
DE-NI,23-05-2020,RKI,10,9,1,1590192000000,03241,Region Hannover,2198,114,2084,1157624,505
DE-NI,24-05-2020,RKI,1,1,0,1590278400000,03241,Region Hannover,2199,114,2085,1157624,505
DE-NI,25-05-2020,RKI,8,8,0,1590364800000,03241,Region Hannover,2207,114,2093,1157624,505
DE-NI,26-05-2020,RKI,19,19,0,1590451200000,03241,Region Hannover,2226,114,2112,1157624,505
DE-NI,27-05-2020,RKI,59,59,0,1590537600000,03241,Region Hannover,2285,114,2171,1157624,505
DE-NI,28-05-2020,RKI,33,33,0,1590624000000,03241,Region Hannover,2318,114,2204,1157624,505
DE-NI,29-05-2020,RKI,18,18,0,1590710400000,03241,Region Hannover,2336,114,2222,1157624,505
DE-NI,30-05-2020,RKI,17,17,0,1590796800000,03241,Region Hannover,2353,114,2239,1157624,505
DE-NI,31-05-2020,RKI,14,14,0,1590883200000,03241,Region Hannover,2367,114,2253,1157624,505
DE-NI,01-06-2020,RKI,0,0,0,1590969600000,03241,Region Hannover,2367,114,2253,1157624,505
DE-NI,02-06-2020,RKI,17,17,0,1591056000000,03241,Region Hannover,2384,114,2270,1157624,505
DE-NI,03-06-2020,RKI,36,35,1,1591142400000,03241,Region Hannover,2420,115,2305,1157624,505
DE-NI,04-06-2020,RKI,28,28,0,1591228800000,03241,Region Hannover,2448,115,2333,1157624,505
DE-NI,05-06-2020,RKI,14,14,0,1591315200000,03241,Region Hannover,2462,115,2347,1157624,505
DE-NI,06-06-2020,RKI,19,19,0,1591401600000,03241,Region Hannover,2481,115,2366,1157624,505
DE-NI,07-06-2020,RKI,3,3,0,1591488000000,03241,Region Hannover,2484,115,2369,1157624,505
DE-NI,08-06-2020,RKI,19,19,0,1591574400000,03241,Region Hannover,2503,115,2388,1157624,505
DE-NI,09-06-2020,RKI,33,33,0,1591660800000,03241,Region Hannover,2536,115,2421,1157624,505
DE-NI,10-06-2020,RKI,19,19,0,1591747200000,03241,Region Hannover,2555,115,2440,1157624,505
DE-NI,11-06-2020,RKI,20,20,0,1591833600000,03241,Region Hannover,2575,115,2460,1157624,505
DE-NI,12-06-2020,RKI,11,11,0,1591920000000,03241,Region Hannover,2586,115,2471,1157624,505
DE-NI,13-06-2020,RKI,4,4,0,1592006400000,03241,Region Hannover,2590,115,2475,1157624,505
DE-NI,14-06-2020,RKI,1,1,0,1592092800000,03241,Region Hannover,2591,115,2476,1157624,505
DE-NI,15-06-2020,RKI,10,10,0,1592179200000,03241,Region Hannover,2601,115,2486,1157624,505
DE-NI,16-06-2020,RKI,19,19,0,1592265600000,03241,Region Hannover,2620,115,2505,1157624,505
DE-NI,17-06-2020,RKI,8,7,1,1592352000000,03241,Region Hannover,2628,116,2512,1157624,505
DE-NI,18-06-2020,RKI,9,9,0,1592438400000,03241,Region Hannover,2637,116,2521,1157624,505
DE-NI,19-06-2020,RKI,14,14,0,1592524800000,03241,Region Hannover,2651,116,2535,1157624,505
DE-NI,20-06-2020,RKI,4,2,0,1592611200000,03241,Region Hannover,2655,116,2537,1157624,505
DE-NI,21-06-2020,RKI,2,1,0,1592697600000,03241,Region Hannover,2657,116,2538,1157624,505
DE-NI,22-06-2020,RKI,3,2,0,1592784000000,03241,Region Hannover,2660,116,2540,1157624,505
DE-NI,23-06-2020,RKI,7,2,0,1592870400000,03241,Region Hannover,2667,116,2542,1157624,505
DE-NI,24-06-2020,RKI,5,0,0,1592956800000,03241,Region Hannover,2672,116,2542,1157624,505
DE-NI,25-06-2020,RKI,2,1,0,1593043200000,03241,Region Hannover,2674,116,2543,1157624,505
DE-NI,26-06-2020,RKI,1,0,0,1593129600000,03241,Region Hannover,2675,116,2543,1157624,505
DE-NI,28-06-2020,RKI,1,0,0,1593302400000,03241,Region Hannover,2676,116,2543,1157624,505
DE-NI,29-06-2020,RKI,1,1,0,1593388800000,03241,Region Hannover,2677,116,2544,1157624,505
DE-NI,30-06-2020,RKI,5,0,0,1593475200000,03241,Region Hannover,2682,116,2544,1157624,505
DE-NI,01-07-2020,RKI,4,0,0,1593561600000,03241,Region Hannover,2686,116,2544,1157624,505
DE-NI,02-07-2020,RKI,1,0,0,1593648000000,03241,Region Hannover,2687,116,2544,1157624,505
DE-NI,03-07-2020,RKI,0,0,0,1593734400000,03241,Region Hannover,2687,116,2544,1157624,505
DE-NI,07-07-2020,RKI,0,0,0,1594080000000,03241,Region Hannover,2687,116,2544,1157624,505
DE-NI,08-07-2020,RKI,1,0,0,1594166400000,03241,Region Hannover,2688,116,2544,1157624,505
DE-NI,09-07-2020,RKI,1,0,0,1594252800000,03241,Region Hannover,2689,116,2544,1157624,505
DE-NI,10-07-2020,RKI,1,0,0,1594339200000,03241,Region Hannover,2690,116,2544,1157624,505
DE-NI,14-07-2020,RKI,1,0,0,1594684800000,03241,Region Hannover,2691,116,2544,1157624,505
DE-NI,11-03-2020,RKI,9,9,0,1583884800000,03251,Diepholz,9,0,9,216886,109
DE-NI,12-03-2020,RKI,3,3,0,1583971200000,03251,Diepholz,12,0,12,216886,109
DE-NI,13-03-2020,RKI,2,2,0,1584057600000,03251,Diepholz,14,0,14,216886,109
DE-NI,15-03-2020,RKI,2,2,0,1584230400000,03251,Diepholz,16,0,16,216886,109
DE-NI,16-03-2020,RKI,1,1,0,1584316800000,03251,Diepholz,17,0,17,216886,109
DE-NI,18-03-2020,RKI,5,5,0,1584489600000,03251,Diepholz,22,0,22,216886,109
DE-NI,19-03-2020,RKI,6,6,0,1584576000000,03251,Diepholz,28,0,28,216886,109
DE-NI,20-03-2020,RKI,18,18,0,1584662400000,03251,Diepholz,46,0,46,216886,109
DE-NI,22-03-2020,RKI,4,4,0,1584835200000,03251,Diepholz,50,0,50,216886,109
DE-NI,23-03-2020,RKI,12,12,0,1584921600000,03251,Diepholz,62,0,62,216886,109
DE-NI,24-03-2020,RKI,10,10,0,1585008000000,03251,Diepholz,72,0,72,216886,109
DE-NI,25-03-2020,RKI,1,0,1,1585094400000,03251,Diepholz,73,1,72,216886,109
DE-NI,26-03-2020,RKI,6,5,1,1585180800000,03251,Diepholz,79,2,77,216886,109
DE-NI,27-03-2020,RKI,6,5,1,1585267200000,03251,Diepholz,85,3,82,216886,109
DE-NI,28-03-2020,RKI,2,2,0,1585353600000,03251,Diepholz,87,3,84,216886,109
DE-NI,29-03-2020,RKI,1,1,0,1585440000000,03251,Diepholz,88,3,85,216886,109
DE-NI,30-03-2020,RKI,7,7,0,1585526400000,03251,Diepholz,95,3,92,216886,109
DE-NI,31-03-2020,RKI,4,4,0,1585612800000,03251,Diepholz,99,3,96,216886,109
DE-NI,01-04-2020,RKI,7,5,2,1585699200000,03251,Diepholz,106,5,101,216886,109
DE-NI,02-04-2020,RKI,13,13,0,1585785600000,03251,Diepholz,119,5,114,216886,109
DE-NI,03-04-2020,RKI,4,4,0,1585872000000,03251,Diepholz,123,5,118,216886,109
DE-NI,04-04-2020,RKI,1,1,0,1585958400000,03251,Diepholz,124,5,119,216886,109
DE-NI,05-04-2020,RKI,0,0,0,1586044800000,03251,Diepholz,124,5,119,216886,109
DE-NI,06-04-2020,RKI,3,3,0,1586131200000,03251,Diepholz,127,5,122,216886,109
DE-NI,07-04-2020,RKI,1,1,0,1586217600000,03251,Diepholz,128,5,123,216886,109
DE-NI,08-04-2020,RKI,7,7,0,1586304000000,03251,Diepholz,135,5,130,216886,109
DE-NI,09-04-2020,RKI,8,8,0,1586390400000,03251,Diepholz,143,5,138,216886,109
DE-NI,10-04-2020,RKI,0,0,0,1586476800000,03251,Diepholz,143,5,138,216886,109
DE-NI,11-04-2020,RKI,0,0,0,1586563200000,03251,Diepholz,143,5,138,216886,109
DE-NI,12-04-2020,RKI,1,1,0,1586649600000,03251,Diepholz,144,5,139,216886,109
DE-NI,13-04-2020,RKI,0,0,0,1586736000000,03251,Diepholz,144,5,139,216886,109
DE-NI,14-04-2020,RKI,4,4,0,1586822400000,03251,Diepholz,148,5,143,216886,109
DE-NI,15-04-2020,RKI,4,4,0,1586908800000,03251,Diepholz,152,5,147,216886,109
DE-NI,16-04-2020,RKI,3,3,0,1586995200000,03251,Diepholz,155,5,150,216886,109
DE-NI,17-04-2020,RKI,2,2,0,1587081600000,03251,Diepholz,157,5,152,216886,109
DE-NI,18-04-2020,RKI,3,3,0,1587168000000,03251,Diepholz,160,5,155,216886,109
DE-NI,19-04-2020,RKI,3,3,0,1587254400000,03251,Diepholz,163,5,158,216886,109
DE-NI,20-04-2020,RKI,2,2,0,1587340800000,03251,Diepholz,165,5,160,216886,109
DE-NI,21-04-2020,RKI,1,1,0,1587427200000,03251,Diepholz,166,5,161,216886,109
DE-NI,23-04-2020,RKI,1,1,0,1587600000000,03251,Diepholz,167,5,162,216886,109
DE-NI,24-04-2020,RKI,2,2,0,1587686400000,03251,Diepholz,169,5,164,216886,109
DE-NI,26-04-2020,RKI,0,0,0,1587859200000,03251,Diepholz,169,5,164,216886,109
DE-NI,27-04-2020,RKI,1,1,0,1587945600000,03251,Diepholz,170,5,165,216886,109
DE-NI,28-04-2020,RKI,0,0,0,1588032000000,03251,Diepholz,170,5,165,216886,109
DE-NI,30-04-2020,RKI,3,3,0,1588204800000,03251,Diepholz,173,5,168,216886,109
DE-NI,01-05-2020,RKI,0,0,0,1588291200000,03251,Diepholz,173,5,168,216886,109
DE-NI,02-05-2020,RKI,1,1,0,1588377600000,03251,Diepholz,174,5,169,216886,109
DE-NI,04-05-2020,RKI,1,1,0,1588550400000,03251,Diepholz,175,5,170,216886,109
DE-NI,05-05-2020,RKI,2,2,0,1588636800000,03251,Diepholz,177,5,172,216886,109
DE-NI,06-05-2020,RKI,5,5,0,1588723200000,03251,Diepholz,182,5,177,216886,109
DE-NI,08-05-2020,RKI,1,1,0,1588896000000,03251,Diepholz,183,5,178,216886,109
DE-NI,11-05-2020,RKI,1,1,0,1589155200000,03251,Diepholz,184,5,179,216886,109
DE-NI,13-05-2020,RKI,1,1,0,1589328000000,03251,Diepholz,185,5,180,216886,109
DE-NI,19-05-2020,RKI,0,0,0,1589846400000,03251,Diepholz,185,5,180,216886,109
DE-NI,20-05-2020,RKI,0,0,0,1589932800000,03251,Diepholz,185,5,180,216886,109
DE-NI,22-05-2020,RKI,0,0,0,1590105600000,03251,Diepholz,185,5,180,216886,109
DE-NI,25-05-2020,RKI,0,0,0,1590364800000,03251,Diepholz,185,5,180,216886,109
DE-NI,29-05-2020,RKI,0,0,0,1590710400000,03251,Diepholz,185,5,180,216886,109
DE-NI,02-06-2020,RKI,1,1,0,1591056000000,03251,Diepholz,186,5,181,216886,109
DE-NI,03-06-2020,RKI,1,1,0,1591142400000,03251,Diepholz,187,5,182,216886,109
DE-NI,05-06-2020,RKI,0,0,0,1591315200000,03251,Diepholz,187,5,182,216886,109
DE-NI,08-06-2020,RKI,0,0,0,1591574400000,03251,Diepholz,187,5,182,216886,109
DE-NI,12-06-2020,RKI,0,0,0,1591920000000,03251,Diepholz,187,5,182,216886,109
DE-NI,15-06-2020,RKI,5,5,0,1592179200000,03251,Diepholz,192,5,187,216886,109
DE-NI,17-06-2020,RKI,0,0,0,1592352000000,03251,Diepholz,192,5,187,216886,109
DE-NI,22-06-2020,RKI,0,0,0,1592784000000,03251,Diepholz,192,5,187,216886,109
DE-NI,24-06-2020,RKI,6,6,0,1592956800000,03251,Diepholz,198,5,193,216886,109
DE-NI,25-06-2020,RKI,0,0,0,1593043200000,03251,Diepholz,198,5,193,216886,109
DE-NI,29-06-2020,RKI,1,1,0,1593388800000,03251,Diepholz,199,5,194,216886,109
DE-NI,30-06-2020,RKI,0,0,0,1593475200000,03251,Diepholz,199,5,194,216886,109
DE-NI,01-07-2020,RKI,0,0,0,1593561600000,03251,Diepholz,199,5,194,216886,109
DE-NI,02-07-2020,RKI,0,0,0,1593648000000,03251,Diepholz,199,5,194,216886,109
DE-NI,03-07-2020,RKI,2,2,0,1593734400000,03251,Diepholz,201,5,196,216886,109
DE-NI,06-07-2020,RKI,4,0,0,1593993600000,03251,Diepholz,205,5,196,216886,109
DE-NI,08-07-2020,RKI,0,0,0,1594166400000,03251,Diepholz,205,5,196,216886,109
DE-NI,09-07-2020,RKI,0,0,0,1594252800000,03251,Diepholz,205,5,196,216886,109
DE-NI,10-07-2020,RKI,0,0,0,1594339200000,03251,Diepholz,205,5,196,216886,109
DE-NI,13-07-2020,RKI,3,0,0,1594598400000,03251,Diepholz,208,5,196,216886,109
DE-NI,14-07-2020,RKI,0,0,0,1594684800000,03251,Diepholz,208,5,196,216886,109
DE-NI,15-07-2020,RKI,1,0,0,1594771200000,03251,Diepholz,209,5,196,216886,109
DE-NI,16-07-2020,RKI,0,0,0,1594857600000,03251,Diepholz,209,5,196,216886,109
DE-NW,06-03-2020,RKI,0,0,0,1583452800000,05111,Düsseldorf,1,0,1,619294,2848
DE-NW,09-03-2020,RKI,1,1,0,1583712000000,05111,Düsseldorf,2,0,2,619294,2848
DE-NW,10-03-2020,RKI,0,0,0,1583798400000,05111,Düsseldorf,2,0,2,619294,2848
DE-NW,11-03-2020,RKI,0,0,0,1583884800000,05111,Düsseldorf,2,0,2,619294,2848
DE-NW,13-03-2020,RKI,16,16,0,1584057600000,05111,Düsseldorf,18,0,18,619294,2848
DE-NW,16-03-2020,RKI,41,41,0,1584316800000,05111,Düsseldorf,59,0,59,619294,2848
DE-NW,17-03-2020,RKI,59,59,0,1584403200000,05111,Düsseldorf,118,0,118,619294,2848
DE-NW,18-03-2020,RKI,35,35,0,1584489600000,05111,Düsseldorf,153,0,153,619294,2848
DE-NW,19-03-2020,RKI,21,21,0,1584576000000,05111,Düsseldorf,174,0,174,619294,2848
DE-NW,20-03-2020,RKI,16,15,1,1584662400000,05111,Düsseldorf,190,1,189,619294,2848
DE-NW,23-03-2020,RKI,45,42,3,1584921600000,05111,Düsseldorf,235,4,231,619294,2848
DE-NW,24-03-2020,RKI,21,20,1,1585008000000,05111,Düsseldorf,256,5,251,619294,2848
DE-NW,25-03-2020,RKI,18,16,2,1585094400000,05111,Düsseldorf,274,7,267,619294,2848
DE-NW,26-03-2020,RKI,26,25,1,1585180800000,05111,Düsseldorf,300,8,292,619294,2848
DE-NW,27-03-2020,RKI,21,20,1,1585267200000,05111,Düsseldorf,321,9,312,619294,2848
DE-NW,28-03-2020,RKI,16,14,2,1585353600000,05111,Düsseldorf,337,11,326,619294,2848
DE-NW,29-03-2020,RKI,3,3,0,1585440000000,05111,Düsseldorf,340,11,329,619294,2848
DE-NW,30-03-2020,RKI,53,49,4,1585526400000,05111,Düsseldorf,393,15,378,619294,2848
DE-NW,31-03-2020,RKI,45,44,1,1585612800000,05111,Düsseldorf,438,16,422,619294,2848
DE-NW,01-04-2020,RKI,28,27,1,1585699200000,05111,Düsseldorf,466,17,449,619294,2848
DE-NW,02-04-2020,RKI,45,44,1,1585785600000,05111,Düsseldorf,511,18,493,619294,2848
DE-NW,03-04-2020,RKI,30,30,0,1585872000000,05111,Düsseldorf,541,18,523,619294,2848
DE-NW,04-04-2020,RKI,7,7,0,1585958400000,05111,Düsseldorf,548,18,530,619294,2848
DE-NW,05-04-2020,RKI,9,8,1,1586044800000,05111,Düsseldorf,557,19,538,619294,2848
DE-NW,06-04-2020,RKI,52,50,2,1586131200000,05111,Düsseldorf,609,21,588,619294,2848
DE-NW,07-04-2020,RKI,24,23,1,1586217600000,05111,Düsseldorf,633,22,611,619294,2848
DE-NW,08-04-2020,RKI,44,43,1,1586304000000,05111,Düsseldorf,677,23,654,619294,2848
DE-NW,09-04-2020,RKI,23,21,2,1586390400000,05111,Düsseldorf,700,25,675,619294,2848
DE-NW,10-04-2020,RKI,3,3,0,1586476800000,05111,Düsseldorf,703,25,678,619294,2848
DE-NW,11-04-2020,RKI,8,8,0,1586563200000,05111,Düsseldorf,711,25,686,619294,2848
DE-NW,12-04-2020,RKI,10,9,1,1586649600000,05111,Düsseldorf,721,26,695,619294,2848
DE-NW,13-04-2020,RKI,12,12,0,1586736000000,05111,Düsseldorf,733,26,707,619294,2848
DE-NW,14-04-2020,RKI,24,24,0,1586822400000,05111,Düsseldorf,757,26,731,619294,2848
DE-NW,15-04-2020,RKI,31,30,1,1586908800000,05111,Düsseldorf,788,27,761,619294,2848
DE-NW,16-04-2020,RKI,15,15,0,1586995200000,05111,Düsseldorf,803,27,776,619294,2848
DE-NW,17-04-2020,RKI,18,18,0,1587081600000,05111,Düsseldorf,821,27,794,619294,2848
DE-NW,18-04-2020,RKI,9,9,0,1587168000000,05111,Düsseldorf,830,27,803,619294,2848
DE-NW,19-04-2020,RKI,21,21,0,1587254400000,05111,Düsseldorf,851,27,824,619294,2848
DE-NW,20-04-2020,RKI,16,15,1,1587340800000,05111,Düsseldorf,867,28,839,619294,2848
DE-NW,21-04-2020,RKI,11,10,1,1587427200000,05111,Düsseldorf,878,29,849,619294,2848
DE-NW,22-04-2020,RKI,8,8,0,1587513600000,05111,Düsseldorf,886,29,857,619294,2848
DE-NW,23-04-2020,RKI,8,8,0,1587600000000,05111,Düsseldorf,894,29,865,619294,2848
DE-NW,24-04-2020,RKI,6,6,0,1587686400000,05111,Düsseldorf,900,29,871,619294,2848
DE-NW,25-04-2020,RKI,3,3,0,1587772800000,05111,Düsseldorf,903,29,874,619294,2848
DE-NW,26-04-2020,RKI,9,9,0,1587859200000,05111,Düsseldorf,912,29,883,619294,2848
DE-NW,27-04-2020,RKI,22,22,0,1587945600000,05111,Düsseldorf,934,29,905,619294,2848
DE-NW,28-04-2020,RKI,15,15,0,1588032000000,05111,Düsseldorf,949,29,920,619294,2848
DE-NW,29-04-2020,RKI,9,9,0,1588118400000,05111,Düsseldorf,958,29,929,619294,2848
DE-NW,30-04-2020,RKI,21,21,0,1588204800000,05111,Düsseldorf,979,29,950,619294,2848
DE-NW,01-05-2020,RKI,8,8,0,1588291200000,05111,Düsseldorf,987,29,958,619294,2848
DE-NW,02-05-2020,RKI,10,10,0,1588377600000,05111,Düsseldorf,997,29,968,619294,2848
DE-NW,03-05-2020,RKI,14,14,0,1588464000000,05111,Düsseldorf,1011,29,982,619294,2848
DE-NW,04-05-2020,RKI,1,1,0,1588550400000,05111,Düsseldorf,1012,29,983,619294,2848
DE-NW,05-05-2020,RKI,24,24,0,1588636800000,05111,Düsseldorf,1036,29,1007,619294,2848
DE-NW,06-05-2020,RKI,33,33,0,1588723200000,05111,Düsseldorf,1069,29,1040,619294,2848
DE-NW,07-05-2020,RKI,8,8,0,1588809600000,05111,Düsseldorf,1077,29,1048,619294,2848
DE-NW,08-05-2020,RKI,4,4,0,1588896000000,05111,Düsseldorf,1081,29,1052,619294,2848
DE-NW,09-05-2020,RKI,11,11,0,1588982400000,05111,Düsseldorf,1092,29,1063,619294,2848
DE-NW,10-05-2020,RKI,5,5,0,1589068800000,05111,Düsseldorf,1097,29,1068,619294,2848
DE-NW,11-05-2020,RKI,15,15,0,1589155200000,05111,Düsseldorf,1112,29,1083,619294,2848
DE-NW,12-05-2020,RKI,5,4,1,1589241600000,05111,Düsseldorf,1117,30,1087,619294,2848
DE-NW,13-05-2020,RKI,30,30,0,1589328000000,05111,Düsseldorf,1147,30,1117,619294,2848
DE-NW,14-05-2020,RKI,15,15,0,1589414400000,05111,Düsseldorf,1162,30,1132,619294,2848
DE-NW,15-05-2020,RKI,9,9,0,1589500800000,05111,Düsseldorf,1171,30,1141,619294,2848
DE-NW,16-05-2020,RKI,9,9,0,1589587200000,05111,Düsseldorf,1180,30,1150,619294,2848
DE-NW,17-05-2020,RKI,7,7,0,1589673600000,05111,Düsseldorf,1187,30,1157,619294,2848
DE-NW,18-05-2020,RKI,5,5,0,1589760000000,05111,Düsseldorf,1192,30,1162,619294,2848
DE-NW,19-05-2020,RKI,11,11,0,1589846400000,05111,Düsseldorf,1203,30,1173,619294,2848
DE-NW,20-05-2020,RKI,20,20,0,1589932800000,05111,Düsseldorf,1223,30,1193,619294,2848
DE-NW,21-05-2020,RKI,7,7,0,1590019200000,05111,Düsseldorf,1230,30,1200,619294,2848
DE-NW,22-05-2020,RKI,14,14,0,1590105600000,05111,Düsseldorf,1244,30,1214,619294,2848
DE-NW,23-05-2020,RKI,1,1,0,1590192000000,05111,Düsseldorf,1245,30,1215,619294,2848
DE-NW,24-05-2020,RKI,16,14,2,1590278400000,05111,Düsseldorf,1261,32,1229,619294,2848
DE-NW,25-05-2020,RKI,23,20,3,1590364800000,05111,Düsseldorf,1284,35,1249,619294,2848
DE-NW,26-05-2020,RKI,13,12,1,1590451200000,05111,Düsseldorf,1297,36,1261,619294,2848
DE-NW,27-05-2020,RKI,16,15,1,1590537600000,05111,Düsseldorf,1313,37,1276,619294,2848
DE-NW,28-05-2020,RKI,5,5,0,1590624000000,05111,Düsseldorf,1318,37,1281,619294,2848
DE-NW,29-05-2020,RKI,9,9,0,1590710400000,05111,Düsseldorf,1327,37,1290,619294,2848
DE-NW,30-05-2020,RKI,8,8,0,1590796800000,05111,Düsseldorf,1335,37,1298,619294,2848
DE-NW,31-05-2020,RKI,4,4,0,1590883200000,05111,Düsseldorf,1339,37,1302,619294,2848
DE-NW,01-06-2020,RKI,2,2,0,1590969600000,05111,Düsseldorf,1341,37,1304,619294,2848
DE-NW,03-06-2020,RKI,10,10,0,1591142400000,05111,Düsseldorf,1351,37,1314,619294,2848
DE-NW,04-06-2020,RKI,7,7,0,1591228800000,05111,Düsseldorf,1358,37,1321,619294,2848
DE-NW,05-06-2020,RKI,12,12,0,1591315200000,05111,Düsseldorf,1370,37,1333,619294,2848
DE-NW,06-06-2020,RKI,8,7,1,1591401600000,05111,Düsseldorf,1378,38,1340,619294,2848
DE-NW,08-06-2020,RKI,7,7,0,1591574400000,05111,Düsseldorf,1385,38,1347,619294,2848
DE-NW,09-06-2020,RKI,26,26,0,1591660800000,05111,Düsseldorf,1411,38,1373,619294,2848
DE-NW,10-06-2020,RKI,2,2,0,1591747200000,05111,Düsseldorf,1413,38,1375,619294,2848
DE-NW,11-06-2020,RKI,5,5,0,1591833600000,05111,Düsseldorf,1418,38,1380,619294,2848
DE-NW,12-06-2020,RKI,6,6,0,1591920000000,05111,Düsseldorf,1424,38,1386,619294,2848
DE-NW,14-06-2020,RKI,10,10,0,1592092800000,05111,Düsseldorf,1434,38,1396,619294,2848
DE-NW,15-06-2020,RKI,6,6,0,1592179200000,05111,Düsseldorf,1440,38,1402,619294,2848
DE-NW,16-06-2020,RKI,17,16,1,1592265600000,05111,Düsseldorf,1457,39,1418,619294,2848
DE-NW,17-06-2020,RKI,18,18,0,1592352000000,05111,Düsseldorf,1475,39,1436,619294,2848
DE-NW,18-06-2020,RKI,15,15,0,1592438400000,05111,Düsseldorf,1490,39,1451,619294,2848
DE-NW,19-06-2020,RKI,19,19,0,1592524800000,05111,Düsseldorf,1509,39,1470,619294,2848
DE-NW,20-06-2020,RKI,13,5,0,1592611200000,05111,Düsseldorf,1522,39,1475,619294,2848
DE-NW,21-06-2020,RKI,4,2,0,1592697600000,05111,Düsseldorf,1526,39,1477,619294,2848
DE-NW,22-06-2020,RKI,17,7,0,1592784000000,05111,Düsseldorf,1543,39,1484,619294,2848
DE-NW,23-06-2020,RKI,21,12,0,1592870400000,05111,Düsseldorf,1564,39,1496,619294,2848
DE-NW,24-06-2020,RKI,26,4,0,1592956800000,05111,Düsseldorf,1590,39,1500,619294,2848
DE-NW,25-06-2020,RKI,15,7,0,1593043200000,05111,Düsseldorf,1605,39,1507,619294,2848
DE-NW,26-06-2020,RKI,28,9,0,1593129600000,05111,Düsseldorf,1633,39,1516,619294,2848
DE-NW,27-06-2020,RKI,3,0,1,1593216000000,05111,Düsseldorf,1636,40,1516,619294,2848
DE-NW,28-06-2020,RKI,9,0,0,1593302400000,05111,Düsseldorf,1645,40,1516,619294,2848
DE-NW,29-06-2020,RKI,12,8,0,1593388800000,05111,Düsseldorf,1657,40,1524,619294,2848
DE-NW,30-06-2020,RKI,20,19,0,1593475200000,05111,Düsseldorf,1677,40,1543,619294,2848
DE-NW,01-07-2020,RKI,37,30,0,1593561600000,05111,Düsseldorf,1714,40,1573,619294,2848
DE-NW,02-07-2020,RKI,33,32,0,1593648000000,05111,Düsseldorf,1747,40,1605,619294,2848
DE-NW,03-07-2020,RKI,20,18,0,1593734400000,05111,Düsseldorf,1767,40,1623,619294,2848
DE-NW,04-07-2020,RKI,8,0,0,1593820800000,05111,Düsseldorf,1775,40,1623,619294,2848
DE-NW,05-07-2020,RKI,11,0,0,1593907200000,05111,Düsseldorf,1786,40,1623,619294,2848
DE-NW,06-07-2020,RKI,1,0,1,1593993600000,05111,Düsseldorf,1787,41,1623,619294,2848
DE-NW,07-07-2020,RKI,16,1,0,1594080000000,05111,Düsseldorf,1803,41,1624,619294,2848
DE-NW,08-07-2020,RKI,8,0,0,1594166400000,05111,Düsseldorf,1811,41,1624,619294,2848
DE-NW,09-07-2020,RKI,2,0,0,1594252800000,05111,Düsseldorf,1813,41,1624,619294,2848
DE-NW,10-07-2020,RKI,4,0,0,1594339200000,05111,Düsseldorf,1817,41,1624,619294,2848
DE-NW,12-07-2020,RKI,2,0,0,1594512000000,05111,Düsseldorf,1819,41,1624,619294,2848
DE-NW,13-07-2020,RKI,3,0,0,1594598400000,05111,Düsseldorf,1822,41,1624,619294,2848
DE-NW,14-07-2020,RKI,2,0,0,1594684800000,05111,Düsseldorf,1824,41,1624,619294,2848
DE-NW,15-07-2020,RKI,4,0,0,1594771200000,05111,Düsseldorf,1828,41,1624,619294,2848
DE-NW,16-07-2020,RKI,11,0,0,1594857600000,05111,Düsseldorf,1839,41,1624,619294,2848
DE-NW,04-03-2020,RKI,0,0,0,1583280000000,05112,Duisburg,0,0,0,498590,2142
DE-NW,06-03-2020,RKI,0,0,0,1583452800000,05112,Duisburg,0,0,0,498590,2142
DE-NW,10-03-2020,RKI,4,4,0,1583798400000,05112,Duisburg,4,0,4,498590,2142
DE-NW,11-03-2020,RKI,0,0,0,1583884800000,05112,Duisburg,4,0,4,498590,2142
DE-NW,12-03-2020,RKI,0,0,0,1583971200000,05112,Duisburg,4,0,4,498590,2142
DE-NW,13-03-2020,RKI,3,3,0,1584057600000,05112,Duisburg,7,0,7,498590,2142
DE-NW,16-03-2020,RKI,22,22,0,1584316800000,05112,Duisburg,29,0,29,498590,2142
DE-NW,17-03-2020,RKI,11,10,1,1584403200000,05112,Duisburg,40,1,39,498590,2142
DE-NW,18-03-2020,RKI,6,6,0,1584489600000,05112,Duisburg,46,1,45,498590,2142
DE-NW,19-03-2020,RKI,17,17,0,1584576000000,05112,Duisburg,63,1,62,498590,2142
DE-NW,20-03-2020,RKI,16,16,0,1584662400000,05112,Duisburg,79,1,78,498590,2142
DE-NW,21-03-2020,RKI,25,24,1,1584748800000,05112,Duisburg,104,2,102,498590,2142
DE-NW,22-03-2020,RKI,15,15,0,1584835200000,05112,Duisburg,119,2,117,498590,2142
DE-NW,23-03-2020,RKI,14,13,1,1584921600000,05112,Duisburg,133,3,130,498590,2142
DE-NW,24-03-2020,RKI,13,12,1,1585008000000,05112,Duisburg,146,4,142,498590,2142
DE-NW,25-03-2020,RKI,25,24,1,1585094400000,05112,Duisburg,171,5,166,498590,2142
DE-NW,26-03-2020,RKI,33,33,0,1585180800000,05112,Duisburg,204,5,199,498590,2142
DE-NW,27-03-2020,RKI,17,17,0,1585267200000,05112,Duisburg,221,5,216,498590,2142
DE-NW,28-03-2020,RKI,13,12,1,1585353600000,05112,Duisburg,234,6,228,498590,2142
DE-NW,29-03-2020,RKI,7,4,3,1585440000000,05112,Duisburg,241,9,232,498590,2142
DE-NW,30-03-2020,RKI,29,29,0,1585526400000,05112,Duisburg,270,9,261,498590,2142
DE-NW,31-03-2020,RKI,21,20,1,1585612800000,05112,Duisburg,291,10,281,498590,2142
DE-NW,01-04-2020,RKI,14,14,0,1585699200000,05112,Duisburg,305,10,295,498590,2142
DE-NW,02-04-2020,RKI,14,14,0,1585785600000,05112,Duisburg,319,10,309,498590,2142
DE-NW,03-04-2020,RKI,22,20,2,1585872000000,05112,Duisburg,341,12,329,498590,2142
DE-NW,04-04-2020,RKI,8,8,0,1585958400000,05112,Duisburg,349,12,337,498590,2142
DE-NW,05-04-2020,RKI,23,22,1,1586044800000,05112,Duisburg,372,13,359,498590,2142
DE-NW,06-04-2020,RKI,17,15,2,1586131200000,05112,Duisburg,389,15,374,498590,2142
DE-NW,07-04-2020,RKI,29,27,2,1586217600000,05112,Duisburg,418,17,401,498590,2142
DE-NW,08-04-2020,RKI,40,37,3,1586304000000,05112,Duisburg,458,20,438,498590,2142
DE-NW,09-04-2020,RKI,26,26,0,1586390400000,05112,Duisburg,484,20,464,498590,2142
DE-NW,10-04-2020,RKI,21,21,0,1586476800000,05112,Duisburg,505,20,485,498590,2142
DE-NW,11-04-2020,RKI,17,16,1,1586563200000,05112,Duisburg,522,21,501,498590,2142
DE-NW,12-04-2020,RKI,19,17,2,1586649600000,05112,Duisburg,541,23,518,498590,2142
DE-NW,13-04-2020,RKI,12,12,0,1586736000000,05112,Duisburg,553,23,530,498590,2142
DE-NW,14-04-2020,RKI,13,13,0,1586822400000,05112,Duisburg,566,23,543,498590,2142
DE-NW,15-04-2020,RKI,18,18,0,1586908800000,05112,Duisburg,584,23,561,498590,2142
DE-NW,16-04-2020,RKI,12,11,1,1586995200000,05112,Duisburg,596,24,572,498590,2142
DE-NW,17-04-2020,RKI,19,17,2,1587081600000,05112,Duisburg,615,26,589,498590,2142
DE-NW,18-04-2020,RKI,10,10,0,1587168000000,05112,Duisburg,625,26,599,498590,2142
DE-NW,19-04-2020,RKI,6,6,0,1587254400000,05112,Duisburg,631,26,605,498590,2142
DE-NW,20-04-2020,RKI,11,8,3,1587340800000,05112,Duisburg,642,29,613,498590,2142
DE-NW,21-04-2020,RKI,27,24,3,1587427200000,05112,Duisburg,669,32,637,498590,2142
DE-NW,22-04-2020,RKI,24,24,0,1587513600000,05112,Duisburg,693,32,661,498590,2142
DE-NW,23-04-2020,RKI,17,14,3,1587600000000,05112,Duisburg,710,35,675,498590,2142
DE-NW,24-04-2020,RKI,25,24,1,1587686400000,05112,Duisburg,735,36,699,498590,2142
DE-NW,25-04-2020,RKI,1,1,0,1587772800000,05112,Duisburg,736,36,700,498590,2142
DE-NW,26-04-2020,RKI,9,9,0,1587859200000,05112,Duisburg,745,36,709,498590,2142
DE-NW,27-04-2020,RKI,10,9,1,1587945600000,05112,Duisburg,755,37,718,498590,2142
DE-NW,28-04-2020,RKI,20,17,3,1588032000000,05112,Duisburg,775,40,735,498590,2142
DE-NW,29-04-2020,RKI,17,17,0,1588118400000,05112,Duisburg,792,40,752,498590,2142
DE-NW,30-04-2020,RKI,28,26,2,1588204800000,05112,Duisburg,820,42,778,498590,2142
DE-NW,01-05-2020,RKI,10,10,0,1588291200000,05112,Duisburg,830,42,788,498590,2142
DE-NW,02-05-2020,RKI,6,5,1,1588377600000,05112,Duisburg,836,43,793,498590,2142
DE-NW,03-05-2020,RKI,11,8,3,1588464000000,05112,Duisburg,847,46,801,498590,2142
DE-NW,04-05-2020,RKI,9,9,0,1588550400000,05112,Duisburg,856,46,810,498590,2142
DE-NW,05-05-2020,RKI,14,12,2,1588636800000,05112,Duisburg,870,48,822,498590,2142
DE-NW,06-05-2020,RKI,9,9,0,1588723200000,05112,Duisburg,879,48,831,498590,2142
DE-NW,07-05-2020,RKI,17,16,1,1588809600000,05112,Duisburg,896,49,847,498590,2142
DE-NW,08-05-2020,RKI,10,10,0,1588896000000,05112,Duisburg,906,49,857,498590,2142
DE-NW,09-05-2020,RKI,15,12,3,1588982400000,05112,Duisburg,921,52,869,498590,2142
DE-NW,10-05-2020,RKI,0,0,0,1589068800000,05112,Duisburg,921,52,869,498590,2142
DE-NW,11-05-2020,RKI,3,3,0,1589155200000,05112,Duisburg,924,52,872,498590,2142
DE-NW,12-05-2020,RKI,24,22,2,1589241600000,05112,Duisburg,948,54,894,498590,2142
DE-NW,13-05-2020,RKI,7,7,0,1589328000000,05112,Duisburg,955,54,901,498590,2142
DE-NW,14-05-2020,RKI,2,1,1,1589414400000,05112,Duisburg,957,55,902,498590,2142
DE-NW,15-05-2020,RKI,11,11,0,1589500800000,05112,Duisburg,968,55,913,498590,2142
DE-NW,16-05-2020,RKI,6,5,1,1589587200000,05112,Duisburg,974,56,918,498590,2142
DE-NW,17-05-2020,RKI,3,3,0,1589673600000,05112,Duisburg,977,56,921,498590,2142
DE-NW,18-05-2020,RKI,1,1,0,1589760000000,05112,Duisburg,978,56,922,498590,2142
DE-NW,19-05-2020,RKI,31,30,1,1589846400000,05112,Duisburg,1009,57,952,498590,2142
DE-NW,20-05-2020,RKI,7,7,0,1589932800000,05112,Duisburg,1016,57,959,498590,2142
DE-NW,21-05-2020,RKI,10,10,0,1590019200000,05112,Duisburg,1026,57,969,498590,2142
DE-NW,22-05-2020,RKI,6,5,1,1590105600000,05112,Duisburg,1032,58,974,498590,2142
DE-NW,23-05-2020,RKI,3,3,0,1590192000000,05112,Duisburg,1035,58,977,498590,2142
DE-NW,24-05-2020,RKI,10,10,0,1590278400000,05112,Duisburg,1045,58,987,498590,2142
DE-NW,25-05-2020,RKI,3,3,0,1590364800000,05112,Duisburg,1048,58,990,498590,2142
DE-NW,26-05-2020,RKI,2,2,0,1590451200000,05112,Duisburg,1050,58,992,498590,2142
DE-NW,27-05-2020,RKI,3,3,0,1590537600000,05112,Duisburg,1053,58,995,498590,2142
DE-NW,28-05-2020,RKI,5,5,0,1590624000000,05112,Duisburg,1058,58,1000,498590,2142
DE-NW,29-05-2020,RKI,9,9,0,1590710400000,05112,Duisburg,1067,58,1009,498590,2142
DE-NW,30-05-2020,RKI,6,6,0,1590796800000,05112,Duisburg,1073,58,1015,498590,2142
DE-NW,31-05-2020,RKI,6,6,0,1590883200000,05112,Duisburg,1079,58,1021,498590,2142
DE-NW,01-06-2020,RKI,1,1,0,1590969600000,05112,Duisburg,1080,58,1022,498590,2142
DE-NW,03-06-2020,RKI,8,8,0,1591142400000,05112,Duisburg,1088,58,1030,498590,2142
DE-NW,04-06-2020,RKI,32,32,0,1591228800000,05112,Duisburg,1120,58,1062,498590,2142
DE-NW,05-06-2020,RKI,9,9,0,1591315200000,05112,Duisburg,1129,58,1071,498590,2142
DE-NW,06-06-2020,RKI,11,11,0,1591401600000,05112,Duisburg,1140,58,1082,498590,2142
DE-NW,07-06-2020,RKI,4,4,0,1591488000000,05112,Duisburg,1144,58,1086,498590,2142
DE-NW,08-06-2020,RKI,14,14,0,1591574400000,05112,Duisburg,1158,58,1100,498590,2142
DE-NW,09-06-2020,RKI,4,4,0,1591660800000,05112,Duisburg,1162,58,1104,498590,2142
DE-NW,10-06-2020,RKI,25,25,0,1591747200000,05112,Duisburg,1187,58,1129,498590,2142
DE-NW,11-06-2020,RKI,15,15,0,1591833600000,05112,Duisburg,1202,58,1144,498590,2142
DE-NW,12-06-2020,RKI,6,6,0,1591920000000,05112,Duisburg,1208,58,1150,498590,2142
DE-NW,13-06-2020,RKI,9,9,0,1592006400000,05112,Duisburg,1217,58,1159,498590,2142
DE-NW,14-06-2020,RKI,8,7,1,1592092800000,05112,Duisburg,1225,59,1166,498590,2142
DE-NW,15-06-2020,RKI,3,2,1,1592179200000,05112,Duisburg,1228,60,1168,498590,2142
DE-NW,16-06-2020,RKI,9,8,1,1592265600000,05112,Duisburg,1237,61,1176,498590,2142
DE-NW,17-06-2020,RKI,17,17,0,1592352000000,05112,Duisburg,1254,61,1193,498590,2142
DE-NW,18-06-2020,RKI,16,16,0,1592438400000,05112,Duisburg,1270,61,1209,498590,2142
DE-NW,19-06-2020,RKI,12,12,0,1592524800000,05112,Duisburg,1282,61,1221,498590,2142
DE-NW,20-06-2020,RKI,12,12,0,1592611200000,05112,Duisburg,1294,61,1233,498590,2142
DE-NW,21-06-2020,RKI,4,3,0,1592697600000,05112,Duisburg,1298,61,1236,498590,2142
DE-NW,22-06-2020,RKI,5,5,0,1592784000000,05112,Duisburg,1303,61,1241,498590,2142
DE-NW,23-06-2020,RKI,13,12,0,1592870400000,05112,Duisburg,1316,61,1253,498590,2142
DE-NW,24-06-2020,RKI,8,8,0,1592956800000,05112,Duisburg,1324,61,1261,498590,2142
DE-NW,25-06-2020,RKI,42,42,0,1593043200000,05112,Duisburg,1366,61,1303,498590,2142
DE-NW,26-06-2020,RKI,7,6,0,1593129600000,05112,Duisburg,1373,61,1309,498590,2142
DE-NW,27-06-2020,RKI,12,10,0,1593216000000,05112,Duisburg,1385,61,1319,498590,2142
DE-NW,28-06-2020,RKI,29,25,0,1593302400000,05112,Duisburg,1414,61,1344,498590,2142
DE-NW,29-06-2020,RKI,2,2,0,1593388800000,05112,Duisburg,1416,61,1346,498590,2142
DE-NW,30-06-2020,RKI,8,6,0,1593475200000,05112,Duisburg,1424,61,1352,498590,2142
DE-NW,01-07-2020,RKI,18,17,0,1593561600000,05112,Duisburg,1442,61,1369,498590,2142
DE-NW,02-07-2020,RKI,19,18,0,1593648000000,05112,Duisburg,1461,61,1387,498590,2142
DE-NW,03-07-2020,RKI,13,11,0,1593734400000,05112,Duisburg,1474,61,1398,498590,2142
DE-NW,04-07-2020,RKI,27,11,0,1593820800000,05112,Duisburg,1501,61,1409,498590,2142
DE-NW,05-07-2020,RKI,15,6,1,1593907200000,05112,Duisburg,1516,62,1415,498590,2142
DE-NW,06-07-2020,RKI,0,0,0,1593993600000,05112,Duisburg,1516,62,1415,498590,2142
DE-NW,07-07-2020,RKI,5,1,0,1594080000000,05112,Duisburg,1521,62,1416,498590,2142
DE-NW,08-07-2020,RKI,16,5,0,1594166400000,05112,Duisburg,1537,62,1421,498590,2142
DE-NW,09-07-2020,RKI,14,4,0,1594252800000,05112,Duisburg,1551,62,1425,498590,2142
DE-NW,10-07-2020,RKI,8,1,0,1594339200000,05112,Duisburg,1559,62,1426,498590,2142
DE-NW,11-07-2020,RKI,16,2,0,1594425600000,05112,Duisburg,1575,62,1428,498590,2142
DE-NW,12-07-2020,RKI,8,0,0,1594512000000,05112,Duisburg,1583,62,1428,498590,2142
DE-NW,13-07-2020,RKI,4,0,0,1594598400000,05112,Duisburg,1587,62,1428,498590,2142
DE-NW,14-07-2020,RKI,8,1,0,1594684800000,05112,Duisburg,1595,62,1429,498590,2142
DE-NW,15-07-2020,RKI,14,0,0,1594771200000,05112,Duisburg,1609,62,1429,498590,2142
DE-NW,16-07-2020,RKI,12,0,0,1594857600000,05112,Duisburg,1621,62,1429,498590,2142
DE-NW,12-03-2020,RKI,4,4,0,1583971200000,05113,Essen,6,1,5,583109,2772
DE-NW,13-03-2020,RKI,6,6,0,1584057600000,05113,Essen,12,1,11,583109,2772
DE-NW,15-03-2020,RKI,37,37,0,1584230400000,05113,Essen,49,1,48,583109,2772
DE-NW,19-03-2020,RKI,72,72,0,1584576000000,05113,Essen,121,1,120,583109,2772
DE-NW,21-03-2020,RKI,43,41,2,1584748800000,05113,Essen,164,3,161,583109,2772
DE-NW,22-03-2020,RKI,5,4,1,1584835200000,05113,Essen,169,4,165,583109,2772
DE-NW,23-03-2020,RKI,53,50,3,1584921600000,05113,Essen,222,7,215,583109,2772
DE-NW,24-03-2020,RKI,3,3,0,1585008000000,05113,Essen,225,7,218,583109,2772
DE-NW,25-03-2020,RKI,27,25,2,1585094400000,05113,Essen,252,9,243,583109,2772
DE-NW,26-03-2020,RKI,24,20,4,1585180800000,05113,Essen,276,13,263,583109,2772
DE-NW,27-03-2020,RKI,35,34,1,1585267200000,05113,Essen,311,14,297,583109,2772
DE-NW,29-03-2020,RKI,5,4,1,1585440000000,05113,Essen,316,15,301,583109,2772
DE-NW,30-03-2020,RKI,1,1,0,1585526400000,05113,Essen,317,15,302,583109,2772
DE-NW,31-03-2020,RKI,10,10,0,1585612800000,05113,Essen,327,15,312,583109,2772
DE-NW,02-04-2020,RKI,16,16,0,1585785600000,05113,Essen,343,15,328,583109,2772
DE-NW,03-04-2020,RKI,14,12,2,1585872000000,05113,Essen,357,17,340,583109,2772
DE-NW,04-04-2020,RKI,7,6,1,1585958400000,05113,Essen,364,18,346,583109,2772
DE-NW,06-04-2020,RKI,35,31,4,1586131200000,05113,Essen,399,22,377,583109,2772
DE-NW,07-04-2020,RKI,13,10,3,1586217600000,05113,Essen,412,25,387,583109,2772
DE-NW,08-04-2020,RKI,24,21,3,1586304000000,05113,Essen,436,28,408,583109,2772
DE-NW,09-04-2020,RKI,3,2,1,1586390400000,05113,Essen,439,29,410,583109,2772
DE-NW,10-04-2020,RKI,3,3,0,1586476800000,05113,Essen,442,29,413,583109,2772
DE-NW,11-04-2020,RKI,2,2,0,1586563200000,05113,Essen,444,29,415,583109,2772
DE-NW,12-04-2020,RKI,0,0,0,1586649600000,05113,Essen,444,29,415,583109,2772
DE-NW,14-04-2020,RKI,15,15,0,1586822400000,05113,Essen,459,29,430,583109,2772
DE-NW,15-04-2020,RKI,3,3,0,1586908800000,05113,Essen,462,29,433,583109,2772
DE-NW,16-04-2020,RKI,13,10,3,1586995200000,05113,Essen,475,32,443,583109,2772
DE-NW,17-04-2020,RKI,0,0,0,1587081600000,05113,Essen,475,32,443,583109,2772
DE-NW,18-04-2020,RKI,1,1,0,1587168000000,05113,Essen,476,32,444,583109,2772
DE-NW,20-04-2020,RKI,171,166,5,1587340800000,05113,Essen,647,37,610,583109,2772
DE-NW,21-04-2020,RKI,10,10,0,1587427200000,05113,Essen,657,37,620,583109,2772
DE-NW,22-04-2020,RKI,10,10,0,1587513600000,05113,Essen,667,37,630,583109,2772
DE-NW,23-04-2020,RKI,7,7,0,1587600000000,05113,Essen,674,37,637,583109,2772
DE-NW,24-04-2020,RKI,7,7,0,1587686400000,05113,Essen,681,37,644,583109,2772
DE-NW,25-04-2020,RKI,2,2,0,1587772800000,05113,Essen,683,37,646,583109,2772
DE-NW,27-04-2020,RKI,5,5,0,1587945600000,05113,Essen,688,37,651,583109,2772
DE-NW,29-04-2020,RKI,9,9,0,1588118400000,05113,Essen,697,37,660,583109,2772
DE-NW,30-04-2020,RKI,0,0,0,1588204800000,05113,Essen,697,37,660,583109,2772
DE-NW,04-05-2020,RKI,16,15,1,1588550400000,05113,Essen,713,38,675,583109,2772
DE-NW,05-05-2020,RKI,5,5,0,1588636800000,05113,Essen,718,38,680,583109,2772
DE-NW,06-05-2020,RKI,6,6,0,1588723200000,05113,Essen,724,38,686,583109,2772
DE-NW,07-05-2020,RKI,4,4,0,1588809600000,05113,Essen,728,38,690,583109,2772
DE-NW,08-05-2020,RKI,8,8,0,1588896000000,05113,Essen,736,38,698,583109,2772
DE-NW,11-05-2020,RKI,2,1,1,1589155200000,05113,Essen,738,39,699,583109,2772
DE-NW,12-05-2020,RKI,2,2,0,1589241600000,05113,Essen,740,39,701,583109,2772
DE-NW,13-05-2020,RKI,6,6,0,1589328000000,05113,Essen,746,39,707,583109,2772
DE-NW,14-05-2020,RKI,2,2,0,1589414400000,05113,Essen,748,39,709,583109,2772
DE-NW,15-05-2020,RKI,4,4,0,1589500800000,05113,Essen,752,39,713,583109,2772
DE-NW,18-05-2020,RKI,4,4,0,1589760000000,05113,Essen,756,39,717,583109,2772
DE-NW,19-05-2020,RKI,0,0,0,1589846400000,05113,Essen,756,39,717,583109,2772
DE-NW,20-05-2020,RKI,2,2,0,1589932800000,05113,Essen,758,39,719,583109,2772
DE-NW,25-05-2020,RKI,13,13,0,1590364800000,05113,Essen,771,39,732,583109,2772
DE-NW,26-05-2020,RKI,3,3,0,1590451200000,05113,Essen,774,39,735,583109,2772
DE-NW,27-05-2020,RKI,3,3,0,1590537600000,05113,Essen,777,39,738,583109,2772
DE-NW,28-05-2020,RKI,1,1,0,1590624000000,05113,Essen,778,39,739,583109,2772
DE-NW,29-05-2020,RKI,8,8,0,1590710400000,05113,Essen,786,39,747,583109,2772
DE-NW,01-06-2020,RKI,16,16,0,1590969600000,05113,Essen,802,39,763,583109,2772
DE-NW,02-06-2020,RKI,0,0,0,1591056000000,05113,Essen,802,39,763,583109,2772
DE-NW,03-06-2020,RKI,4,4,0,1591142400000,05113,Essen,806,39,767,583109,2772
DE-NW,04-06-2020,RKI,3,3,0,1591228800000,05113,Essen,809,39,770,583109,2772
DE-NW,05-06-2020,RKI,1,1,0,1591315200000,05113,Essen,810,39,771,583109,2772
DE-NW,06-06-2020,RKI,1,1,0,1591401600000,05113,Essen,811,39,772,583109,2772
DE-NW,08-06-2020,RKI,0,0,0,1591574400000,05113,Essen,811,39,772,583109,2772
DE-NW,09-06-2020,RKI,0,0,0,1591660800000,05113,Essen,811,39,772,583109,2772
DE-NW,11-06-2020,RKI,2,2,0,1591833600000,05113,Essen,813,39,774,583109,2772
DE-NW,12-06-2020,RKI,7,7,0,1591920000000,05113,Essen,820,39,781,583109,2772
DE-NW,15-06-2020,RKI,8,8,0,1592179200000,05113,Essen,828,39,789,583109,2772
DE-NW,16-06-2020,RKI,6,6,0,1592265600000,05113,Essen,834,39,795,583109,2772
DE-NW,17-06-2020,RKI,5,5,0,1592352000000,05113,Essen,839,39,800,583109,2772
DE-NW,18-06-2020,RKI,2,2,0,1592438400000,05113,Essen,841,39,802,583109,2772
DE-NW,19-06-2020,RKI,2,2,0,1592524800000,05113,Essen,843,39,804,583109,2772
DE-NW,22-06-2020,RKI,15,14,0,1592784000000,05113,Essen,858,39,818,583109,2772
DE-NW,23-06-2020,RKI,6,6,0,1592870400000,05113,Essen,864,39,824,583109,2772
DE-NW,24-06-2020,RKI,6,3,0,1592956800000,05113,Essen,870,39,827,583109,2772
DE-NW,25-06-2020,RKI,10,8,0,1593043200000,05113,Essen,880,39,835,583109,2772
DE-NW,26-06-2020,RKI,3,2,0,1593129600000,05113,Essen,883,39,837,583109,2772
DE-NW,29-06-2020,RKI,15,12,0,1593388800000,05113,Essen,898,39,849,583109,2772
DE-NW,30-06-2020,RKI,5,1,0,1593475200000,05113,Essen,903,39,850,583109,2772
DE-NW,01-07-2020,RKI,1,1,0,1593561600000,05113,Essen,904,39,851,583109,2772
DE-NW,03-07-2020,RKI,2,0,0,1593734400000,05113,Essen,906,39,851,583109,2772
DE-NW,06-07-2020,RKI,3,1,0,1593993600000,05113,Essen,909,39,852,583109,2772
DE-NW,07-07-2020,RKI,9,1,0,1594080000000,05113,Essen,918,39,853,583109,2772
DE-NW,08-07-2020,RKI,15,7,0,1594166400000,05113,Essen,933,39,860,583109,2772
DE-NW,09-07-2020,RKI,0,0,0,1594252800000,05113,Essen,933,39,860,583109,2772
DE-NW,10-07-2020,RKI,5,1,0,1594339200000,05113,Essen,938,39,861,583109,2772
DE-NW,13-07-2020,RKI,9,1,0,1594598400000,05113,Essen,947,39,862,583109,2772
DE-NW,14-07-2020,RKI,2,1,0,1594684800000,05113,Essen,949,39,863,583109,2772
DE-NW,15-07-2020,RKI,5,1,0,1594771200000,05113,Essen,954,39,864,583109,2772
DE-NW,16-07-2020,RKI,7,0,0,1594857600000,05113,Essen,961,39,864,583109,2772
DE-NW,11-03-2020,RKI,6,6,0,1583884800000,05114,Krefeld,6,0,6,227020,1648
DE-NW,12-03-2020,RKI,2,2,0,1583971200000,05114,Krefeld,8,0,8,227020,1648
DE-NW,13-03-2020,RKI,2,2,0,1584057600000,05114,Krefeld,10,0,10,227020,1648
DE-NW,14-03-2020,RKI,8,8,0,1584144000000,05114,Krefeld,18,0,18,227020,1648
DE-NW,15-03-2020,RKI,3,3,0,1584230400000,05114,Krefeld,21,0,21,227020,1648
DE-NW,16-03-2020,RKI,3,3,0,1584316800000,05114,Krefeld,24,0,24,227020,1648
DE-NW,17-03-2020,RKI,5,5,0,1584403200000,05114,Krefeld,29,0,29,227020,1648
DE-NW,18-03-2020,RKI,3,3,0,1584489600000,05114,Krefeld,32,0,32,227020,1648
DE-NW,19-03-2020,RKI,5,5,0,1584576000000,05114,Krefeld,37,0,37,227020,1648
DE-NW,20-03-2020,RKI,9,9,0,1584662400000,05114,Krefeld,46,0,46,227020,1648
DE-NW,21-03-2020,RKI,10,10,0,1584748800000,05114,Krefeld,56,0,56,227020,1648
DE-NW,23-03-2020,RKI,16,16,0,1584921600000,05114,Krefeld,72,0,72,227020,1648
DE-NW,24-03-2020,RKI,6,6,0,1585008000000,05114,Krefeld,78,0,78,227020,1648
DE-NW,25-03-2020,RKI,16,16,0,1585094400000,05114,Krefeld,94,0,94,227020,1648
DE-NW,26-03-2020,RKI,10,10,0,1585180800000,05114,Krefeld,104,0,104,227020,1648
DE-NW,27-03-2020,RKI,30,30,0,1585267200000,05114,Krefeld,134,0,134,227020,1648
DE-NW,28-03-2020,RKI,17,17,0,1585353600000,05114,Krefeld,151,0,151,227020,1648
DE-NW,30-03-2020,RKI,20,20,0,1585526400000,05114,Krefeld,171,0,171,227020,1648
DE-NW,31-03-2020,RKI,12,11,1,1585612800000,05114,Krefeld,183,1,182,227020,1648
DE-NW,01-04-2020,RKI,9,9,0,1585699200000,05114,Krefeld,192,1,191,227020,1648
DE-NW,02-04-2020,RKI,10,10,0,1585785600000,05114,Krefeld,202,1,201,227020,1648
DE-NW,03-04-2020,RKI,23,21,2,1585872000000,05114,Krefeld,225,3,222,227020,1648
DE-NW,04-04-2020,RKI,1,1,0,1585958400000,05114,Krefeld,226,3,223,227020,1648
DE-NW,05-04-2020,RKI,0,0,0,1586044800000,05114,Krefeld,226,3,223,227020,1648
DE-NW,06-04-2020,RKI,4,4,0,1586131200000,05114,Krefeld,230,3,227,227020,1648
DE-NW,07-04-2020,RKI,5,5,0,1586217600000,05114,Krefeld,235,3,232,227020,1648
DE-NW,08-04-2020,RKI,3,3,0,1586304000000,05114,Krefeld,238,3,235,227020,1648
DE-NW,09-04-2020,RKI,9,8,1,1586390400000,05114,Krefeld,247,4,243,227020,1648
DE-NW,12-04-2020,RKI,6,6,0,1586649600000,05114,Krefeld,253,4,249,227020,1648
DE-NW,14-04-2020,RKI,9,8,1,1586822400000,05114,Krefeld,262,5,257,227020,1648
DE-NW,15-04-2020,RKI,1,1,0,1586908800000,05114,Krefeld,263,5,258,227020,1648
DE-NW,16-04-2020,RKI,17,17,0,1586995200000,05114,Krefeld,280,5,275,227020,1648
DE-NW,17-04-2020,RKI,20,20,0,1587081600000,05114,Krefeld,300,5,295,227020,1648
DE-NW,18-04-2020,RKI,14,12,2,1587168000000,05114,Krefeld,314,7,307,227020,1648
DE-NW,19-04-2020,RKI,41,31,10,1587254400000,05114,Krefeld,355,17,338,227020,1648
DE-NW,20-04-2020,RKI,15,13,2,1587340800000,05114,Krefeld,370,19,351,227020,1648
DE-NW,21-04-2020,RKI,11,11,0,1587427200000,05114,Krefeld,381,19,362,227020,1648
DE-NW,22-04-2020,RKI,9,8,1,1587513600000,05114,Krefeld,390,20,370,227020,1648
DE-NW,23-04-2020,RKI,12,11,1,1587600000000,05114,Krefeld,402,21,381,227020,1648
DE-NW,24-04-2020,RKI,10,10,0,1587686400000,05114,Krefeld,412,21,391,227020,1648
DE-NW,25-04-2020,RKI,7,7,0,1587772800000,05114,Krefeld,419,21,398,227020,1648
DE-NW,27-04-2020,RKI,7,7,0,1587945600000,05114,Krefeld,426,21,405,227020,1648
DE-NW,28-04-2020,RKI,6,6,0,1588032000000,05114,Krefeld,432,21,411,227020,1648
DE-NW,29-04-2020,RKI,10,10,0,1588118400000,05114,Krefeld,442,21,421,227020,1648
DE-NW,30-04-2020,RKI,7,7,0,1588204800000,05114,Krefeld,449,21,428,227020,1648
DE-NW,01-05-2020,RKI,16,15,1,1588291200000,05114,Krefeld,465,22,443,227020,1648
DE-NW,02-05-2020,RKI,4,4,0,1588377600000,05114,Krefeld,469,22,447,227020,1648
DE-NW,03-05-2020,RKI,0,0,0,1588464000000,05114,Krefeld,469,22,447,227020,1648
DE-NW,04-05-2020,RKI,0,0,0,1588550400000,05114,Krefeld,469,22,447,227020,1648
DE-NW,05-05-2020,RKI,3,3,0,1588636800000,05114,Krefeld,472,22,450,227020,1648
DE-NW,06-05-2020,RKI,5,5,0,1588723200000,05114,Krefeld,477,22,455,227020,1648
DE-NW,07-05-2020,RKI,4,4,0,1588809600000,05114,Krefeld,481,22,459,227020,1648
DE-NW,08-05-2020,RKI,4,4,0,1588896000000,05114,Krefeld,485,22,463,227020,1648
DE-NW,09-05-2020,RKI,2,2,0,1588982400000,05114,Krefeld,487,22,465,227020,1648
DE-NW,10-05-2020,RKI,3,3,0,1589068800000,05114,Krefeld,490,22,468,227020,1648
DE-NW,11-05-2020,RKI,2,2,0,1589155200000,05114,Krefeld,492,22,470,227020,1648
DE-NW,12-05-2020,RKI,8,8,0,1589241600000,05114,Krefeld,500,22,478,227020,1648
DE-NW,13-05-2020,RKI,3,3,0,1589328000000,05114,Krefeld,503,22,481,227020,1648
DE-NW,14-05-2020,RKI,6,6,0,1589414400000,05114,Krefeld,509,22,487,227020,1648
DE-NW,15-05-2020,RKI,2,2,0,1589500800000,05114,Krefeld,511,22,489,227020,1648
DE-NW,16-05-2020,RKI,8,8,0,1589587200000,05114,Krefeld,519,22,497,227020,1648
DE-NW,18-05-2020,RKI,4,4,0,1589760000000,05114,Krefeld,523,22,501,227020,1648
DE-NW,19-05-2020,RKI,8,8,0,1589846400000,05114,Krefeld,531,22,509,227020,1648
DE-NW,20-05-2020,RKI,2,2,0,1589932800000,05114,Krefeld,533,22,511,227020,1648
DE-NW,21-05-2020,RKI,1,1,0,1590019200000,05114,Krefeld,534,22,512,227020,1648
DE-NW,22-05-2020,RKI,1,1,0,1590105600000,05114,Krefeld,535,22,513,227020,1648
DE-NW,24-05-2020,RKI,1,1,0,1590278400000,05114,Krefeld,536,22,514,227020,1648
DE-NW,26-05-2020,RKI,3,2,1,1590451200000,05114,Krefeld,539,23,516,227020,1648
DE-NW,27-05-2020,RKI,3,3,0,1590537600000,05114,Krefeld,542,23,519,227020,1648
DE-NW,28-05-2020,RKI,4,4,0,1590624000000,05114,Krefeld,546,23,523,227020,1648
DE-NW,02-06-2020,RKI,1,1,0,1591056000000,05114,Krefeld,547,23,524,227020,1648
DE-NW,03-06-2020,RKI,2,2,0,1591142400000,05114,Krefeld,549,23,526,227020,1648
DE-NW,04-06-2020,RKI,1,1,0,1591228800000,05114,Krefeld,550,23,527,227020,1648
DE-NW,05-06-2020,RKI,1,1,0,1591315200000,05114,Krefeld,551,23,528,227020,1648
DE-NW,06-06-2020,RKI,2,2,0,1591401600000,05114,Krefeld,553,23,530,227020,1648
DE-NW,09-06-2020,RKI,0,0,0,1591660800000,05114,Krefeld,553,23,530,227020,1648
DE-NW,10-06-2020,RKI,0,0,0,1591747200000,05114,Krefeld,553,23,530,227020,1648
DE-NW,14-06-2020,RKI,0,0,0,1592092800000,05114,Krefeld,553,23,530,227020,1648
DE-NW,20-06-2020,RKI,1,1,0,1592611200000,05114,Krefeld,554,23,531,227020,1648
DE-NW,22-06-2020,RKI,0,0,0,1592784000000,05114,Krefeld,554,23,531,227020,1648
DE-NW,23-06-2020,RKI,0,0,0,1592870400000,05114,Krefeld,554,23,531,227020,1648
DE-NW,24-06-2020,RKI,1,1,0,1592956800000,05114,Krefeld,555,23,532,227020,1648
DE-NW,25-06-2020,RKI,0,0,0,1593043200000,05114,Krefeld,555,23,532,227020,1648
DE-NW,26-06-2020,RKI,1,1,0,1593129600000,05114,Krefeld,556,23,533,227020,1648
DE-NW,29-06-2020,RKI,5,5,0,1593388800000,05114,Krefeld,561,23,538,227020,1648
DE-NW,30-06-2020,RKI,5,4,0,1593475200000,05114,Krefeld,566,23,542,227020,1648
DE-NW,02-07-2020,RKI,1,0,0,1593648000000,05114,Krefeld,567,23,542,227020,1648
DE-NW,06-07-2020,RKI,5,2,0,1593993600000,05114,Krefeld,572,23,544,227020,1648
DE-NW,08-07-2020,RKI,0,0,0,1594166400000,05114,Krefeld,572,23,544,227020,1648
DE-NW,10-07-2020,RKI,1,0,0,1594339200000,05114,Krefeld,573,23,544,227020,1648
DE-NW,13-07-2020,RKI,1,0,0,1594598400000,05114,Krefeld,574,23,544,227020,1648
DE-NW,14-07-2020,RKI,3,0,0,1594684800000,05114,Krefeld,577,23,544,227020,1648
DE-NW,15-07-2020,RKI,2,0,0,1594771200000,05114,Krefeld,579,23,544,227020,1648
DE-NW,16-07-2020,RKI,1,0,0,1594857600000,05114,Krefeld,580,23,544,227020,1648
DE-NW,04-03-2020,RKI,1,1,0,1583280000000,05116,Mönchengladbach,1,0,1,261454,1534
DE-NW,05-03-2020,RKI,0,0,0,1583366400000,05116,Mönchengladbach,1,0,1,261454,1534
DE-NW,06-03-2020,RKI,2,2,0,1583452800000,05116,Mönchengladbach,3,0,3,261454,1534
DE-NW,09-03-2020,RKI,0,0,0,1583712000000,05116,Mönchengladbach,3,0,3,261454,1534
DE-NW,10-03-2020,RKI,6,6,0,1583798400000,05116,Mönchengladbach,9,0,9,261454,1534
DE-NW,11-03-2020,RKI,1,1,0,1583884800000,05116,Mönchengladbach,10,0,10,261454,1534
DE-NW,12-03-2020,RKI,2,1,1,1583971200000,05116,Mönchengladbach,12,1,11,261454,1534
DE-NW,13-03-2020,RKI,8,8,0,1584057600000,05116,Mönchengladbach,20,1,19,261454,1534
DE-NW,14-03-2020,RKI,5,5,0,1584144000000,05116,Mönchengladbach,25,1,24,261454,1534
DE-NW,16-03-2020,RKI,0,0,0,1584316800000,05116,Mönchengladbach,25,1,24,261454,1534
DE-NW,17-03-2020,RKI,8,8,0,1584403200000,05116,Mönchengladbach,33,1,32,261454,1534
DE-NW,18-03-2020,RKI,9,9,0,1584489600000,05116,Mönchengladbach,42,1,41,261454,1534
DE-NW,19-03-2020,RKI,21,20,1,1584576000000,05116,Mönchengladbach,63,2,61,261454,1534
DE-NW,20-03-2020,RKI,4,4,0,1584662400000,05116,Mönchengladbach,67,2,65,261454,1534
DE-NW,21-03-2020,RKI,19,19,0,1584748800000,05116,Mönchengladbach,86,2,84,261454,1534
DE-NW,23-03-2020,RKI,3,3,0,1584921600000,05116,Mönchengladbach,89,2,87,261454,1534
DE-NW,24-03-2020,RKI,13,13,0,1585008000000,05116,Mönchengladbach,102,2,100,261454,1534
DE-NW,25-03-2020,RKI,3,3,0,1585094400000,05116,Mönchengladbach,105,2,103,261454,1534
DE-NW,26-03-2020,RKI,23,22,1,1585180800000,05116,Mönchengladbach,128,3,125,261454,1534
DE-NW,27-03-2020,RKI,17,17,0,1585267200000,05116,Mönchengladbach,145,3,142,261454,1534
DE-NW,28-03-2020,RKI,6,6,0,1585353600000,05116,Mönchengladbach,151,3,148,261454,1534
DE-NW,29-03-2020,RKI,0,0,0,1585440000000,05116,Mönchengladbach,151,3,148,261454,1534
DE-NW,30-03-2020,RKI,5,4,1,1585526400000,05116,Mönchengladbach,156,4,152,261454,1534
DE-NW,31-03-2020,RKI,27,25,2,1585612800000,05116,Mönchengladbach,183,6,177,261454,1534
DE-NW,01-04-2020,RKI,10,9,1,1585699200000,05116,Mönchengladbach,193,7,186,261454,1534
DE-NW,02-04-2020,RKI,25,21,4,1585785600000,05116,Mönchengladbach,218,11,207,261454,1534
DE-NW,03-04-2020,RKI,13,12,1,1585872000000,05116,Mönchengladbach,231,12,219,261454,1534
DE-NW,04-04-2020,RKI,5,4,1,1585958400000,05116,Mönchengladbach,236,13,223,261454,1534
DE-NW,05-04-2020,RKI,28,16,12,1586044800000,05116,Mönchengladbach,264,25,239,261454,1534
DE-NW,06-04-2020,RKI,6,5,1,1586131200000,05116,Mönchengladbach,270,26,244,261454,1534
DE-NW,07-04-2020,RKI,9,9,0,1586217600000,05116,Mönchengladbach,279,26,253,261454,1534
DE-NW,08-04-2020,RKI,14,12,2,1586304000000,05116,Mönchengladbach,293,28,265,261454,1534
DE-NW,09-04-2020,RKI,8,7,1,1586390400000,05116,Mönchengladbach,301,29,272,261454,1534
DE-NW,10-04-2020,RKI,22,20,2,1586476800000,05116,Mönchengladbach,323,31,292,261454,1534
DE-NW,11-04-2020,RKI,3,3,0,1586563200000,05116,Mönchengladbach,326,31,295,261454,1534
DE-NW,12-04-2020,RKI,7,6,1,1586649600000,05116,Mönchengladbach,333,32,301,261454,1534
DE-NW,13-04-2020,RKI,3,3,0,1586736000000,05116,Mönchengladbach,336,32,304,261454,1534
DE-NW,14-04-2020,RKI,1,1,0,1586822400000,05116,Mönchengladbach,337,32,305,261454,1534
DE-NW,15-04-2020,RKI,5,4,1,1586908800000,05116,Mönchengladbach,342,33,309,261454,1534
DE-NW,16-04-2020,RKI,16,16,0,1586995200000,05116,Mönchengladbach,358,33,325,261454,1534
DE-NW,17-04-2020,RKI,17,16,1,1587081600000,05116,Mönchengladbach,375,34,341,261454,1534
DE-NW,18-04-2020,RKI,5,4,1,1587168000000,05116,Mönchengladbach,380,35,345,261454,1534
DE-NW,20-04-2020,RKI,2,2,0,1587340800000,05116,Mönchengladbach,382,35,347,261454,1534
DE-NW,21-04-2020,RKI,3,3,0,1587427200000,05116,Mönchengladbach,385,35,350,261454,1534
DE-NW,22-04-2020,RKI,15,13,2,1587513600000,05116,Mönchengladbach,400,37,363,261454,1534
DE-NW,23-04-2020,RKI,6,6,0,1587600000000,05116,Mönchengladbach,406,37,369,261454,1534
DE-NW,24-04-2020,RKI,5,5,0,1587686400000,05116,Mönchengladbach,411,37,374,261454,1534
DE-NW,25-04-2020,RKI,3,3,0,1587772800000,05116,Mönchengladbach,414,37,377,261454,1534
DE-NW,26-04-2020,RKI,1,1,0,1587859200000,05116,Mönchengladbach,415,37,378,261454,1534
DE-NW,27-04-2020,RKI,4,4,0,1587945600000,05116,Mönchengladbach,419,37,382,261454,1534
DE-NW,28-04-2020,RKI,9,9,0,1588032000000,05116,Mönchengladbach,428,37,391,261454,1534
DE-NW,29-04-2020,RKI,0,0,0,1588118400000,05116,Mönchengladbach,428,37,391,261454,1534
DE-NW,30-04-2020,RKI,5,5,0,1588204800000,05116,Mönchengladbach,433,37,396,261454,1534
DE-NW,01-05-2020,RKI,5,5,0,1588291200000,05116,Mönchengladbach,438,37,401,261454,1534
DE-NW,02-05-2020,RKI,2,2,0,1588377600000,05116,Mönchengladbach,440,37,403,261454,1534
DE-NW,03-05-2020,RKI,0,0,0,1588464000000,05116,Mönchengladbach,440,37,403,261454,1534
DE-NW,04-05-2020,RKI,3,3,0,1588550400000,05116,Mönchengladbach,443,37,406,261454,1534
DE-NW,05-05-2020,RKI,2,1,1,1588636800000,05116,Mönchengladbach,445,38,407,261454,1534
DE-NW,06-05-2020,RKI,14,14,0,1588723200000,05116,Mönchengladbach,459,38,421,261454,1534
DE-NW,07-05-2020,RKI,3,3,0,1588809600000,05116,Mönchengladbach,462,38,424,261454,1534
DE-NW,08-05-2020,RKI,1,1,0,1588896000000,05116,Mönchengladbach,463,38,425,261454,1534
DE-NW,09-05-2020,RKI,6,6,0,1588982400000,05116,Mönchengladbach,469,38,431,261454,1534
DE-NW,10-05-2020,RKI,1,1,0,1589068800000,05116,Mönchengladbach,470,38,432,261454,1534
DE-NW,11-05-2020,RKI,0,0,0,1589155200000,05116,Mönchengladbach,470,38,432,261454,1534
DE-NW,12-05-2020,RKI,9,9,0,1589241600000,05116,Mönchengladbach,479,38,441,261454,1534
DE-NW,13-05-2020,RKI,6,6,0,1589328000000,05116,Mönchengladbach,485,38,447,261454,1534
DE-NW,14-05-2020,RKI,3,3,0,1589414400000,05116,Mönchengladbach,488,38,450,261454,1534
DE-NW,15-05-2020,RKI,10,10,0,1589500800000,05116,Mönchengladbach,498,38,460,261454,1534
DE-NW,16-05-2020,RKI,7,7,0,1589587200000,05116,Mönchengladbach,505,38,467,261454,1534
DE-NW,18-05-2020,RKI,1,1,0,1589760000000,05116,Mönchengladbach,506,38,468,261454,1534
DE-NW,19-05-2020,RKI,9,9,0,1589846400000,05116,Mönchengladbach,515,38,477,261454,1534
DE-NW,20-05-2020,RKI,3,3,0,1589932800000,05116,Mönchengladbach,518,38,480,261454,1534
DE-NW,21-05-2020,RKI,3,3,0,1590019200000,05116,Mönchengladbach,521,38,483,261454,1534
DE-NW,22-05-2020,RKI,6,5,1,1590105600000,05116,Mönchengladbach,527,39,488,261454,1534
DE-NW,23-05-2020,RKI,0,0,0,1590192000000,05116,Mönchengladbach,527,39,488,261454,1534
DE-NW,25-05-2020,RKI,1,1,0,1590364800000,05116,Mönchengladbach,528,39,489,261454,1534
DE-NW,26-05-2020,RKI,0,0,0,1590451200000,05116,Mönchengladbach,528,39,489,261454,1534
DE-NW,27-05-2020,RKI,1,1,0,1590537600000,05116,Mönchengladbach,529,39,490,261454,1534
DE-NW,28-05-2020,RKI,2,1,1,1590624000000,05116,Mönchengladbach,531,40,491,261454,1534
DE-NW,29-05-2020,RKI,0,0,0,1590710400000,05116,Mönchengladbach,531,40,491,261454,1534
DE-NW,30-05-2020,RKI,2,2,0,1590796800000,05116,Mönchengladbach,533,40,493,261454,1534
DE-NW,03-06-2020,RKI,6,6,0,1591142400000,05116,Mönchengladbach,539,40,499,261454,1534
DE-NW,04-06-2020,RKI,3,3,0,1591228800000,05116,Mönchengladbach,542,40,502,261454,1534
DE-NW,05-06-2020,RKI,2,2,0,1591315200000,05116,Mönchengladbach,544,40,504,261454,1534
DE-NW,06-06-2020,RKI,1,1,0,1591401600000,05116,Mönchengladbach,545,40,505,261454,1534
DE-NW,08-06-2020,RKI,1,1,0,1591574400000,05116,Mönchengladbach,546,40,506,261454,1534
DE-NW,09-06-2020,RKI,0,0,0,1591660800000,05116,Mönchengladbach,546,40,506,261454,1534
DE-NW,10-06-2020,RKI,3,3,0,1591747200000,05116,Mönchengladbach,549,40,509,261454,1534
DE-NW,12-06-2020,RKI,1,1,0,1591920000000,05116,Mönchengladbach,550,40,510,261454,1534
DE-NW,13-06-2020,RKI,0,0,0,1592006400000,05116,Mönchengladbach,550,40,510,261454,1534
DE-NW,14-06-2020,RKI,0,0,0,1592092800000,05116,Mönchengladbach,550,40,510,261454,1534
DE-NW,16-06-2020,RKI,6,6,0,1592265600000,05116,Mönchengladbach,556,40,516,261454,1534
DE-NW,17-06-2020,RKI,3,3,0,1592352000000,05116,Mönchengladbach,559,40,519,261454,1534
DE-NW,18-06-2020,RKI,1,1,0,1592438400000,05116,Mönchengladbach,560,40,520,261454,1534
DE-NW,19-06-2020,RKI,7,7,0,1592524800000,05116,Mönchengladbach,567,40,527,261454,1534
DE-NW,22-06-2020,RKI,6,6,0,1592784000000,05116,Mönchengladbach,573,40,533,261454,1534
DE-NW,23-06-2020,RKI,2,1,0,1592870400000,05116,Mönchengladbach,575,40,534,261454,1534
DE-NW,24-06-2020,RKI,1,1,0,1592956800000,05116,Mönchengladbach,576,40,535,261454,1534
DE-NW,26-06-2020,RKI,3,3,0,1593129600000,05116,Mönchengladbach,579,40,538,261454,1534
DE-NW,27-06-2020,RKI,0,0,0,1593216000000,05116,Mönchengladbach,579,40,538,261454,1534
DE-NW,30-06-2020,RKI,2,2,0,1593475200000,05116,Mönchengladbach,581,40,540,261454,1534
DE-NW,01-07-2020,RKI,3,3,0,1593561600000,05116,Mönchengladbach,584,40,543,261454,1534
DE-NW,04-07-2020,RKI,2,2,0,1593820800000,05116,Mönchengladbach,586,40,545,261454,1534
DE-NW,06-07-2020,RKI,0,0,0,1593993600000,05116,Mönchengladbach,586,40,545,261454,1534
DE-NW,07-07-2020,RKI,0,0,0,1594080000000,05116,Mönchengladbach,586,40,545,261454,1534
DE-NW,08-07-2020,RKI,6,0,0,1594166400000,05116,Mönchengladbach,592,40,545,261454,1534
DE-NW,09-07-2020,RKI,4,2,0,1594252800000,05116,Mönchengladbach,596,40,547,261454,1534
DE-NW,11-07-2020,RKI,8,2,0,1594425600000,05116,Mönchengladbach,604,40,549,261454,1534
DE-NW,14-07-2020,RKI,1,0,0,1594684800000,05116,Mönchengladbach,605,40,549,261454,1534
DE-NW,15-07-2020,RKI,3,0,0,1594771200000,05116,Mönchengladbach,608,40,549,261454,1534
DE-NW,16-07-2020,RKI,12,0,0,1594857600000,05116,Mönchengladbach,620,40,549,261454,1534
DE-NW,12-03-2020,RKI,0,0,0,1583971200000,05117,Mülheim an der Ruhr,2,0,2,170880,1872
DE-NW,13-03-2020,RKI,2,2,0,1584057600000,05117,Mülheim an der Ruhr,4,0,4,170880,1872
DE-NW,16-03-2020,RKI,1,1,0,1584316800000,05117,Mülheim an der Ruhr,5,0,5,170880,1872
DE-NW,17-03-2020,RKI,3,3,0,1584403200000,05117,Mülheim an der Ruhr,8,0,8,170880,1872
DE-NW,18-03-2020,RKI,2,2,0,1584489600000,05117,Mülheim an der Ruhr,10,0,10,170880,1872
DE-NW,19-03-2020,RKI,4,4,0,1584576000000,05117,Mülheim an der Ruhr,14,0,14,170880,1872
DE-NW,20-03-2020,RKI,4,4,0,1584662400000,05117,Mülheim an der Ruhr,18,0,18,170880,1872
DE-NW,21-03-2020,RKI,1,1,0,1584748800000,05117,Mülheim an der Ruhr,19,0,19,170880,1872
DE-NW,23-03-2020,RKI,6,6,0,1584921600000,05117,Mülheim an der Ruhr,25,0,25,170880,1872
DE-NW,24-03-2020,RKI,4,4,0,1585008000000,05117,Mülheim an der Ruhr,29,0,29,170880,1872
DE-NW,25-03-2020,RKI,1,1,0,1585094400000,05117,Mülheim an der Ruhr,30,0,30,170880,1872
DE-NW,27-03-2020,RKI,4,4,0,1585267200000,05117,Mülheim an der Ruhr,34,0,34,170880,1872
DE-NW,30-03-2020,RKI,6,6,0,1585526400000,05117,Mülheim an der Ruhr,40,0,40,170880,1872
DE-NW,31-03-2020,RKI,1,1,0,1585612800000,05117,Mülheim an der Ruhr,41,0,41,170880,1872
DE-NW,01-04-2020,RKI,2,2,0,1585699200000,05117,Mülheim an der Ruhr,43,0,43,170880,1872
DE-NW,02-04-2020,RKI,5,5,0,1585785600000,05117,Mülheim an der Ruhr,48,0,48,170880,1872
DE-NW,03-04-2020,RKI,3,3,0,1585872000000,05117,Mülheim an der Ruhr,51,0,51,170880,1872
DE-NW,06-04-2020,RKI,5,5,0,1586131200000,05117,Mülheim an der Ruhr,56,0,56,170880,1872
DE-NW,07-04-2020,RKI,5,5,0,1586217600000,05117,Mülheim an der Ruhr,61,0,61,170880,1872
DE-NW,11-04-2020,RKI,4,3,1,1586563200000,05117,Mülheim an der Ruhr,65,1,64,170880,1872
DE-NW,14-04-2020,RKI,2,2,0,1586822400000,05117,Mülheim an der Ruhr,67,1,66,170880,1872
DE-NW,16-04-2020,RKI,2,2,0,1586995200000,05117,Mülheim an der Ruhr,69,1,68,170880,1872
DE-NW,17-04-2020,RKI,0,0,0,1587081600000,05117,Mülheim an der Ruhr,69,1,68,170880,1872
DE-NW,20-04-2020,RKI,1,1,0,1587340800000,05117,Mülheim an der Ruhr,70,1,69,170880,1872
DE-NW,21-04-2020,RKI,0,0,0,1587427200000,05117,Mülheim an der Ruhr,70,1,69,170880,1872
DE-NW,22-04-2020,RKI,5,5,0,1587513600000,05117,Mülheim an der Ruhr,75,1,74,170880,1872
DE-NW,24-04-2020,RKI,2,2,0,1587686400000,05117,Mülheim an der Ruhr,77,1,76,170880,1872
DE-NW,27-04-2020,RKI,2,2,0,1587945600000,05117,Mülheim an der Ruhr,79,1,78,170880,1872
DE-NW,28-04-2020,RKI,0,0,0,1588032000000,05117,Mülheim an der Ruhr,79,1,78,170880,1872
DE-NW,30-04-2020,RKI,4,4,0,1588204800000,05117,Mülheim an der Ruhr,83,1,82,170880,1872
DE-NW,04-05-2020,RKI,0,0,0,1588550400000,05117,Mülheim an der Ruhr,83,1,82,170880,1872
DE-NW,05-05-2020,RKI,1,0,1,1588636800000,05117,Mülheim an der Ruhr,84,2,82,170880,1872
DE-NW,07-05-2020,RKI,2,2,0,1588809600000,05117,Mülheim an der Ruhr,86,2,84,170880,1872
DE-NW,08-05-2020,RKI,0,0,0,1588896000000,05117,Mülheim an der Ruhr,86,2,84,170880,1872
DE-NW,13-05-2020,RKI,2,2,0,1589328000000,05117,Mülheim an der Ruhr,88,2,86,170880,1872
DE-NW,15-05-2020,RKI,0,0,0,1589500800000,05117,Mülheim an der Ruhr,88,2,86,170880,1872
DE-NW,18-05-2020,RKI,0,0,0,1589760000000,05117,Mülheim an der Ruhr,88,2,86,170880,1872
DE-NW,22-05-2020,RKI,1,1,0,1590105600000,05117,Mülheim an der Ruhr,89,2,87,170880,1872
DE-NW,25-05-2020,RKI,0,0,0,1590364800000,05117,Mülheim an der Ruhr,89,2,87,170880,1872
DE-NW,26-05-2020,RKI,0,0,0,1590451200000,05117,Mülheim an der Ruhr,89,2,87,170880,1872
DE-NW,27-05-2020,RKI,0,0,0,1590537600000,05117,Mülheim an der Ruhr,89,2,87,170880,1872
DE-NW,28-05-2020,RKI,1,1,0,1590624000000,05117,Mülheim an der Ruhr,90,2,88,170880,1872
DE-NW,29-05-2020,RKI,1,1,0,1590710400000,05117,Mülheim an der Ruhr,91,2,89,170880,1872
DE-NW,02-06-2020,RKI,4,4,0,1591056000000,05117,Mülheim an der Ruhr,95,2,93,170880,1872
DE-NW,09-06-2020,RKI,2,2,0,1591660800000,05117,Mülheim an der Ruhr,97,2,95,170880,1872
DE-NW,10-06-2020,RKI,0,0,0,1591747200000,05117,Mülheim an der Ruhr,97,2,95,170880,1872
DE-NW,15-06-2020,RKI,1,1,0,1592179200000,05117,Mülheim an der Ruhr,98,2,96,170880,1872
DE-NW,17-06-2020,RKI,0,0,0,1592352000000,05117,Mülheim an der Ruhr,98,2,96,170880,1872
DE-NW,18-06-2020,RKI,1,1,0,1592438400000,05117,Mülheim an der Ruhr,99,2,97,170880,1872
DE-NW,19-06-2020,RKI,6,6,0,1592524800000,05117,Mülheim an der Ruhr,105,2,103,170880,1872
DE-NW,22-06-2020,RKI,2,2,0,1592784000000,05117,Mülheim an der Ruhr,107,2,105,170880,1872
DE-NW,23-06-2020,RKI,1,1,0,1592870400000,05117,Mülheim an der Ruhr,108,2,106,170880,1872
DE-NW,24-06-2020,RKI,1,1,0,1592956800000,05117,Mülheim an der Ruhr,109,2,107,170880,1872
DE-NW,25-06-2020,RKI,4,4,0,1593043200000,05117,Mülheim an der Ruhr,113,2,111,170880,1872
DE-NW,26-06-2020,RKI,4,4,0,1593129600000,05117,Mülheim an der Ruhr,117,2,115,170880,1872
DE-NW,29-06-2020,RKI,4,3,0,1593388800000,05117,Mülheim an der Ruhr,121,2,118,170880,1872
DE-NW,30-06-2020,RKI,5,3,0,1593475200000,05117,Mülheim an der Ruhr,126,2,121,170880,1872
DE-NW,01-07-2020,RKI,0,0,0,1593561600000,05117,Mülheim an der Ruhr,126,2,121,170880,1872
DE-NW,02-07-2020,RKI,1,1,0,1593648000000,05117,Mülheim an der Ruhr,127,2,122,170880,1872
DE-NW,03-07-2020,RKI,5,5,0,1593734400000,05117,Mülheim an der Ruhr,132,2,127,170880,1872
DE-NW,07-07-2020,RKI,6,1,0,1594080000000,05117,Mülheim an der Ruhr,138,2,128,170880,1872
DE-NW,08-07-2020,RKI,1,0,0,1594166400000,05117,Mülheim an der Ruhr,139,2,128,170880,1872
DE-NW,09-07-2020,RKI,0,0,0,1594252800000,05117,Mülheim an der Ruhr,139,2,128,170880,1872
DE-NW,10-07-2020,RKI,0,0,0,1594339200000,05117,Mülheim an der Ruhr,139,2,128,170880,1872
DE-NW,13-07-2020,RKI,2,1,0,1594598400000,05117,Mülheim an der Ruhr,141,2,129,170880,1872
DE-NW,14-07-2020,RKI,1,0,0,1594684800000,05117,Mülheim an der Ruhr,142,2,129,170880,1872
DE-NW,15-07-2020,RKI,1,0,0,1594771200000,05117,Mülheim an der Ruhr,143,2,129,170880,1872
DE-NW,16-07-2020,RKI,0,0,0,1594857600000,05117,Mülheim an der Ruhr,143,2,129,170880,1872
DE-RP,05-03-2020,RKI,0,0,0,1583366400000,07111,Koblenz,0,0,0,114024,1085
DE-RP,08-03-2020,RKI,2,2,0,1583625600000,07111,Koblenz,2,0,2,114024,1085
DE-RP,10-03-2020,RKI,1,1,0,1583798400000,07111,Koblenz,3,0,3,114024,1085
DE-RP,11-03-2020,RKI,0,0,0,1583884800000,07111,Koblenz,3,0,3,114024,1085
DE-RP,12-03-2020,RKI,2,2,0,1583971200000,07111,Koblenz,5,0,5,114024,1085
DE-RP,14-03-2020,RKI,0,0,0,1584144000000,07111,Koblenz,5,0,5,114024,1085
DE-RP,15-03-2020,RKI,7,7,0,1584230400000,07111,Koblenz,12,0,12,114024,1085
DE-RP,16-03-2020,RKI,8,8,0,1584316800000,07111,Koblenz,20,0,20,114024,1085
DE-RP,17-03-2020,RKI,6,6,0,1584403200000,07111,Koblenz,26,0,26,114024,1085
DE-RP,18-03-2020,RKI,3,3,0,1584489600000,07111,Koblenz,29,0,29,114024,1085
DE-RP,19-03-2020,RKI,6,6,0,1584576000000,07111,Koblenz,35,0,35,114024,1085
DE-RP,20-03-2020,RKI,8,8,0,1584662400000,07111,Koblenz,43,0,43,114024,1085
DE-RP,21-03-2020,RKI,6,6,0,1584748800000,07111,Koblenz,49,0,49,114024,1085
DE-RP,22-03-2020,RKI,7,7,0,1584835200000,07111,Koblenz,56,0,56,114024,1085
DE-RP,23-03-2020,RKI,7,7,0,1584921600000,07111,Koblenz,63,0,63,114024,1085
DE-RP,24-03-2020,RKI,20,19,1,1585008000000,07111,Koblenz,83,1,82,114024,1085
DE-RP,25-03-2020,RKI,4,2,2,1585094400000,07111,Koblenz,87,3,84,114024,1085
DE-RP,26-03-2020,RKI,3,3,0,1585180800000,07111,Koblenz,90,3,87,114024,1085
DE-RP,27-03-2020,RKI,10,8,2,1585267200000,07111,Koblenz,100,5,95,114024,1085
DE-RP,28-03-2020,RKI,4,3,1,1585353600000,07111,Koblenz,104,6,98,114024,1085
DE-RP,29-03-2020,RKI,1,1,0,1585440000000,07111,Koblenz,105,6,99,114024,1085
DE-RP,30-03-2020,RKI,3,3,0,1585526400000,07111,Koblenz,108,6,102,114024,1085
DE-RP,31-03-2020,RKI,6,4,2,1585612800000,07111,Koblenz,114,8,106,114024,1085
DE-RP,01-04-2020,RKI,3,3,0,1585699200000,07111,Koblenz,117,8,109,114024,1085
DE-RP,02-04-2020,RKI,3,3,0,1585785600000,07111,Koblenz,120,8,112,114024,1085
DE-RP,03-04-2020,RKI,10,8,2,1585872000000,07111,Koblenz,130,10,120,114024,1085
DE-RP,04-04-2020,RKI,0,0,0,1585958400000,07111,Koblenz,130,10,120,114024,1085
DE-RP,05-04-2020,RKI,6,6,0,1586044800000,07111,Koblenz,136,10,126,114024,1085
DE-RP,06-04-2020,RKI,11,9,2,1586131200000,07111,Koblenz,147,12,135,114024,1085
DE-RP,07-04-2020,RKI,13,12,1,1586217600000,07111,Koblenz,160,13,147,114024,1085
DE-RP,08-04-2020,RKI,1,1,0,1586304000000,07111,Koblenz,161,13,148,114024,1085
DE-RP,09-04-2020,RKI,6,6,0,1586390400000,07111,Koblenz,167,13,154,114024,1085
DE-RP,10-04-2020,RKI,5,5,0,1586476800000,07111,Koblenz,172,13,159,114024,1085
DE-RP,11-04-2020,RKI,1,1,0,1586563200000,07111,Koblenz,173,13,160,114024,1085
DE-RP,12-04-2020,RKI,0,0,0,1586649600000,07111,Koblenz,173,13,160,114024,1085
DE-RP,13-04-2020,RKI,1,1,0,1586736000000,07111,Koblenz,174,13,161,114024,1085
DE-RP,14-04-2020,RKI,3,0,3,1586822400000,07111,Koblenz,177,16,161,114024,1085
DE-RP,15-04-2020,RKI,4,4,0,1586908800000,07111,Koblenz,181,16,165,114024,1085
DE-RP,17-04-2020,RKI,1,1,0,1587081600000,07111,Koblenz,182,16,166,114024,1085
DE-RP,18-04-2020,RKI,4,3,1,1587168000000,07111,Koblenz,186,17,169,114024,1085
DE-RP,19-04-2020,RKI,1,1,0,1587254400000,07111,Koblenz,187,17,170,114024,1085
DE-RP,20-04-2020,RKI,1,1,0,1587340800000,07111,Koblenz,188,17,171,114024,1085
DE-RP,21-04-2020,RKI,3,3,0,1587427200000,07111,Koblenz,191,17,174,114024,1085
DE-RP,22-04-2020,RKI,0,0,0,1587513600000,07111,Koblenz,191,17,174,114024,1085
DE-RP,23-04-2020,RKI,1,1,0,1587600000000,07111,Koblenz,192,17,175,114024,1085
DE-RP,24-04-2020,RKI,2,2,0,1587686400000,07111,Koblenz,194,17,177,114024,1085
DE-RP,25-04-2020,RKI,2,2,0,1587772800000,07111,Koblenz,196,17,179,114024,1085
DE-RP,26-04-2020,RKI,3,3,0,1587859200000,07111,Koblenz,199,17,182,114024,1085
DE-RP,29-04-2020,RKI,3,3,0,1588118400000,07111,Koblenz,202,17,185,114024,1085
DE-RP,02-05-2020,RKI,0,0,0,1588377600000,07111,Koblenz,202,17,185,114024,1085
DE-RP,05-05-2020,RKI,0,0,0,1588636800000,07111,Koblenz,202,17,185,114024,1085
DE-RP,08-06-2020,RKI,0,0,0,1591574400000,07111,Koblenz,202,17,185,114024,1085
DE-RP,09-06-2020,RKI,0,0,0,1591660800000,07111,Koblenz,202,17,185,114024,1085
DE-RP,19-06-2020,RKI,0,0,0,1592524800000,07111,Koblenz,202,17,185,114024,1085
DE-RP,09-07-2020,RKI,3,0,0,1594252800000,07111,Koblenz,205,17,185,114024,1085
DE-RP,10-07-2020,RKI,0,0,0,1594339200000,07111,Koblenz,205,17,185,114024,1085
DE-RP,13-03-2020,RKI,2,2,0,1584057600000,07131,Ahrweiler,7,0,7,129727,165
DE-RP,14-03-2020,RKI,0,0,0,1584144000000,07131,Ahrweiler,7,0,7,129727,165
DE-RP,16-03-2020,RKI,2,2,0,1584316800000,07131,Ahrweiler,9,0,9,129727,165
DE-RP,17-03-2020,RKI,4,4,0,1584403200000,07131,Ahrweiler,13,0,13,129727,165
DE-RP,18-03-2020,RKI,7,7,0,1584489600000,07131,Ahrweiler,20,0,20,129727,165
DE-RP,19-03-2020,RKI,6,6,0,1584576000000,07131,Ahrweiler,26,0,26,129727,165
DE-RP,20-03-2020,RKI,5,5,0,1584662400000,07131,Ahrweiler,31,0,31,129727,165
DE-RP,21-03-2020,RKI,2,2,0,1584748800000,07131,Ahrweiler,33,0,33,129727,165
DE-RP,22-03-2020,RKI,0,0,0,1584835200000,07131,Ahrweiler,33,0,33,129727,165
DE-RP,23-03-2020,RKI,3,3,0,1584921600000,07131,Ahrweiler,36,0,36,129727,165
DE-RP,24-03-2020,RKI,1,1,0,1585008000000,07131,Ahrweiler,37,0,37,129727,165
DE-RP,25-03-2020,RKI,4,3,1,1585094400000,07131,Ahrweiler,41,1,40,129727,165
DE-RP,26-03-2020,RKI,1,1,0,1585180800000,07131,Ahrweiler,42,1,41,129727,165
DE-RP,27-03-2020,RKI,3,3,0,1585267200000,07131,Ahrweiler,45,1,44,129727,165
DE-RP,28-03-2020,RKI,2,2,0,1585353600000,07131,Ahrweiler,47,1,46,129727,165
DE-RP,29-03-2020,RKI,1,1,0,1585440000000,07131,Ahrweiler,48,1,47,129727,165
DE-RP,30-03-2020,RKI,2,2,0,1585526400000,07131,Ahrweiler,50,1,49,129727,165
DE-RP,31-03-2020,RKI,4,4,0,1585612800000,07131,Ahrweiler,54,1,53,129727,165
DE-RP,01-04-2020,RKI,2,2,0,1585699200000,07131,Ahrweiler,56,1,55,129727,165
DE-RP,02-04-2020,RKI,4,4,0,1585785600000,07131,Ahrweiler,60,1,59,129727,165
DE-RP,03-04-2020,RKI,2,2,0,1585872000000,07131,Ahrweiler,62,1,61,129727,165
DE-RP,04-04-2020,RKI,4,4,0,1585958400000,07131,Ahrweiler,66,1,65,129727,165
DE-RP,05-04-2020,RKI,2,2,0,1586044800000,07131,Ahrweiler,68,1,67,129727,165
DE-RP,06-04-2020,RKI,6,6,0,1586131200000,07131,Ahrweiler,74,1,73,129727,165
DE-RP,07-04-2020,RKI,0,0,0,1586217600000,07131,Ahrweiler,74,1,73,129727,165
DE-RP,08-04-2020,RKI,2,2,0,1586304000000,07131,Ahrweiler,76,1,75,129727,165
DE-RP,09-04-2020,RKI,0,0,0,1586390400000,07131,Ahrweiler,76,1,75,129727,165
DE-RP,10-04-2020,RKI,3,3,0,1586476800000,07131,Ahrweiler,79,1,78,129727,165
DE-RP,11-04-2020,RKI,0,0,0,1586563200000,07131,Ahrweiler,79,1,78,129727,165
DE-RP,14-04-2020,RKI,0,0,0,1586822400000,07131,Ahrweiler,79,1,78,129727,165
DE-RP,17-04-2020,RKI,0,0,0,1587081600000,07131,Ahrweiler,79,1,78,129727,165
DE-RP,21-04-2020,RKI,0,0,0,1587427200000,07131,Ahrweiler,79,1,78,129727,165
DE-RP,23-04-2020,RKI,1,1,0,1587600000000,07131,Ahrweiler,80,1,79,129727,165
DE-RP,28-04-2020,RKI,2,2,0,1588032000000,07131,Ahrweiler,82,1,81,129727,165
DE-RP,29-04-2020,RKI,1,1,0,1588118400000,07131,Ahrweiler,83,1,82,129727,165
DE-RP,30-04-2020,RKI,1,1,0,1588204800000,07131,Ahrweiler,84,1,83,129727,165
DE-RP,01-05-2020,RKI,1,1,0,1588291200000,07131,Ahrweiler,85,1,84,129727,165
DE-RP,02-05-2020,RKI,8,8,0,1588377600000,07131,Ahrweiler,93,1,92,129727,165
DE-RP,04-05-2020,RKI,0,0,0,1588550400000,07131,Ahrweiler,93,1,92,129727,165
DE-RP,05-05-2020,RKI,0,0,0,1588636800000,07131,Ahrweiler,93,1,92,129727,165
DE-RP,08-05-2020,RKI,1,1,0,1588896000000,07131,Ahrweiler,94,1,93,129727,165
DE-RP,09-05-2020,RKI,3,3,0,1588982400000,07131,Ahrweiler,97,1,96,129727,165
DE-RP,10-05-2020,RKI,5,5,0,1589068800000,07131,Ahrweiler,102,1,101,129727,165
DE-RP,11-05-2020,RKI,3,3,0,1589155200000,07131,Ahrweiler,105,1,104,129727,165
DE-RP,12-05-2020,RKI,0,0,0,1589241600000,07131,Ahrweiler,105,1,104,129727,165
DE-RP,13-05-2020,RKI,0,0,0,1589328000000,07131,Ahrweiler,105,1,104,129727,165
DE-RP,14-05-2020,RKI,1,1,0,1589414400000,07131,Ahrweiler,106,1,105,129727,165
DE-RP,15-05-2020,RKI,1,1,0,1589500800000,07131,Ahrweiler,107,1,106,129727,165
DE-RP,17-05-2020,RKI,11,11,0,1589673600000,07131,Ahrweiler,118,1,117,129727,165
DE-RP,18-05-2020,RKI,1,1,0,1589760000000,07131,Ahrweiler,119,1,118,129727,165
DE-RP,19-05-2020,RKI,0,0,0,1589846400000,07131,Ahrweiler,119,1,118,129727,165
DE-RP,20-05-2020,RKI,0,0,0,1589932800000,07131,Ahrweiler,119,1,118,129727,165
DE-RP,21-05-2020,RKI,1,1,0,1590019200000,07131,Ahrweiler,120,1,119,129727,165
DE-RP,22-05-2020,RKI,0,0,0,1590105600000,07131,Ahrweiler,120,1,119,129727,165
DE-RP,23-05-2020,RKI,0,0,0,1590192000000,07131,Ahrweiler,120,1,119,129727,165
DE-RP,24-05-2020,RKI,0,0,0,1590278400000,07131,Ahrweiler,120,1,119,129727,165
DE-RP,25-05-2020,RKI,0,0,0,1590364800000,07131,Ahrweiler,120,1,119,129727,165
DE-RP,26-05-2020,RKI,0,0,0,1590451200000,07131,Ahrweiler,120,1,119,129727,165
DE-RP,29-05-2020,RKI,1,1,0,1590710400000,07131,Ahrweiler,121,1,120,129727,165
DE-RP,02-06-2020,RKI,0,0,0,1591056000000,07131,Ahrweiler,121,1,120,129727,165
DE-RP,05-06-2020,RKI,2,2,0,1591315200000,07131,Ahrweiler,123,1,122,129727,165
DE-RP,06-06-2020,RKI,0,0,0,1591401600000,07131,Ahrweiler,123,1,122,129727,165
DE-RP,08-06-2020,RKI,0,0,0,1591574400000,07131,Ahrweiler,123,1,122,129727,165
DE-RP,12-06-2020,RKI,0,0,0,1591920000000,07131,Ahrweiler,123,1,122,129727,165
DE-RP,26-06-2020,RKI,0,0,0,1593129600000,07131,Ahrweiler,123,1,122,129727,165
DE-RP,30-06-2020,RKI,4,3,0,1593475200000,07131,Ahrweiler,127,1,125,129727,165
DE-RP,01-07-2020,RKI,3,3,0,1593561600000,07131,Ahrweiler,130,1,128,129727,165
DE-RP,02-07-2020,RKI,0,0,0,1593648000000,07131,Ahrweiler,130,1,128,129727,165
DE-RP,04-07-2020,RKI,0,0,0,1593820800000,07131,Ahrweiler,130,1,128,129727,165
DE-RP,12-07-2020,RKI,5,0,0,1594512000000,07131,Ahrweiler,135,1,128,129727,165
DE-RP,13-07-2020,RKI,0,0,0,1594598400000,07131,Ahrweiler,135,1,128,129727,165
DE-RP,15-07-2020,RKI,2,0,0,1594771200000,07131,Ahrweiler,137,1,128,129727,165
DE-RP,13-03-2020,RKI,0,0,0,1584057600000,07132,Altenkirchen,5,0,5,128705,200
DE-RP,16-03-2020,RKI,6,6,0,1584316800000,07132,Altenkirchen,11,0,11,128705,200
DE-RP,17-03-2020,RKI,1,1,0,1584403200000,07132,Altenkirchen,12,0,12,128705,200
DE-RP,18-03-2020,RKI,0,0,0,1584489600000,07132,Altenkirchen,12,0,12,128705,200
DE-RP,19-03-2020,RKI,1,1,0,1584576000000,07132,Altenkirchen,13,0,13,128705,200
DE-RP,20-03-2020,RKI,0,0,0,1584662400000,07132,Altenkirchen,13,0,13,128705,200
DE-RP,21-03-2020,RKI,2,2,0,1584748800000,07132,Altenkirchen,15,0,15,128705,200
DE-RP,23-03-2020,RKI,3,3,0,1584921600000,07132,Altenkirchen,18,0,18,128705,200
DE-RP,24-03-2020,RKI,3,3,0,1585008000000,07132,Altenkirchen,21,0,21,128705,200
DE-RP,25-03-2020,RKI,2,2,0,1585094400000,07132,Altenkirchen,23,0,23,128705,200
DE-RP,26-03-2020,RKI,2,2,0,1585180800000,07132,Altenkirchen,25,0,25,128705,200
DE-RP,27-03-2020,RKI,6,6,0,1585267200000,07132,Altenkirchen,31,0,31,128705,200
DE-RP,28-03-2020,RKI,4,4,0,1585353600000,07132,Altenkirchen,35,0,35,128705,200
DE-RP,29-03-2020,RKI,1,1,0,1585440000000,07132,Altenkirchen,36,0,36,128705,200
DE-RP,30-03-2020,RKI,2,1,1,1585526400000,07132,Altenkirchen,38,1,37,128705,200
DE-RP,31-03-2020,RKI,1,1,0,1585612800000,07132,Altenkirchen,39,1,38,128705,200
DE-RP,01-04-2020,RKI,4,4,0,1585699200000,07132,Altenkirchen,43,1,42,128705,200
DE-RP,02-04-2020,RKI,0,0,0,1585785600000,07132,Altenkirchen,43,1,42,128705,200
DE-RP,03-04-2020,RKI,1,1,0,1585872000000,07132,Altenkirchen,44,1,43,128705,200
DE-RP,04-04-2020,RKI,0,0,0,1585958400000,07132,Altenkirchen,44,1,43,128705,200
DE-RP,05-04-2020,RKI,1,1,0,1586044800000,07132,Altenkirchen,45,1,44,128705,200
DE-RP,06-04-2020,RKI,7,7,0,1586131200000,07132,Altenkirchen,52,1,51,128705,200
DE-RP,07-04-2020,RKI,1,1,0,1586217600000,07132,Altenkirchen,53,1,52,128705,200
DE-RP,08-04-2020,RKI,10,5,5,1586304000000,07132,Altenkirchen,63,6,57,128705,200
DE-RP,09-04-2020,RKI,3,3,0,1586390400000,07132,Altenkirchen,66,6,60,128705,200
DE-RP,10-04-2020,RKI,4,4,0,1586476800000,07132,Altenkirchen,70,6,64,128705,200
DE-RP,11-04-2020,RKI,5,3,2,1586563200000,07132,Altenkirchen,75,8,67,128705,200
DE-RP,12-04-2020,RKI,1,1,0,1586649600000,07132,Altenkirchen,76,8,68,128705,200
DE-RP,14-04-2020,RKI,5,5,0,1586822400000,07132,Altenkirchen,81,8,73,128705,200
DE-RP,15-04-2020,RKI,1,1,0,1586908800000,07132,Altenkirchen,82,8,74,128705,200
DE-RP,16-04-2020,RKI,9,7,2,1586995200000,07132,Altenkirchen,91,10,81,128705,200
DE-RP,17-04-2020,RKI,0,0,0,1587081600000,07132,Altenkirchen,91,10,81,128705,200
DE-RP,18-04-2020,RKI,6,6,0,1587168000000,07132,Altenkirchen,97,10,87,128705,200
DE-RP,21-04-2020,RKI,0,0,0,1587427200000,07132,Altenkirchen,97,10,87,128705,200
DE-RP,22-04-2020,RKI,7,7,0,1587513600000,07132,Altenkirchen,104,10,94,128705,200
DE-RP,23-04-2020,RKI,0,0,0,1587600000000,07132,Altenkirchen,104,10,94,128705,200
DE-RP,25-04-2020,RKI,0,0,0,1587772800000,07132,Altenkirchen,104,10,94,128705,200
DE-RP,26-04-2020,RKI,1,1,0,1587859200000,07132,Altenkirchen,105,10,95,128705,200
DE-RP,27-04-2020,RKI,1,1,0,1587945600000,07132,Altenkirchen,106,10,96,128705,200
DE-RP,29-04-2020,RKI,2,2,0,1588118400000,07132,Altenkirchen,108,10,98,128705,200
DE-RP,30-04-2020,RKI,1,1,0,1588204800000,07132,Altenkirchen,109,10,99,128705,200
DE-RP,02-05-2020,RKI,0,0,0,1588377600000,07132,Altenkirchen,109,10,99,128705,200
DE-RP,04-05-2020,RKI,0,0,0,1588550400000,07132,Altenkirchen,109,10,99,128705,200
DE-RP,10-05-2020,RKI,0,0,0,1589068800000,07132,Altenkirchen,109,10,99,128705,200
DE-RP,12-05-2020,RKI,0,0,0,1589241600000,07132,Altenkirchen,109,10,99,128705,200
DE-RP,15-05-2020,RKI,2,2,0,1589500800000,07132,Altenkirchen,111,10,101,128705,200
DE-RP,17-05-2020,RKI,0,0,0,1589673600000,07132,Altenkirchen,111,10,101,128705,200
DE-RP,19-05-2020,RKI,3,3,0,1589846400000,07132,Altenkirchen,114,10,104,128705,200
DE-RP,25-05-2020,RKI,0,0,0,1590364800000,07132,Altenkirchen,114,10,104,128705,200
DE-RP,27-05-2020,RKI,0,0,0,1590537600000,07132,Altenkirchen,114,10,104,128705,200
DE-RP,16-06-2020,RKI,1,1,0,1592265600000,07132,Altenkirchen,115,10,105,128705,200
DE-RP,18-06-2020,RKI,4,4,0,1592438400000,07132,Altenkirchen,119,10,109,128705,200
DE-RP,03-07-2020,RKI,1,1,0,1593734400000,07132,Altenkirchen,120,10,110,128705,200
DE-RP,04-07-2020,RKI,1,0,0,1593820800000,07132,Altenkirchen,121,10,110,128705,200
DE-RP,07-07-2020,RKI,1,0,0,1594080000000,07132,Altenkirchen,122,10,110,128705,200
DE-RP,14-07-2020,RKI,0,0,0,1594684800000,07132,Altenkirchen,122,10,110,128705,200
DE-RP,15-07-2020,RKI,0,0,0,1594771200000,07132,Altenkirchen,122,10,110,128705,200
DE-RP,11-03-2020,RKI,6,6,0,1583884800000,07133,Bad Kreuznach,6,0,6,158080,183
DE-RP,12-03-2020,RKI,4,4,0,1583971200000,07133,Bad Kreuznach,10,0,10,158080,183
DE-RP,13-03-2020,RKI,0,0,0,1584057600000,07133,Bad Kreuznach,10,0,10,158080,183
DE-RP,16-03-2020,RKI,6,6,0,1584316800000,07133,Bad Kreuznach,16,0,16,158080,183
DE-RP,18-03-2020,RKI,3,3,0,1584489600000,07133,Bad Kreuznach,19,0,19,158080,183
DE-RP,19-03-2020,RKI,7,7,0,1584576000000,07133,Bad Kreuznach,26,0,26,158080,183
DE-RP,20-03-2020,RKI,10,10,0,1584662400000,07133,Bad Kreuznach,36,0,36,158080,183
DE-RP,23-03-2020,RKI,5,5,0,1584921600000,07133,Bad Kreuznach,41,0,41,158080,183
DE-RP,24-03-2020,RKI,8,8,0,1585008000000,07133,Bad Kreuznach,49,0,49,158080,183
DE-RP,25-03-2020,RKI,3,3,0,1585094400000,07133,Bad Kreuznach,52,0,52,158080,183
DE-RP,26-03-2020,RKI,8,8,0,1585180800000,07133,Bad Kreuznach,60,0,60,158080,183
DE-RP,27-03-2020,RKI,4,4,0,1585267200000,07133,Bad Kreuznach,64,0,64,158080,183
DE-RP,30-03-2020,RKI,12,12,0,1585526400000,07133,Bad Kreuznach,76,0,76,158080,183
DE-RP,31-03-2020,RKI,7,7,0,1585612800000,07133,Bad Kreuznach,83,0,83,158080,183
DE-RP,01-04-2020,RKI,10,9,1,1585699200000,07133,Bad Kreuznach,93,1,92,158080,183
DE-RP,02-04-2020,RKI,6,6,0,1585785600000,07133,Bad Kreuznach,99,1,98,158080,183
DE-RP,03-04-2020,RKI,6,5,1,1585872000000,07133,Bad Kreuznach,105,2,103,158080,183
DE-RP,06-04-2020,RKI,4,4,0,1586131200000,07133,Bad Kreuznach,109,2,107,158080,183
DE-RP,07-04-2020,RKI,4,4,0,1586217600000,07133,Bad Kreuznach,113,2,111,158080,183
DE-RP,08-04-2020,RKI,3,3,0,1586304000000,07133,Bad Kreuznach,116,2,114,158080,183
DE-RP,14-04-2020,RKI,7,7,0,1586822400000,07133,Bad Kreuznach,123,2,121,158080,183
DE-RP,15-04-2020,RKI,4,3,1,1586908800000,07133,Bad Kreuznach,127,3,124,158080,183
DE-RP,16-04-2020,RKI,1,1,0,1586995200000,07133,Bad Kreuznach,128,3,125,158080,183
DE-RP,17-04-2020,RKI,4,4,0,1587081600000,07133,Bad Kreuznach,132,3,129,158080,183
DE-RP,20-04-2020,RKI,4,3,1,1587340800000,07133,Bad Kreuznach,136,4,132,158080,183
DE-RP,21-04-2020,RKI,3,3,0,1587427200000,07133,Bad Kreuznach,139,4,135,158080,183
DE-RP,22-04-2020,RKI,2,1,1,1587513600000,07133,Bad Kreuznach,141,5,136,158080,183
DE-RP,23-04-2020,RKI,1,1,0,1587600000000,07133,Bad Kreuznach,142,5,137,158080,183
DE-RP,24-04-2020,RKI,1,1,0,1587686400000,07133,Bad Kreuznach,143,5,138,158080,183
DE-RP,30-04-2020,RKI,0,0,0,1588204800000,07133,Bad Kreuznach,143,5,138,158080,183
DE-RP,04-05-2020,RKI,1,0,1,1588550400000,07133,Bad Kreuznach,144,6,138,158080,183
DE-RP,05-05-2020,RKI,2,1,1,1588636800000,07133,Bad Kreuznach,146,7,139,158080,183
DE-RP,08-05-2020,RKI,0,0,0,1588896000000,07133,Bad Kreuznach,146,7,139,158080,183
DE-RP,12-05-2020,RKI,0,0,0,1589241600000,07133,Bad Kreuznach,146,7,139,158080,183
DE-RP,13-05-2020,RKI,0,0,0,1589328000000,07133,Bad Kreuznach,146,7,139,158080,183
DE-RP,15-05-2020,RKI,0,0,0,1589500800000,07133,Bad Kreuznach,146,7,139,158080,183
DE-RP,03-06-2020,RKI,1,1,0,1591142400000,07133,Bad Kreuznach,147,7,140,158080,183
DE-RP,10-06-2020,RKI,0,0,0,1591747200000,07133,Bad Kreuznach,147,7,140,158080,183
DE-RP,16-06-2020,RKI,1,1,0,1592265600000,07133,Bad Kreuznach,148,7,141,158080,183
DE-RP,22-06-2020,RKI,0,0,0,1592784000000,07133,Bad Kreuznach,148,7,141,158080,183
DE-RP,03-07-2020,RKI,0,0,0,1593734400000,07133,Bad Kreuznach,148,7,141,158080,183
DE-RP,13-07-2020,RKI,0,0,0,1594598400000,07133,Bad Kreuznach,148,7,141,158080,183
DE-RP,17-03-2020,RKI,0,0,0,1584403200000,07134,Birkenfeld,0,0,0,80720,104
DE-RP,18-03-2020,RKI,1,1,0,1584489600000,07134,Birkenfeld,1,0,1,80720,104
DE-RP,19-03-2020,RKI,0,0,0,1584576000000,07134,Birkenfeld,1,0,1,80720,104
DE-RP,20-03-2020,RKI,2,2,0,1584662400000,07134,Birkenfeld,3,0,3,80720,104
DE-RP,22-03-2020,RKI,1,1,0,1584835200000,07134,Birkenfeld,4,0,4,80720,104
DE-RP,23-03-2020,RKI,5,5,0,1584921600000,07134,Birkenfeld,9,0,9,80720,104
DE-RP,24-03-2020,RKI,0,0,0,1585008000000,07134,Birkenfeld,9,0,9,80720,104
DE-RP,25-03-2020,RKI,1,1,0,1585094400000,07134,Birkenfeld,10,0,10,80720,104
DE-RP,26-03-2020,RKI,4,4,0,1585180800000,07134,Birkenfeld,14,0,14,80720,104
DE-RP,27-03-2020,RKI,4,4,0,1585267200000,07134,Birkenfeld,18,0,18,80720,104
DE-RP,28-03-2020,RKI,1,1,0,1585353600000,07134,Birkenfeld,19,0,19,80720,104
DE-RP,29-03-2020,RKI,0,0,0,1585440000000,07134,Birkenfeld,19,0,19,80720,104
DE-RP,30-03-2020,RKI,0,0,0,1585526400000,07134,Birkenfeld,19,0,19,80720,104
DE-RP,01-04-2020,RKI,7,7,0,1585699200000,07134,Birkenfeld,26,0,26,80720,104
DE-RP,02-04-2020,RKI,0,0,0,1585785600000,07134,Birkenfeld,26,0,26,80720,104
DE-RP,03-04-2020,RKI,4,4,0,1585872000000,07134,Birkenfeld,30,0,30,80720,104
DE-RP,04-04-2020,RKI,0,0,0,1585958400000,07134,Birkenfeld,30,0,30,80720,104
DE-RP,06-04-2020,RKI,0,0,0,1586131200000,07134,Birkenfeld,30,0,30,80720,104
DE-RP,07-04-2020,RKI,3,3,0,1586217600000,07134,Birkenfeld,33,0,33,80720,104
DE-RP,09-04-2020,RKI,6,5,1,1586390400000,07134,Birkenfeld,39,1,38,80720,104
DE-RP,10-04-2020,RKI,3,3,0,1586476800000,07134,Birkenfeld,42,1,41,80720,104
DE-RP,12-04-2020,RKI,1,1,0,1586649600000,07134,Birkenfeld,43,1,42,80720,104
DE-RP,14-04-2020,RKI,1,1,0,1586822400000,07134,Birkenfeld,44,1,43,80720,104
DE-RP,16-04-2020,RKI,1,1,0,1586995200000,07134,Birkenfeld,45,1,44,80720,104
DE-RP,17-04-2020,RKI,0,0,0,1587081600000,07134,Birkenfeld,45,1,44,80720,104
DE-RP,18-04-2020,RKI,0,0,0,1587168000000,07134,Birkenfeld,45,1,44,80720,104
DE-RP,19-04-2020,RKI,1,1,0,1587254400000,07134,Birkenfeld,46,1,45,80720,104
DE-RP,20-04-2020,RKI,0,0,0,1587340800000,07134,Birkenfeld,46,1,45,80720,104
DE-RP,22-04-2020,RKI,0,0,0,1587513600000,07134,Birkenfeld,46,1,45,80720,104
DE-RP,23-04-2020,RKI,1,1,0,1587600000000,07134,Birkenfeld,47,1,46,80720,104
DE-RP,27-04-2020,RKI,0,0,0,1587945600000,07134,Birkenfeld,47,1,46,80720,104
DE-RP,28-04-2020,RKI,0,0,0,1588032000000,07134,Birkenfeld,47,1,46,80720,104
DE-RP,02-05-2020,RKI,0,0,0,1588377600000,07134,Birkenfeld,47,1,46,80720,104
DE-RP,14-05-2020,RKI,0,0,0,1589414400000,07134,Birkenfeld,47,1,46,80720,104
DE-RP,18-05-2020,RKI,1,1,0,1589760000000,07134,Birkenfeld,48,1,47,80720,104
DE-RP,19-05-2020,RKI,0,0,0,1589846400000,07134,Birkenfeld,48,1,47,80720,104
DE-RP,25-05-2020,RKI,0,0,0,1590364800000,07134,Birkenfeld,48,1,47,80720,104
DE-RP,02-06-2020,RKI,0,0,0,1591056000000,07134,Birkenfeld,48,1,47,80720,104
DE-RP,06-07-2020,RKI,0,0,0,1593993600000,07134,Birkenfeld,48,1,47,80720,104
DE-RP,13-07-2020,RKI,0,0,0,1594598400000,07134,Birkenfeld,48,1,47,80720,104
DE-RP,13-03-2020,RKI,3,3,0,1584057600000,07135,Cochem-Zell,4,0,4,61587,89
DE-RP,15-03-2020,RKI,16,16,0,1584230400000,07135,Cochem-Zell,20,0,20,61587,89
DE-RP,16-03-2020,RKI,1,1,0,1584316800000,07135,Cochem-Zell,21,0,21,61587,89
DE-RP,17-03-2020,RKI,6,6,0,1584403200000,07135,Cochem-Zell,27,0,27,61587,89
DE-RP,18-03-2020,RKI,1,1,0,1584489600000,07135,Cochem-Zell,28,0,28,61587,89
DE-RP,19-03-2020,RKI,3,3,0,1584576000000,07135,Cochem-Zell,31,0,31,61587,89
DE-RP,20-03-2020,RKI,3,3,0,1584662400000,07135,Cochem-Zell,34,0,34,61587,89
DE-RP,21-03-2020,RKI,2,2,0,1584748800000,07135,Cochem-Zell,36,0,36,61587,89
DE-RP,24-03-2020,RKI,7,7,0,1585008000000,07135,Cochem-Zell,43,0,43,61587,89
DE-RP,25-03-2020,RKI,13,13,0,1585094400000,07135,Cochem-Zell,56,0,56,61587,89
DE-RP,26-03-2020,RKI,3,3,0,1585180800000,07135,Cochem-Zell,59,0,59,61587,89
DE-RP,27-03-2020,RKI,16,16,0,1585267200000,07135,Cochem-Zell,75,0,75,61587,89
DE-RP,28-03-2020,RKI,8,8,0,1585353600000,07135,Cochem-Zell,83,0,83,61587,89
DE-RP,29-03-2020,RKI,1,1,0,1585440000000,07135,Cochem-Zell,84,0,84,61587,89
DE-RP,30-03-2020,RKI,0,0,0,1585526400000,07135,Cochem-Zell,84,0,84,61587,89
DE-RP,31-03-2020,RKI,7,7,0,1585612800000,07135,Cochem-Zell,91,0,91,61587,89
DE-RP,01-04-2020,RKI,3,3,0,1585699200000,07135,Cochem-Zell,94,0,94,61587,89
DE-RP,02-04-2020,RKI,0,0,0,1585785600000,07135,Cochem-Zell,94,0,94,61587,89
DE-RP,03-04-2020,RKI,1,1,0,1585872000000,07135,Cochem-Zell,95,0,95,61587,89
DE-RP,06-04-2020,RKI,1,0,1,1586131200000,07135,Cochem-Zell,96,1,95,61587,89
DE-RP,07-04-2020,RKI,2,2,0,1586217600000,07135,Cochem-Zell,98,1,97,61587,89
DE-RP,09-04-2020,RKI,0,0,0,1586390400000,07135,Cochem-Zell,98,1,97,61587,89
DE-RP,15-04-2020,RKI,0,0,0,1586908800000,07135,Cochem-Zell,98,1,97,61587,89
DE-RP,17-04-2020,RKI,1,1,0,1587081600000,07135,Cochem-Zell,99,1,98,61587,89
DE-RP,21-04-2020,RKI,0,0,0,1587427200000,07135,Cochem-Zell,99,1,98,61587,89
DE-RP,29-04-2020,RKI,0,0,0,1588118400000,07135,Cochem-Zell,99,1,98,61587,89
DE-RP,13-05-2020,RKI,0,0,0,1589328000000,07135,Cochem-Zell,99,1,98,61587,89
DE-RP,27-05-2020,RKI,0,0,0,1590537600000,07135,Cochem-Zell,99,1,98,61587,89
DE-RP,03-06-2020,RKI,1,1,0,1591142400000,07135,Cochem-Zell,100,1,99,61587,89
DE-RP,09-06-2020,RKI,2,2,0,1591660800000,07135,Cochem-Zell,102,1,101,61587,89
DE-RP,19-06-2020,RKI,0,0,0,1592524800000,07135,Cochem-Zell,102,1,101,61587,89
DE-RP,22-06-2020,RKI,0,0,0,1592784000000,07135,Cochem-Zell,102,1,101,61587,89
DE-RP,24-06-2020,RKI,0,0,0,1592956800000,07135,Cochem-Zell,102,1,101,61587,89
DE-RP,03-07-2020,RKI,0,0,0,1593734400000,07135,Cochem-Zell,102,1,101,61587,89
DE-RP,10-03-2020,RKI,0,0,0,1583798400000,07137,Mayen-Koblenz,0,0,0,214259,262
DE-RP,12-03-2020,RKI,2,2,0,1583971200000,07137,Mayen-Koblenz,2,0,2,214259,262
DE-RP,13-03-2020,RKI,4,4,0,1584057600000,07137,Mayen-Koblenz,6,0,6,214259,262
DE-RP,14-03-2020,RKI,0,0,0,1584144000000,07137,Mayen-Koblenz,6,0,6,214259,262
DE-RP,15-03-2020,RKI,24,23,1,1584230400000,07137,Mayen-Koblenz,30,1,29,214259,262
DE-RP,16-03-2020,RKI,16,16,0,1584316800000,07137,Mayen-Koblenz,46,1,45,214259,262
DE-RP,17-03-2020,RKI,19,18,1,1584403200000,07137,Mayen-Koblenz,65,2,63,214259,262
DE-RP,18-03-2020,RKI,18,18,0,1584489600000,07137,Mayen-Koblenz,83,2,81,214259,262
DE-RP,19-03-2020,RKI,10,10,0,1584576000000,07137,Mayen-Koblenz,93,2,91,214259,262
DE-RP,20-03-2020,RKI,2,2,0,1584662400000,07137,Mayen-Koblenz,95,2,93,214259,262
DE-RP,21-03-2020,RKI,12,12,0,1584748800000,07137,Mayen-Koblenz,107,2,105,214259,262
DE-RP,22-03-2020,RKI,10,10,0,1584835200000,07137,Mayen-Koblenz,117,2,115,214259,262
DE-RP,23-03-2020,RKI,13,13,0,1584921600000,07137,Mayen-Koblenz,130,2,128,214259,262
DE-RP,24-03-2020,RKI,12,12,0,1585008000000,07137,Mayen-Koblenz,142,2,140,214259,262
DE-RP,25-03-2020,RKI,5,5,0,1585094400000,07137,Mayen-Koblenz,147,2,145,214259,262
DE-RP,26-03-2020,RKI,8,8,0,1585180800000,07137,Mayen-Koblenz,155,2,153,214259,262
DE-RP,27-03-2020,RKI,12,12,0,1585267200000,07137,Mayen-Koblenz,167,2,165,214259,262
DE-RP,28-03-2020,RKI,6,6,0,1585353600000,07137,Mayen-Koblenz,173,2,171,214259,262
DE-RP,29-03-2020,RKI,5,5,0,1585440000000,07137,Mayen-Koblenz,178,2,176,214259,262
DE-RP,30-03-2020,RKI,10,9,1,1585526400000,07137,Mayen-Koblenz,188,3,185,214259,262
DE-RP,31-03-2020,RKI,10,9,1,1585612800000,07137,Mayen-Koblenz,198,4,194,214259,262
DE-RP,01-04-2020,RKI,8,8,0,1585699200000,07137,Mayen-Koblenz,206,4,202,214259,262
DE-RP,02-04-2020,RKI,6,5,1,1585785600000,07137,Mayen-Koblenz,212,5,207,214259,262
DE-RP,03-04-2020,RKI,6,4,2,1585872000000,07137,Mayen-Koblenz,218,7,211,214259,262
DE-RP,04-04-2020,RKI,4,4,0,1585958400000,07137,Mayen-Koblenz,222,7,215,214259,262
DE-RP,05-04-2020,RKI,5,4,1,1586044800000,07137,Mayen-Koblenz,227,8,219,214259,262
DE-RP,06-04-2020,RKI,8,7,1,1586131200000,07137,Mayen-Koblenz,235,9,226,214259,262
DE-RP,07-04-2020,RKI,11,9,2,1586217600000,07137,Mayen-Koblenz,246,11,235,214259,262
DE-RP,08-04-2020,RKI,3,3,0,1586304000000,07137,Mayen-Koblenz,249,11,238,214259,262
DE-RP,09-04-2020,RKI,6,6,0,1586390400000,07137,Mayen-Koblenz,255,11,244,214259,262
DE-RP,10-04-2020,RKI,9,9,0,1586476800000,07137,Mayen-Koblenz,264,11,253,214259,262
DE-RP,11-04-2020,RKI,6,5,1,1586563200000,07137,Mayen-Koblenz,270,12,258,214259,262
DE-RP,12-04-2020,RKI,0,0,0,1586649600000,07137,Mayen-Koblenz,270,12,258,214259,262
DE-RP,14-04-2020,RKI,0,0,0,1586822400000,07137,Mayen-Koblenz,270,12,258,214259,262
DE-RP,15-04-2020,RKI,2,2,0,1586908800000,07137,Mayen-Koblenz,272,12,260,214259,262
DE-RP,16-04-2020,RKI,4,4,0,1586995200000,07137,Mayen-Koblenz,276,12,264,214259,262
DE-RP,17-04-2020,RKI,3,2,1,1587081600000,07137,Mayen-Koblenz,279,13,266,214259,262
DE-RP,18-04-2020,RKI,1,1,0,1587168000000,07137,Mayen-Koblenz,280,13,267,214259,262
DE-RP,19-04-2020,RKI,0,0,0,1587254400000,07137,Mayen-Koblenz,280,13,267,214259,262
DE-RP,21-04-2020,RKI,1,1,0,1587427200000,07137,Mayen-Koblenz,281,13,268,214259,262
DE-RP,23-04-2020,RKI,0,0,0,1587600000000,07137,Mayen-Koblenz,281,13,268,214259,262
DE-RP,24-04-2020,RKI,0,0,0,1587686400000,07137,Mayen-Koblenz,281,13,268,214259,262
DE-RP,25-04-2020,RKI,0,0,0,1587772800000,07137,Mayen-Koblenz,281,13,268,214259,262
DE-RP,26-04-2020,RKI,1,1,0,1587859200000,07137,Mayen-Koblenz,282,13,269,214259,262
DE-RP,29-04-2020,RKI,4,4,0,1588118400000,07137,Mayen-Koblenz,286,13,273,214259,262
DE-RP,30-04-2020,RKI,0,0,0,1588204800000,07137,Mayen-Koblenz,286,13,273,214259,262
DE-RP,05-05-2020,RKI,0,0,0,1588636800000,07137,Mayen-Koblenz,286,13,273,214259,262
DE-RP,14-05-2020,RKI,0,0,0,1589414400000,07137,Mayen-Koblenz,286,13,273,214259,262
DE-RP,30-05-2020,RKI,0,0,0,1590796800000,07137,Mayen-Koblenz,286,13,273,214259,262
DE-RP,16-06-2020,RKI,0,0,0,1592265600000,07137,Mayen-Koblenz,286,13,273,214259,262
DE-RP,17-06-2020,RKI,4,4,0,1592352000000,07137,Mayen-Koblenz,290,13,277,214259,262
DE-RP,18-06-2020,RKI,0,0,0,1592438400000,07137,Mayen-Koblenz,290,13,277,214259,262
DE-RP,27-06-2020,RKI,0,0,0,1593216000000,07137,Mayen-Koblenz,290,13,277,214259,262
DE-RP,06-07-2020,RKI,0,0,0,1593993600000,07137,Mayen-Koblenz,290,13,277,214259,262
DE-RP,09-07-2020,RKI,0,0,0,1594252800000,07137,Mayen-Koblenz,290,13,277,214259,262
DE-RP,15-07-2020,RKI,0,0,0,1594771200000,07137,Mayen-Koblenz,290,13,277,214259,262
DE-RP,10-03-2020,RKI,0,0,0,1583798400000,07138,Neuwied,1,0,1,181941,290
DE-RP,12-03-2020,RKI,0,0,0,1583971200000,07138,Neuwied,1,0,1,181941,290
DE-RP,13-03-2020,RKI,5,5,0,1584057600000,07138,Neuwied,6,0,6,181941,290
DE-RP,15-03-2020,RKI,8,8,0,1584230400000,07138,Neuwied,14,0,14,181941,290
DE-RP,16-03-2020,RKI,4,4,0,1584316800000,07138,Neuwied,18,0,18,181941,290
DE-RP,17-03-2020,RKI,8,8,0,1584403200000,07138,Neuwied,26,0,26,181941,290
DE-RP,18-03-2020,RKI,1,1,0,1584489600000,07138,Neuwied,27,0,27,181941,290
DE-RP,19-03-2020,RKI,10,9,1,1584576000000,07138,Neuwied,37,1,36,181941,290
DE-RP,20-03-2020,RKI,9,9,0,1584662400000,07138,Neuwied,46,1,45,181941,290
DE-RP,22-03-2020,RKI,10,9,1,1584835200000,07138,Neuwied,56,2,54,181941,290
DE-RP,23-03-2020,RKI,7,7,0,1584921600000,07138,Neuwied,63,2,61,181941,290
DE-RP,24-03-2020,RKI,7,7,0,1585008000000,07138,Neuwied,70,2,68,181941,290
DE-RP,25-03-2020,RKI,15,15,0,1585094400000,07138,Neuwied,85,2,83,181941,290
DE-RP,26-03-2020,RKI,4,4,0,1585180800000,07138,Neuwied,89,2,87,181941,290
DE-RP,27-03-2020,RKI,7,7,0,1585267200000,07138,Neuwied,96,2,94,181941,290
DE-RP,30-03-2020,RKI,11,11,0,1585526400000,07138,Neuwied,107,2,105,181941,290
DE-RP,31-03-2020,RKI,3,3,0,1585612800000,07138,Neuwied,110,2,108,181941,290
DE-RP,01-04-2020,RKI,5,4,1,1585699200000,07138,Neuwied,115,3,112,181941,290
DE-RP,02-04-2020,RKI,7,7,0,1585785600000,07138,Neuwied,122,3,119,181941,290
DE-RP,03-04-2020,RKI,0,0,0,1585872000000,07138,Neuwied,122,3,119,181941,290
DE-RP,06-04-2020,RKI,16,16,0,1586131200000,07138,Neuwied,138,3,135,181941,290
DE-RP,07-04-2020,RKI,5,5,0,1586217600000,07138,Neuwied,143,3,140,181941,290
DE-RP,08-04-2020,RKI,4,3,1,1586304000000,07138,Neuwied,147,4,143,181941,290
DE-RP,09-04-2020,RKI,5,5,0,1586390400000,07138,Neuwied,152,4,148,181941,290
DE-RP,14-04-2020,RKI,10,10,0,1586822400000,07138,Neuwied,162,4,158,181941,290
DE-RP,16-04-2020,RKI,3,3,0,1586995200000,07138,Neuwied,165,4,161,181941,290
DE-RP,17-04-2020,RKI,0,0,0,1587081600000,07138,Neuwied,165,4,161,181941,290
DE-RP,19-04-2020,RKI,0,0,0,1587254400000,07138,Neuwied,165,4,161,181941,290
DE-RP,23-04-2020,RKI,0,0,0,1587600000000,07138,Neuwied,165,4,161,181941,290
DE-RP,24-04-2020,RKI,0,0,0,1587686400000,07138,Neuwied,165,4,161,181941,290
DE-RP,27-04-2020,RKI,0,0,0,1587945600000,07138,Neuwied,165,4,161,181941,290
DE-RP,04-05-2020,RKI,0,0,0,1588550400000,07138,Neuwied,165,4,161,181941,290
DE-RP,19-05-2020,RKI,0,0,0,1589846400000,07138,Neuwied,165,4,161,181941,290
DE-RP,29-05-2020,RKI,1,1,0,1590710400000,07138,Neuwied,166,4,162,181941,290
DE-RP,02-06-2020,RKI,0,0,0,1591056000000,07138,Neuwied,166,4,162,181941,290
DE-RP,12-06-2020,RKI,0,0,0,1591920000000,07138,Neuwied,166,4,162,181941,290
DE-RP,06-07-2020,RKI,0,0,0,1593993600000,07138,Neuwied,166,4,162,181941,290
DE-RP,09-07-2020,RKI,0,0,0,1594252800000,07138,Neuwied,166,4,162,181941,290
DE-RP,13-07-2020,RKI,7,0,0,1594598400000,07138,Neuwied,173,4,162,181941,290
DE-RP,14-07-2020,RKI,0,0,0,1594684800000,07138,Neuwied,173,4,162,181941,290
DE-RP,15-07-2020,RKI,0,0,0,1594771200000,07138,Neuwied,173,4,162,181941,290
DE-RP,11-03-2020,RKI,0,0,0,1583884800000,07140,Rhein-Hunsrück-Kreis,1,0,1,102937,104
DE-RP,12-03-2020,RKI,2,2,0,1583971200000,07140,Rhein-Hunsrück-Kreis,3,0,3,102937,104
DE-RP,13-03-2020,RKI,0,0,0,1584057600000,07140,Rhein-Hunsrück-Kreis,3,0,3,102937,104
DE-RP,14-03-2020,RKI,7,7,0,1584144000000,07140,Rhein-Hunsrück-Kreis,10,0,10,102937,104
DE-RP,15-03-2020,RKI,6,6,0,1584230400000,07140,Rhein-Hunsrück-Kreis,16,0,16,102937,104
DE-RP,16-03-2020,RKI,2,2,0,1584316800000,07140,Rhein-Hunsrück-Kreis,18,0,18,102937,104
DE-RP,17-03-2020,RKI,6,6,0,1584403200000,07140,Rhein-Hunsrück-Kreis,24,0,24,102937,104
DE-RP,18-03-2020,RKI,4,4,0,1584489600000,07140,Rhein-Hunsrück-Kreis,28,0,28,102937,104
DE-RP,19-03-2020,RKI,1,1,0,1584576000000,07140,Rhein-Hunsrück-Kreis,29,0,29,102937,104
DE-RP,20-03-2020,RKI,8,8,0,1584662400000,07140,Rhein-Hunsrück-Kreis,37,0,37,102937,104
DE-RP,21-03-2020,RKI,1,1,0,1584748800000,07140,Rhein-Hunsrück-Kreis,38,0,38,102937,104
DE-RP,22-03-2020,RKI,0,0,0,1584835200000,07140,Rhein-Hunsrück-Kreis,38,0,38,102937,104
DE-RP,23-03-2020,RKI,5,5,0,1584921600000,07140,Rhein-Hunsrück-Kreis,43,0,43,102937,104
DE-RP,24-03-2020,RKI,8,8,0,1585008000000,07140,Rhein-Hunsrück-Kreis,51,0,51,102937,104
DE-RP,25-03-2020,RKI,6,6,0,1585094400000,07140,Rhein-Hunsrück-Kreis,57,0,57,102937,104
DE-RP,26-03-2020,RKI,5,5,0,1585180800000,07140,Rhein-Hunsrück-Kreis,62,0,62,102937,104
DE-RP,27-03-2020,RKI,9,9,0,1585267200000,07140,Rhein-Hunsrück-Kreis,71,0,71,102937,104
DE-RP,28-03-2020,RKI,10,10,0,1585353600000,07140,Rhein-Hunsrück-Kreis,81,0,81,102937,104
DE-RP,29-03-2020,RKI,1,1,0,1585440000000,07140,Rhein-Hunsrück-Kreis,82,0,82,102937,104
DE-RP,30-03-2020,RKI,2,2,0,1585526400000,07140,Rhein-Hunsrück-Kreis,84,0,84,102937,104
DE-RP,31-03-2020,RKI,1,1,0,1585612800000,07140,Rhein-Hunsrück-Kreis,85,0,85,102937,104
DE-RP,01-04-2020,RKI,3,3,0,1585699200000,07140,Rhein-Hunsrück-Kreis,88,0,88,102937,104
DE-RP,02-04-2020,RKI,3,3,0,1585785600000,07140,Rhein-Hunsrück-Kreis,91,0,91,102937,104
DE-RP,03-04-2020,RKI,4,4,0,1585872000000,07140,Rhein-Hunsrück-Kreis,95,0,95,102937,104
DE-RP,04-04-2020,RKI,4,4,0,1585958400000,07140,Rhein-Hunsrück-Kreis,99,0,99,102937,104
DE-RP,06-04-2020,RKI,0,0,0,1586131200000,07140,Rhein-Hunsrück-Kreis,99,0,99,102937,104
DE-RP,07-04-2020,RKI,3,2,1,1586217600000,07140,Rhein-Hunsrück-Kreis,102,1,101,102937,104
DE-RP,08-04-2020,RKI,1,1,0,1586304000000,07140,Rhein-Hunsrück-Kreis,103,1,102,102937,104
DE-RP,09-04-2020,RKI,2,1,1,1586390400000,07140,Rhein-Hunsrück-Kreis,105,2,103,102937,104
DE-RP,10-04-2020,RKI,1,1,0,1586476800000,07140,Rhein-Hunsrück-Kreis,106,2,104,102937,104
DE-RP,11-04-2020,RKI,0,0,0,1586563200000,07140,Rhein-Hunsrück-Kreis,106,2,104,102937,104
DE-RP,12-04-2020,RKI,0,0,0,1586649600000,07140,Rhein-Hunsrück-Kreis,106,2,104,102937,104
DE-RP,13-04-2020,RKI,0,0,0,1586736000000,07140,Rhein-Hunsrück-Kreis,106,2,104,102937,104
DE-RP,14-04-2020,RKI,3,3,0,1586822400000,07140,Rhein-Hunsrück-Kreis,109,2,107,102937,104
DE-RP,15-04-2020,RKI,5,4,1,1586908800000,07140,Rhein-Hunsrück-Kreis,114,3,111,102937,104
DE-RP,16-04-2020,RKI,0,0,0,1586995200000,07140,Rhein-Hunsrück-Kreis,114,3,111,102937,104
DE-RP,17-04-2020,RKI,2,2,0,1587081600000,07140,Rhein-Hunsrück-Kreis,116,3,113,102937,104
DE-RP,19-04-2020,RKI,1,1,0,1587254400000,07140,Rhein-Hunsrück-Kreis,117,3,114,102937,104
DE-RP,20-04-2020,RKI,0,0,0,1587340800000,07140,Rhein-Hunsrück-Kreis,117,3,114,102937,104
DE-RP,22-04-2020,RKI,2,1,1,1587513600000,07140,Rhein-Hunsrück-Kreis,119,4,115,102937,104
DE-RP,23-04-2020,RKI,0,0,0,1587600000000,07140,Rhein-Hunsrück-Kreis,119,4,115,102937,104
DE-RP,29-04-2020,RKI,0,0,0,1588118400000,07140,Rhein-Hunsrück-Kreis,119,4,115,102937,104
DE-RP,05-05-2020,RKI,0,0,0,1588636800000,07140,Rhein-Hunsrück-Kreis,119,4,115,102937,104
DE-RP,29-05-2020,RKI,0,0,0,1590710400000,07140,Rhein-Hunsrück-Kreis,119,4,115,102937,104
DE-RP,03-06-2020,RKI,3,3,0,1591142400000,07140,Rhein-Hunsrück-Kreis,122,4,118,102937,104
DE-RP,09-07-2020,RKI,0,0,0,1594252800000,07140,Rhein-Hunsrück-Kreis,122,4,118,102937,104
DE-RP,15-07-2020,RKI,0,0,0,1594771200000,07140,Rhein-Hunsrück-Kreis,122,4,118,102937,104
DE-RP,12-03-2020,RKI,0,0,0,1583971200000,07141,Rhein-Lahn-Kreis,3,0,3,122308,156
DE-RP,13-03-2020,RKI,0,0,0,1584057600000,07141,Rhein-Lahn-Kreis,3,0,3,122308,156
DE-RP,16-03-2020,RKI,3,2,1,1584316800000,07141,Rhein-Lahn-Kreis,6,1,5,122308,156
DE-RP,17-03-2020,RKI,5,5,0,1584403200000,07141,Rhein-Lahn-Kreis,11,1,10,122308,156
DE-RP,18-03-2020,RKI,9,9,0,1584489600000,07141,Rhein-Lahn-Kreis,20,1,19,122308,156
DE-RP,19-03-2020,RKI,5,5,0,1584576000000,07141,Rhein-Lahn-Kreis,25,1,24,122308,156
DE-RP,21-03-2020,RKI,1,1,0,1584748800000,07141,Rhein-Lahn-Kreis,26,1,25,122308,156
DE-RP,22-03-2020,RKI,2,2,0,1584835200000,07141,Rhein-Lahn-Kreis,28,1,27,122308,156
DE-RP,23-03-2020,RKI,8,8,0,1584921600000,07141,Rhein-Lahn-Kreis,36,1,35,122308,156
DE-RP,24-03-2020,RKI,2,2,0,1585008000000,07141,Rhein-Lahn-Kreis,38,1,37,122308,156
DE-RP,25-03-2020,RKI,8,8,0,1585094400000,07141,Rhein-Lahn-Kreis,46,1,45,122308,156
DE-RP,26-03-2020,RKI,7,6,1,1585180800000,07141,Rhein-Lahn-Kreis,53,2,51,122308,156
DE-RP,27-03-2020,RKI,5,5,0,1585267200000,07141,Rhein-Lahn-Kreis,58,2,56,122308,156
DE-RP,28-03-2020,RKI,4,3,1,1585353600000,07141,Rhein-Lahn-Kreis,62,3,59,122308,156
DE-RP,29-03-2020,RKI,0,0,0,1585440000000,07141,Rhein-Lahn-Kreis,62,3,59,122308,156
DE-RP,30-03-2020,RKI,5,5,0,1585526400000,07141,Rhein-Lahn-Kreis,67,3,64,122308,156
DE-RP,31-03-2020,RKI,2,1,1,1585612800000,07141,Rhein-Lahn-Kreis,69,4,65,122308,156
DE-RP,01-04-2020,RKI,6,6,0,1585699200000,07141,Rhein-Lahn-Kreis,75,4,71,122308,156
DE-RP,02-04-2020,RKI,10,9,1,1585785600000,07141,Rhein-Lahn-Kreis,85,5,80,122308,156
DE-RP,04-04-2020,RKI,4,4,0,1585958400000,07141,Rhein-Lahn-Kreis,89,5,84,122308,156
DE-RP,05-04-2020,RKI,2,2,0,1586044800000,07141,Rhein-Lahn-Kreis,91,5,86,122308,156
DE-RP,06-04-2020,RKI,2,2,0,1586131200000,07141,Rhein-Lahn-Kreis,93,5,88,122308,156
DE-RP,07-04-2020,RKI,2,2,0,1586217600000,07141,Rhein-Lahn-Kreis,95,5,90,122308,156
DE-RP,08-04-2020,RKI,5,5,0,1586304000000,07141,Rhein-Lahn-Kreis,100,5,95,122308,156
DE-RP,09-04-2020,RKI,2,2,0,1586390400000,07141,Rhein-Lahn-Kreis,102,5,97,122308,156
DE-RP,10-04-2020,RKI,0,0,0,1586476800000,07141,Rhein-Lahn-Kreis,102,5,97,122308,156
DE-RP,11-04-2020,RKI,1,1,0,1586563200000,07141,Rhein-Lahn-Kreis,103,5,98,122308,156
DE-RP,12-04-2020,RKI,1,1,0,1586649600000,07141,Rhein-Lahn-Kreis,104,5,99,122308,156
DE-RP,14-04-2020,RKI,1,1,0,1586822400000,07141,Rhein-Lahn-Kreis,105,5,100,122308,156
DE-RP,15-04-2020,RKI,0,0,0,1586908800000,07141,Rhein-Lahn-Kreis,105,5,100,122308,156
DE-RP,16-04-2020,RKI,2,2,0,1586995200000,07141,Rhein-Lahn-Kreis,107,5,102,122308,156
DE-RP,17-04-2020,RKI,7,7,0,1587081600000,07141,Rhein-Lahn-Kreis,114,5,109,122308,156
DE-RP,18-04-2020,RKI,1,1,0,1587168000000,07141,Rhein-Lahn-Kreis,115,5,110,122308,156
DE-RP,24-04-2020,RKI,0,0,0,1587686400000,07141,Rhein-Lahn-Kreis,115,5,110,122308,156
DE-RP,26-04-2020,RKI,0,0,0,1587859200000,07141,Rhein-Lahn-Kreis,115,5,110,122308,156
DE-RP,30-04-2020,RKI,0,0,0,1588204800000,07141,Rhein-Lahn-Kreis,115,5,110,122308,156
DE-RP,04-05-2020,RKI,1,1,0,1588550400000,07141,Rhein-Lahn-Kreis,116,5,111,122308,156
DE-RP,06-05-2020,RKI,1,1,0,1588723200000,07141,Rhein-Lahn-Kreis,117,5,112,122308,156
DE-RP,11-05-2020,RKI,0,0,0,1589155200000,07141,Rhein-Lahn-Kreis,117,5,112,122308,156
DE-RP,02-06-2020,RKI,0,0,0,1591056000000,07141,Rhein-Lahn-Kreis,117,5,112,122308,156
DE-RP,11-03-2020,RKI,0,0,0,1583884800000,07143,Westerwaldkreis,2,0,2,201597,204
DE-RP,12-03-2020,RKI,4,4,0,1583971200000,07143,Westerwaldkreis,6,0,6,201597,204
DE-RP,13-03-2020,RKI,3,3,0,1584057600000,07143,Westerwaldkreis,9,0,9,201597,204
DE-RP,14-03-2020,RKI,2,2,0,1584144000000,07143,Westerwaldkreis,11,0,11,201597,204
DE-RP,15-03-2020,RKI,4,4,0,1584230400000,07143,Westerwaldkreis,15,0,15,201597,204
DE-RP,16-03-2020,RKI,2,2,0,1584316800000,07143,Westerwaldkreis,17,0,17,201597,204
DE-RP,17-03-2020,RKI,8,8,0,1584403200000,07143,Westerwaldkreis,25,0,25,201597,204
DE-RP,18-03-2020,RKI,10,10,0,1584489600000,07143,Westerwaldkreis,35,0,35,201597,204
DE-RP,19-03-2020,RKI,4,3,1,1584576000000,07143,Westerwaldkreis,39,1,38,201597,204
DE-RP,20-03-2020,RKI,11,11,0,1584662400000,07143,Westerwaldkreis,50,1,49,201597,204
DE-RP,22-03-2020,RKI,13,13,0,1584835200000,07143,Westerwaldkreis,63,1,62,201597,204
DE-RP,23-03-2020,RKI,18,18,0,1584921600000,07143,Westerwaldkreis,81,1,80,201597,204
DE-RP,24-03-2020,RKI,3,2,1,1585008000000,07143,Westerwaldkreis,84,2,82,201597,204
DE-RP,25-03-2020,RKI,4,4,0,1585094400000,07143,Westerwaldkreis,88,2,86,201597,204
DE-RP,26-03-2020,RKI,7,7,0,1585180800000,07143,Westerwaldkreis,95,2,93,201597,204
DE-RP,27-03-2020,RKI,16,16,0,1585267200000,07143,Westerwaldkreis,111,2,109,201597,204
DE-RP,28-03-2020,RKI,5,4,1,1585353600000,07143,Westerwaldkreis,116,3,113,201597,204
DE-RP,29-03-2020,RKI,3,3,0,1585440000000,07143,Westerwaldkreis,119,3,116,201597,204
DE-RP,30-03-2020,RKI,6,5,1,1585526400000,07143,Westerwaldkreis,125,4,121,201597,204
DE-RP,31-03-2020,RKI,12,12,0,1585612800000,07143,Westerwaldkreis,137,4,133,201597,204
DE-RP,01-04-2020,RKI,14,11,3,1585699200000,07143,Westerwaldkreis,151,7,144,201597,204
DE-RP,02-04-2020,RKI,6,6,0,1585785600000,07143,Westerwaldkreis,157,7,150,201597,204
DE-RP,03-04-2020,RKI,5,5,0,1585872000000,07143,Westerwaldkreis,162,7,155,201597,204
DE-RP,04-04-2020,RKI,7,5,2,1585958400000,07143,Westerwaldkreis,169,9,160,201597,204
DE-RP,05-04-2020,RKI,5,5,0,1586044800000,07143,Westerwaldkreis,174,9,165,201597,204
DE-RP,06-04-2020,RKI,7,5,2,1586131200000,07143,Westerwaldkreis,181,11,170,201597,204
DE-RP,07-04-2020,RKI,28,22,6,1586217600000,07143,Westerwaldkreis,209,17,192,201597,204
DE-RP,08-04-2020,RKI,17,15,2,1586304000000,07143,Westerwaldkreis,226,19,207,201597,204
DE-RP,09-04-2020,RKI,4,4,0,1586390400000,07143,Westerwaldkreis,230,19,211,201597,204
DE-RP,10-04-2020,RKI,6,6,0,1586476800000,07143,Westerwaldkreis,236,19,217,201597,204
DE-RP,11-04-2020,RKI,0,0,0,1586563200000,07143,Westerwaldkreis,236,19,217,201597,204
DE-RP,12-04-2020,RKI,3,3,0,1586649600000,07143,Westerwaldkreis,239,19,220,201597,204
DE-RP,13-04-2020,RKI,11,9,2,1586736000000,07143,Westerwaldkreis,250,21,229,201597,204
DE-RP,14-04-2020,RKI,1,0,1,1586822400000,07143,Westerwaldkreis,251,22,229,201597,204
DE-RP,15-04-2020,RKI,3,3,0,1586908800000,07143,Westerwaldkreis,254,22,232,201597,204
DE-RP,16-04-2020,RKI,3,3,0,1586995200000,07143,Westerwaldkreis,257,22,235,201597,204
DE-RP,17-04-2020,RKI,13,13,0,1587081600000,07143,Westerwaldkreis,270,22,248,201597,204
DE-RP,18-04-2020,RKI,4,4,0,1587168000000,07143,Westerwaldkreis,274,22,252,201597,204
DE-RP,20-04-2020,RKI,0,0,0,1587340800000,07143,Westerwaldkreis,274,22,252,201597,204
DE-RP,21-04-2020,RKI,1,1,0,1587427200000,07143,Westerwaldkreis,275,22,253,201597,204
DE-RP,23-04-2020,RKI,2,2,0,1587600000000,07143,Westerwaldkreis,277,22,255,201597,204
DE-RP,24-04-2020,RKI,2,2,0,1587686400000,07143,Westerwaldkreis,279,22,257,201597,204
DE-RP,25-04-2020,RKI,0,0,0,1587772800000,07143,Westerwaldkreis,279,22,257,201597,204
DE-RP,26-04-2020,RKI,0,0,0,1587859200000,07143,Westerwaldkreis,279,22,257,201597,204
DE-RP,29-04-2020,RKI,0,0,0,1588118400000,07143,Westerwaldkreis,279,22,257,201597,204
DE-RP,30-04-2020,RKI,2,2,0,1588204800000,07143,Westerwaldkreis,281,22,259,201597,204
DE-RP,01-05-2020,RKI,1,1,0,1588291200000,07143,Westerwaldkreis,282,22,260,201597,204
DE-RP,05-05-2020,RKI,0,0,0,1588636800000,07143,Westerwaldkreis,282,22,260,201597,204
DE-RP,06-05-2020,RKI,0,0,0,1588723200000,07143,Westerwaldkreis,282,22,260,201597,204
DE-RP,07-05-2020,RKI,6,6,0,1588809600000,07143,Westerwaldkreis,288,22,266,201597,204
DE-RP,08-05-2020,RKI,1,1,0,1588896000000,07143,Westerwaldkreis,289,22,267,201597,204
DE-RP,09-05-2020,RKI,0,0,0,1588982400000,07143,Westerwaldkreis,289,22,267,201597,204
DE-RP,11-05-2020,RKI,0,0,0,1589155200000,07143,Westerwaldkreis,289,22,267,201597,204
DE-RP,12-05-2020,RKI,0,0,0,1589241600000,07143,Westerwaldkreis,289,22,267,201597,204
DE-RP,14-05-2020,RKI,1,1,0,1589414400000,07143,Westerwaldkreis,290,22,268,201597,204
DE-RP,16-05-2020,RKI,2,2,0,1589587200000,07143,Westerwaldkreis,292,22,270,201597,204
DE-RP,18-05-2020,RKI,1,1,0,1589760000000,07143,Westerwaldkreis,293,22,271,201597,204
DE-RP,20-05-2020,RKI,2,2,0,1589932800000,07143,Westerwaldkreis,295,22,273,201597,204
DE-RP,27-05-2020,RKI,0,0,0,1590537600000,07143,Westerwaldkreis,295,22,273,201597,204
DE-RP,30-05-2020,RKI,1,1,0,1590796800000,07143,Westerwaldkreis,296,22,274,201597,204
DE-RP,03-06-2020,RKI,0,0,0,1591142400000,07143,Westerwaldkreis,296,22,274,201597,204
DE-RP,04-06-2020,RKI,0,0,0,1591228800000,07143,Westerwaldkreis,296,22,274,201597,204
DE-RP,15-06-2020,RKI,1,1,0,1592179200000,07143,Westerwaldkreis,297,22,275,201597,204
DE-RP,17-06-2020,RKI,2,2,0,1592352000000,07143,Westerwaldkreis,299,22,277,201597,204
DE-RP,18-06-2020,RKI,0,0,0,1592438400000,07143,Westerwaldkreis,299,22,277,201597,204
DE-RP,20-06-2020,RKI,2,2,0,1592611200000,07143,Westerwaldkreis,301,22,279,201597,204
DE-RP,27-06-2020,RKI,0,0,0,1593216000000,07143,Westerwaldkreis,301,22,279,201597,204
DE-RP,30-06-2020,RKI,8,8,0,1593475200000,07143,Westerwaldkreis,309,22,287,201597,204
DE-RP,02-07-2020,RKI,0,0,0,1593648000000,07143,Westerwaldkreis,309,22,287,201597,204
DE-RP,06-07-2020,RKI,1,0,0,1593993600000,07143,Westerwaldkreis,310,22,287,201597,204
DE-RP,14-07-2020,RKI,0,0,0,1594684800000,07143,Westerwaldkreis,310,22,287,201597,204
DE-RP,15-07-2020,RKI,0,0,0,1594771200000,07143,Westerwaldkreis,310,22,287,201597,204
DE-RP,16-07-2020,RKI,2,0,0,1594857600000,07143,Westerwaldkreis,312,22,287,201597,204
DE-RP,15-03-2020,RKI,2,2,0,1584230400000,07211,Trier,4,0,4,110636,945
DE-RP,16-03-2020,RKI,0,0,0,1584316800000,07211,Trier,4,0,4,110636,945
DE-RP,17-03-2020,RKI,2,2,0,1584403200000,07211,Trier,6,0,6,110636,945
DE-RP,18-03-2020,RKI,0,0,0,1584489600000,07211,Trier,6,0,6,110636,945
DE-RP,19-03-2020,RKI,0,0,0,1584576000000,07211,Trier,6,0,6,110636,945
DE-RP,21-03-2020,RKI,3,3,0,1584748800000,07211,Trier,9,0,9,110636,945
DE-RP,22-03-2020,RKI,3,3,0,1584835200000,07211,Trier,12,0,12,110636,945
DE-RP,23-03-2020,RKI,0,0,0,1584921600000,07211,Trier,12,0,12,110636,945
DE-RP,24-03-2020,RKI,2,2,0,1585008000000,07211,Trier,14,0,14,110636,945
DE-RP,26-03-2020,RKI,4,4,0,1585180800000,07211,Trier,18,0,18,110636,945
DE-RP,27-03-2020,RKI,7,7,0,1585267200000,07211,Trier,25,0,25,110636,945
DE-RP,28-03-2020,RKI,5,5,0,1585353600000,07211,Trier,30,0,30,110636,945
DE-RP,29-03-2020,RKI,12,12,0,1585440000000,07211,Trier,42,0,42,110636,945
DE-RP,30-03-2020,RKI,2,2,0,1585526400000,07211,Trier,44,0,44,110636,945
DE-RP,31-03-2020,RKI,0,0,0,1585612800000,07211,Trier,44,0,44,110636,945
DE-RP,01-04-2020,RKI,4,4,0,1585699200000,07211,Trier,48,0,48,110636,945
DE-RP,02-04-2020,RKI,3,3,0,1585785600000,07211,Trier,51,0,51,110636,945
DE-RP,03-04-2020,RKI,1,1,0,1585872000000,07211,Trier,52,0,52,110636,945
DE-RP,05-04-2020,RKI,0,0,0,1586044800000,07211,Trier,52,0,52,110636,945
DE-RP,06-04-2020,RKI,2,2,0,1586131200000,07211,Trier,54,0,54,110636,945
DE-RP,07-04-2020,RKI,5,5,0,1586217600000,07211,Trier,59,0,59,110636,945
DE-RP,08-04-2020,RKI,0,0,0,1586304000000,07211,Trier,59,0,59,110636,945
DE-RP,09-04-2020,RKI,0,0,0,1586390400000,07211,Trier,59,0,59,110636,945
DE-RP,12-04-2020,RKI,4,4,0,1586649600000,07211,Trier,63,0,63,110636,945
DE-RP,13-04-2020,RKI,1,1,0,1586736000000,07211,Trier,64,0,64,110636,945
DE-RP,16-04-2020,RKI,1,1,0,1586995200000,07211,Trier,65,0,65,110636,945
DE-RP,17-04-2020,RKI,1,1,0,1587081600000,07211,Trier,66,0,66,110636,945
DE-RP,24-04-2020,RKI,1,1,0,1587686400000,07211,Trier,67,0,67,110636,945
DE-RP,29-04-2020,RKI,0,0,0,1588118400000,07211,Trier,67,0,67,110636,945
DE-RP,30-04-2020,RKI,1,1,0,1588204800000,07211,Trier,68,0,68,110636,945
DE-RP,06-05-2020,RKI,0,0,0,1588723200000,07211,Trier,68,0,68,110636,945
DE-RP,14-05-2020,RKI,0,0,0,1589414400000,07211,Trier,68,0,68,110636,945
DE-RP,22-05-2020,RKI,0,0,0,1590105600000,07211,Trier,68,0,68,110636,945
DE-RP,17-06-2020,RKI,0,0,0,1592352000000,07211,Trier,68,0,68,110636,945
DE-RP,01-07-2020,RKI,0,0,0,1593561600000,07211,Trier,68,0,68,110636,945
DE-RP,05-07-2020,RKI,0,0,0,1593907200000,07211,Trier,68,0,68,110636,945
DE-RP,08-07-2020,RKI,0,0,0,1594166400000,07211,Trier,68,0,68,110636,945
DE-RP,10-07-2020,RKI,4,0,0,1594339200000,07211,Trier,72,0,68,110636,945
DE-RP,11-07-2020,RKI,0,0,0,1594425600000,07211,Trier,72,0,68,110636,945
DE-RP,12-07-2020,RKI,0,0,0,1594512000000,07211,Trier,72,0,68,110636,945
DE-RP,13-07-2020,RKI,2,0,0,1594598400000,07211,Trier,74,0,68,110636,945
DE-RP,15-07-2020,RKI,1,0,0,1594771200000,07211,Trier,75,0,68,110636,945
DE-RP,11-03-2020,RKI,0,0,0,1583884800000,07231,Bernkastel-Wittlich,0,0,0,112262,96
DE-RP,12-03-2020,RKI,0,0,0,1583971200000,07231,Bernkastel-Wittlich,0,0,0,112262,96
DE-RP,16-03-2020,RKI,0,0,0,1584316800000,07231,Bernkastel-Wittlich,0,0,0,112262,96
DE-RP,17-03-2020,RKI,0,0,0,1584403200000,07231,Bernkastel-Wittlich,0,0,0,112262,96
DE-RP,18-03-2020,RKI,0,0,0,1584489600000,07231,Bernkastel-Wittlich,0,0,0,112262,96
DE-RP,19-03-2020,RKI,5,5,0,1584576000000,07231,Bernkastel-Wittlich,5,0,5,112262,96
DE-RP,20-03-2020,RKI,2,2,0,1584662400000,07231,Bernkastel-Wittlich,7,0,7,112262,96
DE-RP,21-03-2020,RKI,2,2,0,1584748800000,07231,Bernkastel-Wittlich,9,0,9,112262,96
DE-RP,22-03-2020,RKI,1,1,0,1584835200000,07231,Bernkastel-Wittlich,10,0,10,112262,96
DE-RP,23-03-2020,RKI,0,0,0,1584921600000,07231,Bernkastel-Wittlich,10,0,10,112262,96
DE-RP,24-03-2020,RKI,5,5,0,1585008000000,07231,Bernkastel-Wittlich,15,0,15,112262,96
DE-RP,25-03-2020,RKI,2,2,0,1585094400000,07231,Bernkastel-Wittlich,17,0,17,112262,96
DE-RP,26-03-2020,RKI,5,5,0,1585180800000,07231,Bernkastel-Wittlich,22,0,22,112262,96
DE-RP,27-03-2020,RKI,6,6,0,1585267200000,07231,Bernkastel-Wittlich,28,0,28,112262,96
DE-RP,28-03-2020,RKI,2,2,0,1585353600000,07231,Bernkastel-Wittlich,30,0,30,112262,96
DE-RP,29-03-2020,RKI,6,6,0,1585440000000,07231,Bernkastel-Wittlich,36,0,36,112262,96
DE-RP,30-03-2020,RKI,5,5,0,1585526400000,07231,Bernkastel-Wittlich,41,0,41,112262,96
DE-RP,31-03-2020,RKI,4,3,1,1585612800000,07231,Bernkastel-Wittlich,45,1,44,112262,96
DE-RP,02-04-2020,RKI,6,6,0,1585785600000,07231,Bernkastel-Wittlich,51,1,50,112262,96
DE-RP,03-04-2020,RKI,3,3,0,1585872000000,07231,Bernkastel-Wittlich,54,1,53,112262,96
DE-RP,04-04-2020,RKI,1,0,1,1585958400000,07231,Bernkastel-Wittlich,55,2,53,112262,96
DE-RP,05-04-2020,RKI,4,4,0,1586044800000,07231,Bernkastel-Wittlich,59,2,57,112262,96
DE-RP,06-04-2020,RKI,1,1,0,1586131200000,07231,Bernkastel-Wittlich,60,2,58,112262,96
DE-RP,07-04-2020,RKI,5,5,0,1586217600000,07231,Bernkastel-Wittlich,65,2,63,112262,96
DE-RP,08-04-2020,RKI,3,3,0,1586304000000,07231,Bernkastel-Wittlich,68,2,66,112262,96
DE-RP,09-04-2020,RKI,8,8,0,1586390400000,07231,Bernkastel-Wittlich,76,2,74,112262,96
DE-RP,10-04-2020,RKI,2,2,0,1586476800000,07231,Bernkastel-Wittlich,78,2,76,112262,96
DE-RP,11-04-2020,RKI,0,0,0,1586563200000,07231,Bernkastel-Wittlich,78,2,76,112262,96
DE-RP,13-04-2020,RKI,2,2,0,1586736000000,07231,Bernkastel-Wittlich,80,2,78,112262,96
DE-RP,14-04-2020,RKI,0,0,0,1586822400000,07231,Bernkastel-Wittlich,80,2,78,112262,96
DE-RP,15-04-2020,RKI,0,0,0,1586908800000,07231,Bernkastel-Wittlich,80,2,78,112262,96
DE-RP,16-04-2020,RKI,1,1,0,1586995200000,07231,Bernkastel-Wittlich,81,2,79,112262,96
DE-RP,17-04-2020,RKI,2,2,0,1587081600000,07231,Bernkastel-Wittlich,83,2,81,112262,96
DE-RP,20-04-2020,RKI,0,0,0,1587340800000,07231,Bernkastel-Wittlich,83,2,81,112262,96
DE-RP,22-04-2020,RKI,0,0,0,1587513600000,07231,Bernkastel-Wittlich,83,2,81,112262,96
DE-RP,23-04-2020,RKI,2,2,0,1587600000000,07231,Bernkastel-Wittlich,85,2,83,112262,96
DE-RP,25-04-2020,RKI,0,0,0,1587772800000,07231,Bernkastel-Wittlich,85,2,83,112262,96
DE-RP,29-04-2020,RKI,1,1,0,1588118400000,07231,Bernkastel-Wittlich,86,2,84,112262,96
DE-RP,30-04-2020,RKI,0,0,0,1588204800000,07231,Bernkastel-Wittlich,86,2,84,112262,96
DE-RP,02-05-2020,RKI,1,1,0,1588377600000,07231,Bernkastel-Wittlich,87,2,85,112262,96
DE-RP,06-05-2020,RKI,0,0,0,1588723200000,07231,Bernkastel-Wittlich,87,2,85,112262,96
DE-RP,07-05-2020,RKI,5,5,0,1588809600000,07231,Bernkastel-Wittlich,92,2,90,112262,96
DE-RP,10-05-2020,RKI,2,2,0,1589068800000,07231,Bernkastel-Wittlich,94,2,92,112262,96
DE-RP,11-05-2020,RKI,0,0,0,1589155200000,07231,Bernkastel-Wittlich,94,2,92,112262,96
DE-RP,12-05-2020,RKI,0,0,0,1589241600000,07231,Bernkastel-Wittlich,94,2,92,112262,96
DE-RP,13-05-2020,RKI,1,1,0,1589328000000,07231,Bernkastel-Wittlich,95,2,93,112262,96
DE-RP,14-05-2020,RKI,3,3,0,1589414400000,07231,Bernkastel-Wittlich,98,2,96,112262,96
DE-RP,16-05-2020,RKI,0,0,0,1589587200000,07231,Bernkastel-Wittlich,98,2,96,112262,96
DE-RP,17-05-2020,RKI,0,0,0,1589673600000,07231,Bernkastel-Wittlich,98,2,96,112262,96
DE-RP,20-05-2020,RKI,0,0,0,1589932800000,07231,Bernkastel-Wittlich,98,2,96,112262,96
DE-RP,27-05-2020,RKI,3,3,0,1590537600000,07231,Bernkastel-Wittlich,101,2,99,112262,96
DE-RP,29-05-2020,RKI,2,2,0,1590710400000,07231,Bernkastel-Wittlich,103,2,101,112262,96
DE-RP,01-06-2020,RKI,0,0,0,1590969600000,07231,Bernkastel-Wittlich,103,2,101,112262,96
DE-RP,04-06-2020,RKI,1,1,0,1591228800000,07231,Bernkastel-Wittlich,104,2,102,112262,96
DE-RP,06-06-2020,RKI,0,0,0,1591401600000,07231,Bernkastel-Wittlich,104,2,102,112262,96
DE-RP,07-06-2020,RKI,0,0,0,1591488000000,07231,Bernkastel-Wittlich,104,2,102,112262,96
DE-RP,14-06-2020,RKI,0,0,0,1592092800000,07231,Bernkastel-Wittlich,104,2,102,112262,96
DE-RP,17-06-2020,RKI,0,0,0,1592352000000,07231,Bernkastel-Wittlich,104,2,102,112262,96
DE-RP,19-06-2020,RKI,2,2,0,1592524800000,07231,Bernkastel-Wittlich,106,2,104,112262,96
DE-RP,23-06-2020,RKI,1,1,0,1592870400000,07231,Bernkastel-Wittlich,107,2,105,112262,96
DE-RP,26-06-2020,RKI,1,1,0,1593129600000,07231,Bernkastel-Wittlich,108,2,106,112262,96
DE-RP,28-06-2020,RKI,0,0,0,1593302400000,07231,Bernkastel-Wittlich,108,2,106,112262,96
DE-RP,01-07-2020,RKI,0,0,0,1593561600000,07231,Bernkastel-Wittlich,108,2,106,112262,96
DE-RP,04-07-2020,RKI,0,0,0,1593820800000,07231,Bernkastel-Wittlich,108,2,106,112262,96
DE-RP,08-07-2020,RKI,2,0,0,1594166400000,07231,Bernkastel-Wittlich,110,2,106,112262,96
DE-RP,11-07-2020,RKI,0,0,0,1594425600000,07231,Bernkastel-Wittlich,110,2,106,112262,96
DE-RP,16-07-2020,RKI,1,0,0,1594857600000,07231,Bernkastel-Wittlich,111,2,106,112262,96
DE-RP,12-03-2020,RKI,2,2,0,1583971200000,07232,Bitburg-Prüm,2,0,2,98561,61
DE-RP,13-03-2020,RKI,1,1,0,1584057600000,07232,Bitburg-Prüm,3,0,3,98561,61
DE-RP,14-03-2020,RKI,5,5,0,1584144000000,07232,Bitburg-Prüm,8,0,8,98561,61
DE-RP,15-03-2020,RKI,2,2,0,1584230400000,07232,Bitburg-Prüm,10,0,10,98561,61
DE-RP,16-03-2020,RKI,3,3,0,1584316800000,07232,Bitburg-Prüm,13,0,13,98561,61
DE-RP,17-03-2020,RKI,1,1,0,1584403200000,07232,Bitburg-Prüm,14,0,14,98561,61
DE-RP,18-03-2020,RKI,6,6,0,1584489600000,07232,Bitburg-Prüm,20,0,20,98561,61
DE-RP,19-03-2020,RKI,1,1,0,1584576000000,07232,Bitburg-Prüm,21,0,21,98561,61
DE-RP,20-03-2020,RKI,5,5,0,1584662400000,07232,Bitburg-Prüm,26,0,26,98561,61
DE-RP,21-03-2020,RKI,4,4,0,1584748800000,07232,Bitburg-Prüm,30,0,30,98561,61
DE-RP,22-03-2020,RKI,1,1,0,1584835200000,07232,Bitburg-Prüm,31,0,31,98561,61
DE-RP,23-03-2020,RKI,1,1,0,1584921600000,07232,Bitburg-Prüm,32,0,32,98561,61
DE-RP,24-03-2020,RKI,8,8,0,1585008000000,07232,Bitburg-Prüm,40,0,40,98561,61
DE-RP,25-03-2020,RKI,1,1,0,1585094400000,07232,Bitburg-Prüm,41,0,41,98561,61
DE-RP,26-03-2020,RKI,16,15,1,1585180800000,07232,Bitburg-Prüm,57,1,56,98561,61
DE-RP,27-03-2020,RKI,3,3,0,1585267200000,07232,Bitburg-Prüm,60,1,59,98561,61
DE-RP,28-03-2020,RKI,10,9,1,1585353600000,07232,Bitburg-Prüm,70,2,68,98561,61
DE-RP,29-03-2020,RKI,0,0,0,1585440000000,07232,Bitburg-Prüm,70,2,68,98561,61
DE-RP,30-03-2020,RKI,4,3,1,1585526400000,07232,Bitburg-Prüm,74,3,71,98561,61
DE-RP,01-04-2020,RKI,15,15,0,1585699200000,07232,Bitburg-Prüm,89,3,86,98561,61
DE-RP,02-04-2020,RKI,1,1,0,1585785600000,07232,Bitburg-Prüm,90,3,87,98561,61
DE-RP,03-04-2020,RKI,2,1,1,1585872000000,07232,Bitburg-Prüm,92,4,88,98561,61
DE-RP,04-04-2020,RKI,0,0,0,1585958400000,07232,Bitburg-Prüm,92,4,88,98561,61
DE-RP,05-04-2020,RKI,2,2,0,1586044800000,07232,Bitburg-Prüm,94,4,90,98561,61
DE-RP,06-04-2020,RKI,4,4,0,1586131200000,07232,Bitburg-Prüm,98,4,94,98561,61
DE-RP,07-04-2020,RKI,1,1,0,1586217600000,07232,Bitburg-Prüm,99,4,95,98561,61
DE-RP,08-04-2020,RKI,0,0,0,1586304000000,07232,Bitburg-Prüm,99,4,95,98561,61
DE-RP,09-04-2020,RKI,2,2,0,1586390400000,07232,Bitburg-Prüm,101,4,97,98561,61
DE-RP,11-04-2020,RKI,2,2,0,1586563200000,07232,Bitburg-Prüm,103,4,99,98561,61
DE-RP,12-04-2020,RKI,0,0,0,1586649600000,07232,Bitburg-Prüm,103,4,99,98561,61
DE-RP,13-04-2020,RKI,2,2,0,1586736000000,07232,Bitburg-Prüm,105,4,101,98561,61
DE-RP,14-04-2020,RKI,3,3,0,1586822400000,07232,Bitburg-Prüm,108,4,104,98561,61
DE-RP,15-04-2020,RKI,1,1,0,1586908800000,07232,Bitburg-Prüm,109,4,105,98561,61
DE-RP,16-04-2020,RKI,2,2,0,1586995200000,07232,Bitburg-Prüm,111,4,107,98561,61
DE-RP,17-04-2020,RKI,1,1,0,1587081600000,07232,Bitburg-Prüm,112,4,108,98561,61
DE-RP,18-04-2020,RKI,2,2,0,1587168000000,07232,Bitburg-Prüm,114,4,110,98561,61
DE-RP,19-04-2020,RKI,2,2,0,1587254400000,07232,Bitburg-Prüm,116,4,112,98561,61
DE-RP,20-04-2020,RKI,0,0,0,1587340800000,07232,Bitburg-Prüm,116,4,112,98561,61
DE-RP,21-04-2020,RKI,1,1,0,1587427200000,07232,Bitburg-Prüm,117,4,113,98561,61
DE-RP,22-04-2020,RKI,0,0,0,1587513600000,07232,Bitburg-Prüm,117,4,113,98561,61
DE-RP,23-04-2020,RKI,0,0,0,1587600000000,07232,Bitburg-Prüm,117,4,113,98561,61
DE-RP,24-04-2020,RKI,2,2,0,1587686400000,07232,Bitburg-Prüm,119,4,115,98561,61
DE-RP,25-04-2020,RKI,0,0,0,1587772800000,07232,Bitburg-Prüm,119,4,115,98561,61
DE-RP,26-04-2020,RKI,1,1,0,1587859200000,07232,Bitburg-Prüm,120,4,116,98561,61
DE-RP,28-04-2020,RKI,0,0,0,1588032000000,07232,Bitburg-Prüm,120,4,116,98561,61
DE-RP,29-04-2020,RKI,0,0,0,1588118400000,07232,Bitburg-Prüm,120,4,116,98561,61
DE-RP,30-04-2020,RKI,1,0,1,1588204800000,07232,Bitburg-Prüm,121,5,116,98561,61
DE-RP,01-05-2020,RKI,1,1,0,1588291200000,07232,Bitburg-Prüm,122,5,117,98561,61
DE-RP,04-05-2020,RKI,0,0,0,1588550400000,07232,Bitburg-Prüm,122,5,117,98561,61
DE-RP,06-05-2020,RKI,1,1,0,1588723200000,07232,Bitburg-Prüm,123,5,118,98561,61
DE-RP,09-05-2020,RKI,0,0,0,1588982400000,07232,Bitburg-Prüm,123,5,118,98561,61
DE-RP,11-05-2020,RKI,0,0,0,1589155200000,07232,Bitburg-Prüm,123,5,118,98561,61
DE-RP,12-05-2020,RKI,1,1,0,1589241600000,07232,Bitburg-Prüm,124,5,119,98561,61
DE-RP,13-05-2020,RKI,0,0,0,1589328000000,07232,Bitburg-Prüm,124,5,119,98561,61
DE-RP,14-05-2020,RKI,0,0,0,1589414400000,07232,Bitburg-Prüm,124,5,119,98561,61
DE-RP,20-05-2020,RKI,0,0,0,1589932800000,07232,Bitburg-Prüm,124,5,119,98561,61
DE-RP,16-06-2020,RKI,0,0,0,1592265600000,07232,Bitburg-Prüm,124,5,119,98561,61
DE-RP,18-06-2020,RKI,0,0,0,1592438400000,07232,Bitburg-Prüm,124,5,119,98561,61
DE-RP,19-06-2020,RKI,0,0,0,1592524800000,07232,Bitburg-Prüm,124,5,119,98561,61
DE-RP,22-06-2020,RKI,0,0,0,1592784000000,07232,Bitburg-Prüm,124,5,119,98561,61
DE-RP,23-06-2020,RKI,8,6,0,1592870400000,07232,Bitburg-Prüm,132,5,125,98561,61
DE-RP,26-06-2020,RKI,1,1,0,1593129600000,07232,Bitburg-Prüm,133,5,126,98561,61
DE-RP,11-07-2020,RKI,0,0,0,1594425600000,07232,Bitburg-Prüm,133,5,126,98561,61
DE-RP,12-07-2020,RKI,2,0,0,1594512000000,07232,Bitburg-Prüm,135,5,126,98561,61
DE-RP,14-07-2020,RKI,0,0,0,1594684800000,07232,Bitburg-Prüm,135,5,126,98561,61
DE-RP,15-07-2020,RKI,0,0,0,1594771200000,07232,Bitburg-Prüm,135,5,126,98561,61
DE-RP,16-07-2020,RKI,4,0,0,1594857600000,07232,Bitburg-Prüm,139,5,126,98561,61
DE-RP,15-03-2020,RKI,0,0,0,1584230400000,07233,Vulkaneifel,2,0,2,60603,67
DE-RP,16-03-2020,RKI,8,8,0,1584316800000,07233,Vulkaneifel,10,0,10,60603,67
DE-RP,17-03-2020,RKI,1,1,0,1584403200000,07233,Vulkaneifel,11,0,11,60603,67
DE-RP,18-03-2020,RKI,3,3,0,1584489600000,07233,Vulkaneifel,14,0,14,60603,67
DE-RP,19-03-2020,RKI,4,4,0,1584576000000,07233,Vulkaneifel,18,0,18,60603,67
DE-RP,20-03-2020,RKI,5,5,0,1584662400000,07233,Vulkaneifel,23,0,23,60603,67
DE-RP,22-03-2020,RKI,0,0,0,1584835200000,07233,Vulkaneifel,23,0,23,60603,67
DE-RP,24-03-2020,RKI,1,1,0,1585008000000,07233,Vulkaneifel,24,0,24,60603,67
DE-RP,25-03-2020,RKI,0,0,0,1585094400000,07233,Vulkaneifel,24,0,24,60603,67
DE-RP,27-03-2020,RKI,3,3,0,1585267200000,07233,Vulkaneifel,27,0,27,60603,67
DE-RP,28-03-2020,RKI,5,5,0,1585353600000,07233,Vulkaneifel,32,0,32,60603,67
DE-RP,29-03-2020,RKI,2,2,0,1585440000000,07233,Vulkaneifel,34,0,34,60603,67
DE-RP,30-03-2020,RKI,2,2,0,1585526400000,07233,Vulkaneifel,36,0,36,60603,67
DE-RP,31-03-2020,RKI,0,0,0,1585612800000,07233,Vulkaneifel,36,0,36,60603,67
DE-RP,01-04-2020,RKI,6,5,1,1585699200000,07233,Vulkaneifel,42,1,41,60603,67
DE-RP,02-04-2020,RKI,4,4,0,1585785600000,07233,Vulkaneifel,46,1,45,60603,67
DE-RP,03-04-2020,RKI,0,0,0,1585872000000,07233,Vulkaneifel,46,1,45,60603,67
DE-RP,04-04-2020,RKI,16,16,0,1585958400000,07233,Vulkaneifel,62,1,61,60603,67
DE-RP,06-04-2020,RKI,3,3,0,1586131200000,07233,Vulkaneifel,65,1,64,60603,67
DE-RP,08-04-2020,RKI,2,2,0,1586304000000,07233,Vulkaneifel,67,1,66,60603,67
DE-RP,09-04-2020,RKI,0,0,0,1586390400000,07233,Vulkaneifel,67,1,66,60603,67
DE-RP,10-04-2020,RKI,3,3,0,1586476800000,07233,Vulkaneifel,70,1,69,60603,67
DE-RP,11-04-2020,RKI,0,0,0,1586563200000,07233,Vulkaneifel,70,1,69,60603,67
DE-RP,13-04-2020,RKI,4,3,1,1586736000000,07233,Vulkaneifel,74,2,72,60603,67
DE-RP,15-04-2020,RKI,0,0,0,1586908800000,07233,Vulkaneifel,74,2,72,60603,67
DE-RP,17-04-2020,RKI,0,0,0,1587081600000,07233,Vulkaneifel,74,2,72,60603,67
DE-RP,20-04-2020,RKI,3,3,0,1587340800000,07233,Vulkaneifel,77,2,75,60603,67
DE-RP,21-04-2020,RKI,1,0,1,1587427200000,07233,Vulkaneifel,78,3,75,60603,67
DE-RP,23-04-2020,RKI,0,0,0,1587600000000,07233,Vulkaneifel,78,3,75,60603,67
DE-RP,29-04-2020,RKI,0,0,0,1588118400000,07233,Vulkaneifel,78,3,75,60603,67
DE-RP,30-04-2020,RKI,0,0,0,1588204800000,07233,Vulkaneifel,78,3,75,60603,67
DE-RP,01-05-2020,RKI,3,3,0,1588291200000,07233,Vulkaneifel,81,3,78,60603,67
DE-RP,05-05-2020,RKI,0,0,0,1588636800000,07233,Vulkaneifel,81,3,78,60603,67
DE-RP,07-05-2020,RKI,0,0,0,1588809600000,07233,Vulkaneifel,81,3,78,60603,67
DE-RP,09-05-2020,RKI,0,0,0,1588982400000,07233,Vulkaneifel,81,3,78,60603,67
DE-RP,17-06-2020,RKI,0,0,0,1592352000000,07233,Vulkaneifel,81,3,78,60603,67
DE-RP,24-06-2020,RKI,0,0,0,1592956800000,07233,Vulkaneifel,81,3,78,60603,67
DE-RP,25-06-2020,RKI,1,1,0,1593043200000,07233,Vulkaneifel,82,3,79,60603,67
DE-RP,29-06-2020,RKI,0,0,0,1593388800000,07233,Vulkaneifel,82,3,79,60603,67
DE-RP,09-07-2020,RKI,0,0,0,1594252800000,07233,Vulkaneifel,82,3,79,60603,67
DE-RP,15-03-2020,RKI,6,6,0,1584230400000,07235,Trier-Saarburg,6,0,6,148945,135
DE-RP,16-03-2020,RKI,0,0,0,1584316800000,07235,Trier-Saarburg,6,0,6,148945,135
DE-RP,17-03-2020,RKI,3,3,0,1584403200000,07235,Trier-Saarburg,9,0,9,148945,135
DE-RP,18-03-2020,RKI,3,3,0,1584489600000,07235,Trier-Saarburg,12,0,12,148945,135
DE-RP,19-03-2020,RKI,3,2,1,1584576000000,07235,Trier-Saarburg,15,1,14,148945,135
DE-RP,20-03-2020,RKI,1,1,0,1584662400000,07235,Trier-Saarburg,16,1,15,148945,135
DE-RP,21-03-2020,RKI,5,5,0,1584748800000,07235,Trier-Saarburg,21,1,20,148945,135
DE-RP,22-03-2020,RKI,2,2,0,1584835200000,07235,Trier-Saarburg,23,1,22,148945,135
DE-RP,23-03-2020,RKI,2,2,0,1584921600000,07235,Trier-Saarburg,25,1,24,148945,135
DE-RP,24-03-2020,RKI,4,3,1,1585008000000,07235,Trier-Saarburg,29,2,27,148945,135
DE-RP,25-03-2020,RKI,2,2,0,1585094400000,07235,Trier-Saarburg,31,2,29,148945,135
DE-RP,26-03-2020,RKI,2,2,0,1585180800000,07235,Trier-Saarburg,33,2,31,148945,135
DE-RP,27-03-2020,RKI,2,1,1,1585267200000,07235,Trier-Saarburg,35,3,32,148945,135
DE-RP,28-03-2020,RKI,4,4,0,1585353600000,07235,Trier-Saarburg,39,3,36,148945,135
DE-RP,29-03-2020,RKI,19,18,1,1585440000000,07235,Trier-Saarburg,58,4,54,148945,135
DE-RP,30-03-2020,RKI,3,3,0,1585526400000,07235,Trier-Saarburg,61,4,57,148945,135
DE-RP,31-03-2020,RKI,3,3,0,1585612800000,07235,Trier-Saarburg,64,4,60,148945,135
DE-RP,01-04-2020,RKI,7,7,0,1585699200000,07235,Trier-Saarburg,71,4,67,148945,135
DE-RP,02-04-2020,RKI,5,5,0,1585785600000,07235,Trier-Saarburg,76,4,72,148945,135
DE-RP,03-04-2020,RKI,5,5,0,1585872000000,07235,Trier-Saarburg,81,4,77,148945,135
DE-RP,04-04-2020,RKI,1,1,0,1585958400000,07235,Trier-Saarburg,82,4,78,148945,135
DE-RP,05-04-2020,RKI,2,2,0,1586044800000,07235,Trier-Saarburg,84,4,80,148945,135
DE-RP,06-04-2020,RKI,7,7,0,1586131200000,07235,Trier-Saarburg,91,4,87,148945,135
DE-RP,07-04-2020,RKI,6,6,0,1586217600000,07235,Trier-Saarburg,97,4,93,148945,135
DE-RP,08-04-2020,RKI,3,3,0,1586304000000,07235,Trier-Saarburg,100,4,96,148945,135
DE-RP,09-04-2020,RKI,3,3,0,1586390400000,07235,Trier-Saarburg,103,4,99,148945,135
DE-RP,10-04-2020,RKI,1,1,0,1586476800000,07235,Trier-Saarburg,104,4,100,148945,135
DE-RP,11-04-2020,RKI,0,0,0,1586563200000,07235,Trier-Saarburg,104,4,100,148945,135
DE-RP,12-04-2020,RKI,3,3,0,1586649600000,07235,Trier-Saarburg,107,4,103,148945,135
DE-RP,13-04-2020,RKI,6,5,1,1586736000000,07235,Trier-Saarburg,113,5,108,148945,135
DE-RP,14-04-2020,RKI,4,4,0,1586822400000,07235,Trier-Saarburg,117,5,112,148945,135
DE-RP,15-04-2020,RKI,3,3,0,1586908800000,07235,Trier-Saarburg,120,5,115,148945,135
DE-RP,16-04-2020,RKI,5,5,0,1586995200000,07235,Trier-Saarburg,125,5,120,148945,135
DE-RP,17-04-2020,RKI,2,2,0,1587081600000,07235,Trier-Saarburg,127,5,122,148945,135
DE-RP,19-04-2020,RKI,1,0,1,1587254400000,07235,Trier-Saarburg,128,6,122,148945,135
DE-RP,21-04-2020,RKI,0,0,0,1587427200000,07235,Trier-Saarburg,128,6,122,148945,135
DE-RP,22-04-2020,RKI,3,3,0,1587513600000,07235,Trier-Saarburg,131,6,125,148945,135
DE-RP,23-04-2020,RKI,1,1,0,1587600000000,07235,Trier-Saarburg,132,6,126,148945,135
DE-RP,24-04-2020,RKI,0,0,0,1587686400000,07235,Trier-Saarburg,132,6,126,148945,135
DE-RP,27-04-2020,RKI,0,0,0,1587945600000,07235,Trier-Saarburg,132,6,126,148945,135
DE-RP,28-04-2020,RKI,0,0,0,1588032000000,07235,Trier-Saarburg,132,6,126,148945,135
DE-RP,29-04-2020,RKI,6,5,1,1588118400000,07235,Trier-Saarburg,138,7,131,148945,135
DE-RP,30-04-2020,RKI,2,2,0,1588204800000,07235,Trier-Saarburg,140,7,133,148945,135
DE-RP,01-05-2020,RKI,1,1,0,1588291200000,07235,Trier-Saarburg,141,7,134,148945,135
DE-RP,04-05-2020,RKI,3,2,1,1588550400000,07235,Trier-Saarburg,144,8,136,148945,135
DE-RP,06-05-2020,RKI,0,0,0,1588723200000,07235,Trier-Saarburg,144,8,136,148945,135
DE-RP,11-05-2020,RKI,0,0,0,1589155200000,07235,Trier-Saarburg,144,8,136,148945,135
DE-RP,15-05-2020,RKI,0,0,0,1589500800000,07235,Trier-Saarburg,144,8,136,148945,135
DE-RP,19-05-2020,RKI,0,0,0,1589846400000,07235,Trier-Saarburg,144,8,136,148945,135
DE-RP,11-06-2020,RKI,0,0,0,1591833600000,07235,Trier-Saarburg,144,8,136,148945,135
DE-RP,12-06-2020,RKI,1,1,0,1591920000000,07235,Trier-Saarburg,145,8,137,148945,135
DE-RP,18-06-2020,RKI,0,0,0,1592438400000,07235,Trier-Saarburg,145,8,137,148945,135
DE-RP,19-06-2020,RKI,1,1,0,1592524800000,07235,Trier-Saarburg,146,8,138,148945,135
DE-RP,23-06-2020,RKI,0,0,0,1592870400000,07235,Trier-Saarburg,146,8,138,148945,135
DE-RP,25-06-2020,RKI,0,0,0,1593043200000,07235,Trier-Saarburg,146,8,138,148945,135
DE-RP,01-07-2020,RKI,0,0,0,1593561600000,07235,Trier-Saarburg,146,8,138,148945,135
DE-RP,07-07-2020,RKI,1,1,0,1594080000000,07235,Trier-Saarburg,147,8,139,148945,135
DE-RP,08-07-2020,RKI,0,0,0,1594166400000,07235,Trier-Saarburg,147,8,139,148945,135
DE-RP,10-07-2020,RKI,2,0,0,1594339200000,07235,Trier-Saarburg,149,8,139,148945,135
DE-RP,11-07-2020,RKI,0,0,0,1594425600000,07235,Trier-Saarburg,149,8,139,148945,135
DE-RP,12-07-2020,RKI,1,0,0,1594512000000,07235,Trier-Saarburg,150,8,139,148945,135
DE-RP,13-07-2020,RKI,5,0,0,1594598400000,07235,Trier-Saarburg,155,8,139,148945,135
DE-RP,14-07-2020,RKI,0,0,0,1594684800000,07235,Trier-Saarburg,155,8,139,148945,135
DE-RP,15-07-2020,RKI,1,0,0,1594771200000,07235,Trier-Saarburg,156,8,139,148945,135
DE-RP,17-03-2020,RKI,1,1,0,1584403200000,07311,Frankenthal,1,0,1,48561,1110
DE-RP,18-03-2020,RKI,4,4,0,1584489600000,07311,Frankenthal,5,0,5,48561,1110
DE-RP,19-03-2020,RKI,0,0,0,1584576000000,07311,Frankenthal,5,0,5,48561,1110
DE-RP,20-03-2020,RKI,1,1,0,1584662400000,07311,Frankenthal,6,0,6,48561,1110
DE-RP,23-03-2020,RKI,0,0,0,1584921600000,07311,Frankenthal,6,0,6,48561,1110
DE-RP,26-03-2020,RKI,0,0,0,1585180800000,07311,Frankenthal,6,0,6,48561,1110
DE-RP,27-03-2020,RKI,2,1,1,1585267200000,07311,Frankenthal,8,1,7,48561,1110
DE-RP,29-03-2020,RKI,2,2,0,1585440000000,07311,Frankenthal,10,1,9,48561,1110
DE-RP,31-03-2020,RKI,2,2,0,1585612800000,07311,Frankenthal,12,1,11,48561,1110
DE-RP,01-04-2020,RKI,1,1,0,1585699200000,07311,Frankenthal,13,1,12,48561,1110
DE-RP,02-04-2020,RKI,0,0,0,1585785600000,07311,Frankenthal,13,1,12,48561,1110
DE-RP,03-04-2020,RKI,0,0,0,1585872000000,07311,Frankenthal,13,1,12,48561,1110
DE-RP,04-04-2020,RKI,0,0,0,1585958400000,07311,Frankenthal,13,1,12,48561,1110
DE-RP,09-04-2020,RKI,3,3,0,1586390400000,07311,Frankenthal,16,1,15,48561,1110
DE-RP,14-04-2020,RKI,0,0,0,1586822400000,07311,Frankenthal,16,1,15,48561,1110
DE-RP,16-04-2020,RKI,0,0,0,1586995200000,07311,Frankenthal,16,1,15,48561,1110
DE-RP,18-04-2020,RKI,2,2,0,1587168000000,07311,Frankenthal,18,1,17,48561,1110
DE-RP,20-04-2020,RKI,0,0,0,1587340800000,07311,Frankenthal,18,1,17,48561,1110
DE-RP,22-04-2020,RKI,0,0,0,1587513600000,07311,Frankenthal,18,1,17,48561,1110
DE-RP,25-04-2020,RKI,0,0,0,1587772800000,07311,Frankenthal,18,1,17,48561,1110
DE-RP,27-04-2020,RKI,1,1,0,1587945600000,07311,Frankenthal,19,1,18,48561,1110
DE-RP,07-05-2020,RKI,0,0,0,1588809600000,07311,Frankenthal,19,1,18,48561,1110
DE-RP,20-05-2020,RKI,0,0,0,1589932800000,07311,Frankenthal,19,1,18,48561,1110
DE-RP,28-05-2020,RKI,0,0,0,1590624000000,07311,Frankenthal,19,1,18,48561,1110
DE-RP,17-06-2020,RKI,2,2,0,1592352000000,07311,Frankenthal,21,1,20,48561,1110
DE-RP,29-02-2020,RKI,0,0,0,1582934400000,07312,Kaiserslautern,0,0,0,99845,715
DE-RP,03-03-2020,RKI,0,0,0,1583193600000,07312,Kaiserslautern,0,0,0,99845,715
DE-RP,06-03-2020,RKI,0,0,0,1583452800000,07312,Kaiserslautern,0,0,0,99845,715
DE-RP,11-03-2020,RKI,0,0,0,1583884800000,07312,Kaiserslautern,0,0,0,99845,715
DE-RP,13-03-2020,RKI,0,0,0,1584057600000,07312,Kaiserslautern,0,0,0,99845,715
DE-RP,15-03-2020,RKI,1,1,0,1584230400000,07312,Kaiserslautern,1,0,1,99845,715
DE-RP,16-03-2020,RKI,2,2,0,1584316800000,07312,Kaiserslautern,3,0,3,99845,715
DE-RP,18-03-2020,RKI,1,1,0,1584489600000,07312,Kaiserslautern,4,0,4,99845,715
DE-RP,20-03-2020,RKI,0,0,0,1584662400000,07312,Kaiserslautern,4,0,4,99845,715
DE-RP,21-03-2020,RKI,5,5,0,1584748800000,07312,Kaiserslautern,9,0,9,99845,715
DE-RP,22-03-2020,RKI,6,6,0,1584835200000,07312,Kaiserslautern,15,0,15,99845,715
DE-RP,23-03-2020,RKI,3,3,0,1584921600000,07312,Kaiserslautern,18,0,18,99845,715
DE-RP,24-03-2020,RKI,6,6,0,1585008000000,07312,Kaiserslautern,24,0,24,99845,715
DE-RP,25-03-2020,RKI,7,7,0,1585094400000,07312,Kaiserslautern,31,0,31,99845,715
DE-RP,26-03-2020,RKI,3,2,1,1585180800000,07312,Kaiserslautern,34,1,33,99845,715
DE-RP,27-03-2020,RKI,2,2,0,1585267200000,07312,Kaiserslautern,36,1,35,99845,715
DE-RP,28-03-2020,RKI,0,0,0,1585353600000,07312,Kaiserslautern,36,1,35,99845,715
DE-RP,29-03-2020,RKI,0,0,0,1585440000000,07312,Kaiserslautern,36,1,35,99845,715
DE-RP,31-03-2020,RKI,4,4,0,1585612800000,07312,Kaiserslautern,40,1,39,99845,715
DE-RP,01-04-2020,RKI,2,2,0,1585699200000,07312,Kaiserslautern,42,1,41,99845,715
DE-RP,02-04-2020,RKI,3,3,0,1585785600000,07312,Kaiserslautern,45,1,44,99845,715
DE-RP,03-04-2020,RKI,3,2,1,1585872000000,07312,Kaiserslautern,48,2,46,99845,715
DE-RP,04-04-2020,RKI,2,2,0,1585958400000,07312,Kaiserslautern,50,2,48,99845,715
DE-RP,06-04-2020,RKI,0,0,0,1586131200000,07312,Kaiserslautern,50,2,48,99845,715
DE-RP,07-04-2020,RKI,0,0,0,1586217600000,07312,Kaiserslautern,50,2,48,99845,715
DE-RP,08-04-2020,RKI,7,7,0,1586304000000,07312,Kaiserslautern,57,2,55,99845,715
DE-RP,09-04-2020,RKI,1,1,0,1586390400000,07312,Kaiserslautern,58,2,56,99845,715
DE-RP,10-04-2020,RKI,0,0,0,1586476800000,07312,Kaiserslautern,58,2,56,99845,715
DE-RP,11-04-2020,RKI,1,1,0,1586563200000,07312,Kaiserslautern,59,2,57,99845,715
DE-RP,14-04-2020,RKI,1,0,1,1586822400000,07312,Kaiserslautern,60,3,57,99845,715
DE-RP,15-04-2020,RKI,4,2,2,1586908800000,07312,Kaiserslautern,64,5,59,99845,715
DE-RP,16-04-2020,RKI,0,0,0,1586995200000,07312,Kaiserslautern,64,5,59,99845,715
DE-RP,17-04-2020,RKI,4,4,0,1587081600000,07312,Kaiserslautern,68,5,63,99845,715
DE-RP,18-04-2020,RKI,2,2,0,1587168000000,07312,Kaiserslautern,70,5,65,99845,715
DE-RP,19-04-2020,RKI,0,0,0,1587254400000,07312,Kaiserslautern,70,5,65,99845,715
DE-RP,20-04-2020,RKI,0,0,0,1587340800000,07312,Kaiserslautern,70,5,65,99845,715
DE-RP,21-04-2020,RKI,2,2,0,1587427200000,07312,Kaiserslautern,72,5,67,99845,715
DE-RP,23-04-2020,RKI,0,0,0,1587600000000,07312,Kaiserslautern,72,5,67,99845,715
DE-RP,27-04-2020,RKI,4,4,0,1587945600000,07312,Kaiserslautern,76,5,71,99845,715
DE-RP,28-04-2020,RKI,0,0,0,1588032000000,07312,Kaiserslautern,76,5,71,99845,715
DE-RP,30-04-2020,RKI,5,5,0,1588204800000,07312,Kaiserslautern,81,5,76,99845,715
DE-RP,01-05-2020,RKI,6,6,0,1588291200000,07312,Kaiserslautern,87,5,82,99845,715
DE-RP,04-05-2020,RKI,0,0,0,1588550400000,07312,Kaiserslautern,87,5,82,99845,715
DE-RP,05-05-2020,RKI,0,0,0,1588636800000,07312,Kaiserslautern,87,5,82,99845,715
DE-RP,06-05-2020,RKI,1,1,0,1588723200000,07312,Kaiserslautern,88,5,83,99845,715
DE-RP,08-05-2020,RKI,1,1,0,1588896000000,07312,Kaiserslautern,89,5,84,99845,715
DE-RP,09-05-2020,RKI,1,1,0,1588982400000,07312,Kaiserslautern,90,5,85,99845,715
DE-RP,12-05-2020,RKI,0,0,0,1589241600000,07312,Kaiserslautern,90,5,85,99845,715
DE-RP,13-05-2020,RKI,1,1,0,1589328000000,07312,Kaiserslautern,91,5,86,99845,715
DE-RP,15-05-2020,RKI,0,0,0,1589500800000,07312,Kaiserslautern,91,5,86,99845,715
DE-RP,16-05-2020,RKI,3,3,0,1589587200000,07312,Kaiserslautern,94,5,89,99845,715
DE-RP,18-05-2020,RKI,6,6,0,1589760000000,07312,Kaiserslautern,100,5,95,99845,715
DE-RP,19-05-2020,RKI,1,1,0,1589846400000,07312,Kaiserslautern,101,5,96,99845,715
DE-RP,20-05-2020,RKI,0,0,0,1589932800000,07312,Kaiserslautern,101,5,96,99845,715
DE-RP,21-05-2020,RKI,0,0,0,1590019200000,07312,Kaiserslautern,101,5,96,99845,715
DE-RP,22-05-2020,RKI,1,1,0,1590105600000,07312,Kaiserslautern,102,5,97,99845,715
DE-RP,23-05-2020,RKI,1,1,0,1590192000000,07312,Kaiserslautern,103,5,98,99845,715
DE-RP,25-05-2020,RKI,1,1,0,1590364800000,07312,Kaiserslautern,104,5,99,99845,715
DE-RP,30-05-2020,RKI,1,1,0,1590796800000,07312,Kaiserslautern,105,5,100,99845,715
DE-RP,01-06-2020,RKI,0,0,0,1590969600000,07312,Kaiserslautern,105,5,100,99845,715
DE-RP,04-06-2020,RKI,4,4,0,1591228800000,07312,Kaiserslautern,109,5,104,99845,715
DE-RP,05-06-2020,RKI,7,7,0,1591315200000,07312,Kaiserslautern,116,5,111,99845,715
DE-RP,06-06-2020,RKI,0,0,0,1591401600000,07312,Kaiserslautern,116,5,111,99845,715
DE-RP,08-06-2020,RKI,0,0,0,1591574400000,07312,Kaiserslautern,116,5,111,99845,715
DE-RP,09-06-2020,RKI,0,0,0,1591660800000,07312,Kaiserslautern,116,5,111,99845,715
DE-RP,12-06-2020,RKI,0,0,0,1591920000000,07312,Kaiserslautern,116,5,111,99845,715
DE-RP,22-06-2020,RKI,0,0,0,1592784000000,07312,Kaiserslautern,116,5,111,99845,715
DE-RP,25-06-2020,RKI,2,0,0,1593043200000,07312,Kaiserslautern,118,5,111,99845,715
DE-RP,26-06-2020,RKI,0,0,0,1593129600000,07312,Kaiserslautern,118,5,111,99845,715
DE-RP,03-07-2020,RKI,0,0,0,1593734400000,07312,Kaiserslautern,118,5,111,99845,715
DE-RP,07-07-2020,RKI,1,0,0,1594080000000,07312,Kaiserslautern,119,5,111,99845,715
DE-RP,09-07-2020,RKI,0,0,0,1594252800000,07312,Kaiserslautern,119,5,111,99845,715
DE-RP,10-07-2020,RKI,3,0,0,1594339200000,07312,Kaiserslautern,122,5,111,99845,715
DE-RP,13-07-2020,RKI,4,2,0,1594598400000,07312,Kaiserslautern,126,5,113,99845,715
DE-RP,14-07-2020,RKI,6,0,0,1594684800000,07312,Kaiserslautern,132,5,113,99845,715
DE-RP,18-03-2020,RKI,0,0,0,1584489600000,07313,Landau in der Pfalz,0,0,0,46677,563
DE-RP,19-03-2020,RKI,1,1,0,1584576000000,07313,Landau in der Pfalz,1,0,1,46677,563
DE-RP,20-03-2020,RKI,0,0,0,1584662400000,07313,Landau in der Pfalz,1,0,1,46677,563
DE-RP,23-03-2020,RKI,1,1,0,1584921600000,07313,Landau in der Pfalz,2,0,2,46677,563
DE-RP,24-03-2020,RKI,5,5,0,1585008000000,07313,Landau in der Pfalz,7,0,7,46677,563
DE-RP,26-03-2020,RKI,5,5,0,1585180800000,07313,Landau in der Pfalz,12,0,12,46677,563
DE-RP,27-03-2020,RKI,5,5,0,1585267200000,07313,Landau in der Pfalz,17,0,17,46677,563
DE-RP,28-03-2020,RKI,2,2,0,1585353600000,07313,Landau in der Pfalz,19,0,19,46677,563
DE-RP,29-03-2020,RKI,1,1,0,1585440000000,07313,Landau in der Pfalz,20,0,20,46677,563
DE-RP,30-03-2020,RKI,0,0,0,1585526400000,07313,Landau in der Pfalz,20,0,20,46677,563
DE-RP,31-03-2020,RKI,1,0,1,1585612800000,07313,Landau in der Pfalz,21,1,20,46677,563
DE-RP,01-04-2020,RKI,5,5,0,1585699200000,07313,Landau in der Pfalz,26,1,25,46677,563
DE-RP,02-04-2020,RKI,1,1,0,1585785600000,07313,Landau in der Pfalz,27,1,26,46677,563
DE-RP,03-04-2020,RKI,0,0,0,1585872000000,07313,Landau in der Pfalz,27,1,26,46677,563
DE-RP,05-04-2020,RKI,1,1,0,1586044800000,07313,Landau in der Pfalz,28,1,27,46677,563
DE-RP,08-04-2020,RKI,3,3,0,1586304000000,07313,Landau in der Pfalz,31,1,30,46677,563
DE-RP,13-04-2020,RKI,0,0,0,1586736000000,07313,Landau in der Pfalz,31,1,30,46677,563
DE-RP,17-04-2020,RKI,0,0,0,1587081600000,07313,Landau in der Pfalz,31,1,30,46677,563
DE-RP,18-04-2020,RKI,0,0,0,1587168000000,07313,Landau in der Pfalz,31,1,30,46677,563
DE-RP,22-04-2020,RKI,1,1,0,1587513600000,07313,Landau in der Pfalz,32,1,31,46677,563
DE-RP,27-04-2020,RKI,0,0,0,1587945600000,07313,Landau in der Pfalz,32,1,31,46677,563
DE-RP,04-05-2020,RKI,0,0,0,1588550400000,07313,Landau in der Pfalz,32,1,31,46677,563
DE-RP,06-07-2020,RKI,0,0,0,1593993600000,07313,Landau in der Pfalz,32,1,31,46677,563
DE-RP,06-03-2020,RKI,0,0,0,1583452800000,07315,Mainz,0,0,0,217118,2221
DE-RP,10-03-2020,RKI,0,0,0,1583798400000,07315,Mainz,0,0,0,217118,2221
DE-RP,11-03-2020,RKI,0,0,0,1583884800000,07315,Mainz,0,0,0,217118,2221
DE-RP,12-03-2020,RKI,8,8,0,1583971200000,07315,Mainz,8,0,8,217118,2221
DE-RP,14-03-2020,RKI,3,3,0,1584144000000,07315,Mainz,11,0,11,217118,2221
DE-RP,15-03-2020,RKI,0,0,0,1584230400000,07315,Mainz,11,0,11,217118,2221
DE-RP,16-03-2020,RKI,6,6,0,1584316800000,07315,Mainz,17,0,17,217118,2221
DE-RP,17-03-2020,RKI,4,4,0,1584403200000,07315,Mainz,21,0,21,217118,2221
DE-RP,18-03-2020,RKI,14,14,0,1584489600000,07315,Mainz,35,0,35,217118,2221
DE-RP,19-03-2020,RKI,5,5,0,1584576000000,07315,Mainz,40,0,40,217118,2221
DE-RP,20-03-2020,RKI,10,10,0,1584662400000,07315,Mainz,50,0,50,217118,2221
DE-RP,21-03-2020,RKI,6,6,0,1584748800000,07315,Mainz,56,0,56,217118,2221
DE-RP,22-03-2020,RKI,13,12,1,1584835200000,07315,Mainz,69,1,68,217118,2221
DE-RP,23-03-2020,RKI,6,6,0,1584921600000,07315,Mainz,75,1,74,217118,2221
DE-RP,24-03-2020,RKI,7,7,0,1585008000000,07315,Mainz,82,1,81,217118,2221
DE-RP,25-03-2020,RKI,8,8,0,1585094400000,07315,Mainz,90,1,89,217118,2221
DE-RP,26-03-2020,RKI,12,11,1,1585180800000,07315,Mainz,102,2,100,217118,2221
DE-RP,27-03-2020,RKI,19,18,1,1585267200000,07315,Mainz,121,3,118,217118,2221
DE-RP,28-03-2020,RKI,14,13,1,1585353600000,07315,Mainz,135,4,131,217118,2221
DE-RP,29-03-2020,RKI,20,19,1,1585440000000,07315,Mainz,155,5,150,217118,2221
DE-RP,30-03-2020,RKI,4,4,0,1585526400000,07315,Mainz,159,5,154,217118,2221
DE-RP,31-03-2020,RKI,7,7,0,1585612800000,07315,Mainz,166,5,161,217118,2221
DE-RP,01-04-2020,RKI,15,15,0,1585699200000,07315,Mainz,181,5,176,217118,2221
DE-RP,02-04-2020,RKI,11,11,0,1585785600000,07315,Mainz,192,5,187,217118,2221
DE-RP,03-04-2020,RKI,21,21,0,1585872000000,07315,Mainz,213,5,208,217118,2221
DE-RP,04-04-2020,RKI,2,2,0,1585958400000,07315,Mainz,215,5,210,217118,2221
DE-RP,05-04-2020,RKI,16,15,1,1586044800000,07315,Mainz,231,6,225,217118,2221
DE-RP,06-04-2020,RKI,11,10,1,1586131200000,07315,Mainz,242,7,235,217118,2221
DE-RP,07-04-2020,RKI,20,19,1,1586217600000,07315,Mainz,262,8,254,217118,2221
DE-RP,08-04-2020,RKI,17,17,0,1586304000000,07315,Mainz,279,8,271,217118,2221
DE-RP,09-04-2020,RKI,21,18,3,1586390400000,07315,Mainz,300,11,289,217118,2221
DE-RP,10-04-2020,RKI,8,6,2,1586476800000,07315,Mainz,308,13,295,217118,2221
DE-RP,11-04-2020,RKI,7,7,0,1586563200000,07315,Mainz,315,13,302,217118,2221
DE-RP,13-04-2020,RKI,0,0,0,1586736000000,07315,Mainz,315,13,302,217118,2221
DE-RP,14-04-2020,RKI,2,1,1,1586822400000,07315,Mainz,317,14,303,217118,2221
DE-RP,15-04-2020,RKI,16,16,0,1586908800000,07315,Mainz,333,14,319,217118,2221
DE-RP,16-04-2020,RKI,12,10,2,1586995200000,07315,Mainz,345,16,329,217118,2221
DE-RP,17-04-2020,RKI,14,11,3,1587081600000,07315,Mainz,359,19,340,217118,2221
DE-RP,18-04-2020,RKI,21,20,1,1587168000000,07315,Mainz,380,20,360,217118,2221
DE-RP,19-04-2020,RKI,1,1,0,1587254400000,07315,Mainz,381,20,361,217118,2221
DE-RP,20-04-2020,RKI,2,2,0,1587340800000,07315,Mainz,383,20,363,217118,2221
DE-RP,21-04-2020,RKI,6,6,0,1587427200000,07315,Mainz,389,20,369,217118,2221
DE-RP,22-04-2020,RKI,17,15,2,1587513600000,07315,Mainz,406,22,384,217118,2221
DE-RP,23-04-2020,RKI,8,8,0,1587600000000,07315,Mainz,414,22,392,217118,2221
DE-RP,24-04-2020,RKI,17,15,2,1587686400000,07315,Mainz,431,24,407,217118,2221
DE-RP,25-04-2020,RKI,2,2,0,1587772800000,07315,Mainz,433,24,409,217118,2221
DE-RP,26-04-2020,RKI,1,1,0,1587859200000,07315,Mainz,434,24,410,217118,2221
DE-RP,27-04-2020,RKI,0,0,0,1587945600000,07315,Mainz,434,24,410,217118,2221
DE-RP,28-04-2020,RKI,6,6,0,1588032000000,07315,Mainz,440,24,416,217118,2221
DE-RP,29-04-2020,RKI,5,5,0,1588118400000,07315,Mainz,445,24,421,217118,2221
DE-RP,30-04-2020,RKI,3,3,0,1588204800000,07315,Mainz,448,24,424,217118,2221
DE-RP,01-05-2020,RKI,6,6,0,1588291200000,07315,Mainz,454,24,430,217118,2221
DE-RP,04-05-2020,RKI,4,4,0,1588550400000,07315,Mainz,458,24,434,217118,2221
DE-RP,05-05-2020,RKI,10,10,0,1588636800000,07315,Mainz,468,24,444,217118,2221
DE-RP,06-05-2020,RKI,2,2,0,1588723200000,07315,Mainz,470,24,446,217118,2221
DE-RP,07-05-2020,RKI,7,6,1,1588809600000,07315,Mainz,477,25,452,217118,2221
DE-RP,08-05-2020,RKI,3,3,0,1588896000000,07315,Mainz,480,25,455,217118,2221
DE-RP,09-05-2020,RKI,5,5,0,1588982400000,07315,Mainz,485,25,460,217118,2221
DE-RP,11-05-2020,RKI,0,0,0,1589155200000,07315,Mainz,485,25,460,217118,2221
DE-RP,12-05-2020,RKI,1,1,0,1589241600000,07315,Mainz,486,25,461,217118,2221
DE-RP,13-05-2020,RKI,4,4,0,1589328000000,07315,Mainz,490,25,465,217118,2221
DE-RP,14-05-2020,RKI,0,0,0,1589414400000,07315,Mainz,490,25,465,217118,2221
DE-RP,15-05-2020,RKI,10,10,0,1589500800000,07315,Mainz,500,25,475,217118,2221
DE-RP,16-05-2020,RKI,0,0,0,1589587200000,07315,Mainz,500,25,475,217118,2221
DE-RP,17-05-2020,RKI,0,0,0,1589673600000,07315,Mainz,500,25,475,217118,2221
DE-RP,20-05-2020,RKI,4,4,0,1589932800000,07315,Mainz,504,25,479,217118,2221
DE-RP,21-05-2020,RKI,1,1,0,1590019200000,07315,Mainz,505,25,480,217118,2221
DE-RP,22-05-2020,RKI,1,1,0,1590105600000,07315,Mainz,506,25,481,217118,2221
DE-RP,25-05-2020,RKI,0,0,0,1590364800000,07315,Mainz,506,25,481,217118,2221
DE-RP,26-05-2020,RKI,30,30,0,1590451200000,07315,Mainz,536,25,511,217118,2221
DE-RP,27-05-2020,RKI,1,1,0,1590537600000,07315,Mainz,537,25,512,217118,2221
DE-RP,28-05-2020,RKI,1,1,0,1590624000000,07315,Mainz,538,25,513,217118,2221
DE-RP,29-05-2020,RKI,4,4,0,1590710400000,07315,Mainz,542,25,517,217118,2221
DE-RP,30-05-2020,RKI,4,4,0,1590796800000,07315,Mainz,546,25,521,217118,2221
DE-RP,03-06-2020,RKI,1,1,0,1591142400000,07315,Mainz,547,25,522,217118,2221
DE-RP,04-06-2020,RKI,12,12,0,1591228800000,07315,Mainz,559,25,534,217118,2221
DE-RP,05-06-2020,RKI,1,1,0,1591315200000,07315,Mainz,560,25,535,217118,2221
DE-RP,06-06-2020,RKI,0,0,0,1591401600000,07315,Mainz,560,25,535,217118,2221
DE-RP,08-06-2020,RKI,4,4,0,1591574400000,07315,Mainz,564,25,539,217118,2221
DE-RP,09-06-2020,RKI,4,4,0,1591660800000,07315,Mainz,568,25,543,217118,2221
DE-RP,10-06-2020,RKI,0,0,0,1591747200000,07315,Mainz,568,25,543,217118,2221
DE-RP,12-06-2020,RKI,0,0,0,1591920000000,07315,Mainz,568,25,543,217118,2221
DE-RP,15-06-2020,RKI,1,1,0,1592179200000,07315,Mainz,569,25,544,217118,2221
DE-RP,19-06-2020,RKI,0,0,0,1592524800000,07315,Mainz,569,25,544,217118,2221
DE-RP,24-06-2020,RKI,0,0,0,1592956800000,07315,Mainz,569,25,544,217118,2221
DE-RP,26-06-2020,RKI,0,0,0,1593129600000,07315,Mainz,569,25,544,217118,2221
DE-RP,29-06-2020,RKI,0,0,0,1593388800000,07315,Mainz,569,25,544,217118,2221
DE-RP,30-06-2020,RKI,0,0,0,1593475200000,07315,Mainz,569,25,544,217118,2221
DE-RP,01-07-2020,RKI,0,0,0,1593561600000,07315,Mainz,569,25,544,217118,2221
DE-RP,06-07-2020,RKI,0,0,0,1593993600000,07315,Mainz,569,25,544,217118,2221
DE-RP,08-07-2020,RKI,0,0,0,1594166400000,07315,Mainz,569,25,544,217118,2221
DE-RP,11-07-2020,RKI,1,0,0,1594425600000,07315,Mainz,570,25,544,217118,2221
DE-RP,16-07-2020,RKI,0,0,0,1594857600000,07315,Mainz,570,25,544,217118,2221
DE-RP,13-03-2020,RKI,1,1,0,1584057600000,07316,Neustadt an der Weinstraße,1,0,1,53148,454
DE-RP,17-03-2020,RKI,2,2,0,1584403200000,07316,Neustadt an der Weinstraße,3,0,3,53148,454
DE-RP,18-03-2020,RKI,3,2,1,1584489600000,07316,Neustadt an der Weinstraße,6,1,5,53148,454
DE-RP,19-03-2020,RKI,1,1,0,1584576000000,07316,Neustadt an der Weinstraße,7,1,6,53148,454
DE-RP,20-03-2020,RKI,5,5,0,1584662400000,07316,Neustadt an der Weinstraße,12,1,11,53148,454
DE-RP,21-03-2020,RKI,4,4,0,1584748800000,07316,Neustadt an der Weinstraße,16,1,15,53148,454
DE-RP,23-03-2020,RKI,10,10,0,1584921600000,07316,Neustadt an der Weinstraße,26,1,25,53148,454
DE-RP,24-03-2020,RKI,3,3,0,1585008000000,07316,Neustadt an der Weinstraße,29,1,28,53148,454
DE-RP,25-03-2020,RKI,2,2,0,1585094400000,07316,Neustadt an der Weinstraße,31,1,30,53148,454
DE-RP,26-03-2020,RKI,3,3,0,1585180800000,07316,Neustadt an der Weinstraße,34,1,33,53148,454
DE-RP,27-03-2020,RKI,5,5,0,1585267200000,07316,Neustadt an der Weinstraße,39,1,38,53148,454
DE-RP,28-03-2020,RKI,2,2,0,1585353600000,07316,Neustadt an der Weinstraße,41,1,40,53148,454
DE-RP,30-03-2020,RKI,4,4,0,1585526400000,07316,Neustadt an der Weinstraße,45,1,44,53148,454
DE-RP,31-03-2020,RKI,1,1,0,1585612800000,07316,Neustadt an der Weinstraße,46,1,45,53148,454
DE-RP,01-04-2020,RKI,4,4,0,1585699200000,07316,Neustadt an der Weinstraße,50,1,49,53148,454
DE-RP,02-04-2020,RKI,2,2,0,1585785600000,07316,Neustadt an der Weinstraße,52,1,51,53148,454
DE-RP,03-04-2020,RKI,4,4,0,1585872000000,07316,Neustadt an der Weinstraße,56,1,55,53148,454
DE-RP,04-04-2020,RKI,3,3,0,1585958400000,07316,Neustadt an der Weinstraße,59,1,58,53148,454
DE-RP,05-04-2020,RKI,1,1,0,1586044800000,07316,Neustadt an der Weinstraße,60,1,59,53148,454
DE-RP,06-04-2020,RKI,2,2,0,1586131200000,07316,Neustadt an der Weinstraße,62,1,61,53148,454
DE-RP,07-04-2020,RKI,1,1,0,1586217600000,07316,Neustadt an der Weinstraße,63,1,62,53148,454
DE-RP,08-04-2020,RKI,3,3,0,1586304000000,07316,Neustadt an der Weinstraße,66,1,65,53148,454
DE-RP,10-04-2020,RKI,4,4,0,1586476800000,07316,Neustadt an der Weinstraße,70,1,69,53148,454
DE-RP,14-04-2020,RKI,0,0,0,1586822400000,07316,Neustadt an der Weinstraße,70,1,69,53148,454
DE-RP,15-04-2020,RKI,1,1,0,1586908800000,07316,Neustadt an der Weinstraße,71,1,70,53148,454
DE-RP,17-04-2020,RKI,0,0,0,1587081600000,07316,Neustadt an der Weinstraße,71,1,70,53148,454
DE-RP,22-04-2020,RKI,1,1,0,1587513600000,07316,Neustadt an der Weinstraße,72,1,71,53148,454
DE-RP,30-04-2020,RKI,0,0,0,1588204800000,07316,Neustadt an der Weinstraße,72,1,71,53148,454
DE-RP,13-05-2020,RKI,0,0,0,1589328000000,07316,Neustadt an der Weinstraße,72,1,71,53148,454
DE-RP,01-06-2020,RKI,0,0,0,1590969600000,07316,Neustadt an der Weinstraße,72,1,71,53148,454
DE-RP,23-06-2020,RKI,0,0,0,1592870400000,07316,Neustadt an der Weinstraße,72,1,71,53148,454
DE-RP,26-06-2020,RKI,0,0,0,1593129600000,07316,Neustadt an der Weinstraße,72,1,71,53148,454
DE-RP,02-07-2020,RKI,0,0,0,1593648000000,07316,Neustadt an der Weinstraße,72,1,71,53148,454
DE-RP,08-07-2020,RKI,1,0,0,1594166400000,07316,Neustadt an der Weinstraße,73,1,71,53148,454
DE-RP,09-07-2020,RKI,1,0,0,1594252800000,07316,Neustadt an der Weinstraße,74,1,71,53148,454
DE-RP,21-03-2020,RKI,1,1,0,1584748800000,07317,Pirmasens,1,0,1,40403,658
DE-RP,22-03-2020,RKI,1,1,0,1584835200000,07317,Pirmasens,2,0,2,40403,658
DE-RP,23-03-2020,RKI,0,0,0,1584921600000,07317,Pirmasens,2,0,2,40403,658
DE-RP,25-03-2020,RKI,3,3,0,1585094400000,07317,Pirmasens,5,0,5,40403,658
DE-RP,26-03-2020,RKI,0,0,0,1585180800000,07317,Pirmasens,5,0,5,40403,658
DE-RP,29-03-2020,RKI,2,2,0,1585440000000,07317,Pirmasens,7,0,7,40403,658
DE-RP,01-04-2020,RKI,3,3,0,1585699200000,07317,Pirmasens,10,0,10,40403,658
DE-RP,02-04-2020,RKI,0,0,0,1585785600000,07317,Pirmasens,10,0,10,40403,658
DE-RP,04-04-2020,RKI,3,3,0,1585958400000,07317,Pirmasens,13,0,13,40403,658
DE-RP,09-04-2020,RKI,1,1,0,1586390400000,07317,Pirmasens,14,0,14,40403,658
DE-RP,13-04-2020,RKI,0,0,0,1586736000000,07317,Pirmasens,14,0,14,40403,658
DE-RP,15-04-2020,RKI,2,2,0,1586908800000,07317,Pirmasens,16,0,16,40403,658
DE-RP,16-05-2020,RKI,0,0,0,1589587200000,07317,Pirmasens,16,0,16,40403,658
DE-RP,15-07-2020,RKI,1,0,0,1594771200000,07317,Pirmasens,17,0,16,40403,658
DE-RP,16-03-2020,RKI,0,0,0,1584316800000,07318,Speyer,1,0,1,50378,1183
DE-RP,17-03-2020,RKI,0,0,0,1584403200000,07318,Speyer,1,0,1,50378,1183
DE-RP,18-03-2020,RKI,3,3,0,1584489600000,07318,Speyer,4,0,4,50378,1183
DE-RP,23-03-2020,RKI,4,4,0,1584921600000,07318,Speyer,8,0,8,50378,1183
DE-RP,25-03-2020,RKI,1,1,0,1585094400000,07318,Speyer,9,0,9,50378,1183
DE-RP,27-03-2020,RKI,7,7,0,1585267200000,07318,Speyer,16,0,16,50378,1183
DE-RP,29-03-2020,RKI,0,0,0,1585440000000,07318,Speyer,16,0,16,50378,1183
DE-RP,30-03-2020,RKI,0,0,0,1585526400000,07318,Speyer,16,0,16,50378,1183
DE-RP,31-03-2020,RKI,4,4,0,1585612800000,07318,Speyer,20,0,20,50378,1183
DE-RP,01-04-2020,RKI,1,1,0,1585699200000,07318,Speyer,21,0,21,50378,1183
DE-RP,02-04-2020,RKI,2,2,0,1585785600000,07318,Speyer,23,0,23,50378,1183
DE-RP,03-04-2020,RKI,0,0,0,1585872000000,07318,Speyer,23,0,23,50378,1183
DE-RP,05-04-2020,RKI,1,1,0,1586044800000,07318,Speyer,24,0,24,50378,1183
DE-RP,07-04-2020,RKI,1,1,0,1586217600000,07318,Speyer,25,0,25,50378,1183
DE-RP,08-04-2020,RKI,1,1,0,1586304000000,07318,Speyer,26,0,26,50378,1183
DE-RP,09-04-2020,RKI,5,5,0,1586390400000,07318,Speyer,31,0,31,50378,1183
DE-RP,11-04-2020,RKI,0,0,0,1586563200000,07318,Speyer,31,0,31,50378,1183
DE-RP,13-04-2020,RKI,0,0,0,1586736000000,07318,Speyer,31,0,31,50378,1183
DE-RP,14-04-2020,RKI,1,1,0,1586822400000,07318,Speyer,32,0,32,50378,1183
DE-RP,15-04-2020,RKI,0,0,0,1586908800000,07318,Speyer,32,0,32,50378,1183
DE-RP,17-04-2020,RKI,0,0,0,1587081600000,07318,Speyer,32,0,32,50378,1183
DE-RP,18-04-2020,RKI,1,1,0,1587168000000,07318,Speyer,33,0,33,50378,1183
DE-RP,20-04-2020,RKI,1,1,0,1587340800000,07318,Speyer,34,0,34,50378,1183
DE-RP,21-04-2020,RKI,0,0,0,1587427200000,07318,Speyer,34,0,34,50378,1183
DE-RP,22-04-2020,RKI,0,0,0,1587513600000,07318,Speyer,34,0,34,50378,1183
DE-RP,23-04-2020,RKI,1,1,0,1587600000000,07318,Speyer,35,0,35,50378,1183
DE-RP,24-04-2020,RKI,3,3,0,1587686400000,07318,Speyer,38,0,38,50378,1183
DE-RP,26-04-2020,RKI,1,1,0,1587859200000,07318,Speyer,39,0,39,50378,1183
DE-RP,27-04-2020,RKI,4,4,0,1587945600000,07318,Speyer,43,0,43,50378,1183
DE-RP,28-04-2020,RKI,0,0,0,1588032000000,07318,Speyer,43,0,43,50378,1183
DE-RP,29-04-2020,RKI,6,6,0,1588118400000,07318,Speyer,49,0,49,50378,1183
DE-RP,06-05-2020,RKI,0,0,0,1588723200000,07318,Speyer,49,0,49,50378,1183
DE-RP,10-05-2020,RKI,0,0,0,1589068800000,07318,Speyer,49,0,49,50378,1183
DE-RP,13-05-2020,RKI,0,0,0,1589328000000,07318,Speyer,49,0,49,50378,1183
DE-RP,14-05-2020,RKI,0,0,0,1589414400000,07318,Speyer,49,0,49,50378,1183
DE-RP,28-05-2020,RKI,0,0,0,1590624000000,07318,Speyer,49,0,49,50378,1183
DE-RP,03-06-2020,RKI,0,0,0,1591142400000,07318,Speyer,49,0,49,50378,1183
DE-RP,06-06-2020,RKI,0,0,0,1591401600000,07318,Speyer,49,0,49,50378,1183
DE-RP,09-06-2020,RKI,0,0,0,1591660800000,07318,Speyer,49,0,49,50378,1183
DE-RP,10-06-2020,RKI,0,0,0,1591747200000,07318,Speyer,49,0,49,50378,1183
DE-RP,12-06-2020,RKI,0,0,0,1591920000000,07318,Speyer,49,0,49,50378,1183
DE-RP,13-06-2020,RKI,0,0,0,1592006400000,07318,Speyer,49,0,49,50378,1183
DE-RP,15-06-2020,RKI,0,0,0,1592179200000,07318,Speyer,49,0,49,50378,1183
DE-RP,16-06-2020,RKI,0,0,0,1592265600000,07318,Speyer,49,0,49,50378,1183
DE-RP,17-06-2020,RKI,0,0,0,1592352000000,07318,Speyer,49,0,49,50378,1183
DE-RP,24-06-2020,RKI,1,1,0,1592956800000,07318,Speyer,50,0,50,50378,1183
DE-RP,25-06-2020,RKI,0,0,0,1593043200000,07318,Speyer,50,0,50,50378,1183
DE-RP,26-06-2020,RKI,2,1,0,1593129600000,07318,Speyer,52,0,51,50378,1183
DE-RP,30-06-2020,RKI,0,0,0,1593475200000,07318,Speyer,52,0,51,50378,1183
DE-RP,01-07-2020,RKI,2,2,0,1593561600000,07318,Speyer,54,0,53,50378,1183
DE-RP,03-07-2020,RKI,0,0,0,1593734400000,07318,Speyer,54,0,53,50378,1183
DE-RP,08-07-2020,RKI,1,1,0,1594166400000,07318,Speyer,55,0,54,50378,1183
DE-RP,09-07-2020,RKI,0,0,0,1594252800000,07318,Speyer,55,0,54,50378,1183
DE-RP,11-07-2020,RKI,0,0,0,1594425600000,07318,Speyer,55,0,54,50378,1183
DE-RP,13-07-2020,RKI,0,0,0,1594598400000,07318,Speyer,55,0,54,50378,1183
DE-RP,17-03-2020,RKI,10,10,0,1584403200000,07319,Worms,10,0,10,83330,766
DE-RP,18-03-2020,RKI,3,3,0,1584489600000,07319,Worms,13,0,13,83330,766
DE-RP,19-03-2020,RKI,6,6,0,1584576000000,07319,Worms,19,0,19,83330,766
DE-RP,20-03-2020,RKI,6,6,0,1584662400000,07319,Worms,25,0,25,83330,766
DE-RP,21-03-2020,RKI,3,3,0,1584748800000,07319,Worms,28,0,28,83330,766
DE-RP,22-03-2020,RKI,5,5,0,1584835200000,07319,Worms,33,0,33,83330,766
DE-RP,23-03-2020,RKI,5,5,0,1584921600000,07319,Worms,38,0,38,83330,766
DE-RP,24-03-2020,RKI,3,3,0,1585008000000,07319,Worms,41,0,41,83330,766
DE-RP,25-03-2020,RKI,2,2,0,1585094400000,07319,Worms,43,0,43,83330,766
DE-RP,26-03-2020,RKI,3,3,0,1585180800000,07319,Worms,46,0,46,83330,766
DE-RP,27-03-2020,RKI,3,3,0,1585267200000,07319,Worms,49,0,49,83330,766
DE-RP,28-03-2020,RKI,6,6,0,1585353600000,07319,Worms,55,0,55,83330,766
DE-RP,30-03-2020,RKI,4,3,1,1585526400000,07319,Worms,59,1,58,83330,766
DE-RP,31-03-2020,RKI,5,2,3,1585612800000,07319,Worms,64,4,60,83330,766
DE-RP,01-04-2020,RKI,3,3,0,1585699200000,07319,Worms,67,4,63,83330,766
DE-RP,02-04-2020,RKI,1,1,0,1585785600000,07319,Worms,68,4,64,83330,766
DE-RP,03-04-2020,RKI,15,13,2,1585872000000,07319,Worms,83,6,77,83330,766
DE-RP,04-04-2020,RKI,9,9,0,1585958400000,07319,Worms,92,6,86,83330,766
DE-RP,05-04-2020,RKI,1,1,0,1586044800000,07319,Worms,93,6,87,83330,766
DE-RP,07-04-2020,RKI,6,5,1,1586217600000,07319,Worms,99,7,92,83330,766
DE-RP,08-04-2020,RKI,5,5,0,1586304000000,07319,Worms,104,7,97,83330,766
DE-RP,10-04-2020,RKI,6,6,0,1586476800000,07319,Worms,110,7,103,83330,766
DE-RP,11-04-2020,RKI,2,2,0,1586563200000,07319,Worms,112,7,105,83330,766
DE-RP,12-04-2020,RKI,2,2,0,1586649600000,07319,Worms,114,7,107,83330,766
DE-RP,13-04-2020,RKI,0,0,0,1586736000000,07319,Worms,114,7,107,83330,766
DE-RP,14-04-2020,RKI,0,0,0,1586822400000,07319,Worms,114,7,107,83330,766
DE-RP,15-04-2020,RKI,1,1,0,1586908800000,07319,Worms,115,7,108,83330,766
DE-RP,16-04-2020,RKI,0,0,0,1586995200000,07319,Worms,115,7,108,83330,766
DE-RP,17-04-2020,RKI,7,7,0,1587081600000,07319,Worms,122,7,115,83330,766
DE-RP,18-04-2020,RKI,2,2,0,1587168000000,07319,Worms,124,7,117,83330,766
DE-RP,19-04-2020,RKI,0,0,0,1587254400000,07319,Worms,124,7,117,83330,766
DE-RP,21-04-2020,RKI,3,3,0,1587427200000,07319,Worms,127,7,120,83330,766
DE-RP,22-04-2020,RKI,3,3,0,1587513600000,07319,Worms,130,7,123,83330,766
DE-RP,23-04-2020,RKI,0,0,0,1587600000000,07319,Worms,130,7,123,83330,766
DE-RP,24-04-2020,RKI,4,4,0,1587686400000,07319,Worms,134,7,127,83330,766
DE-RP,26-04-2020,RKI,4,4,0,1587859200000,07319,Worms,138,7,131,83330,766
DE-RP,27-04-2020,RKI,0,0,0,1587945600000,07319,Worms,138,7,131,83330,766
DE-RP,28-04-2020,RKI,0,0,0,1588032000000,07319,Worms,138,7,131,83330,766
DE-RP,29-04-2020,RKI,2,2,0,1588118400000,07319,Worms,140,7,133,83330,766
DE-RP,30-04-2020,RKI,1,1,0,1588204800000,07319,Worms,141,7,134,83330,766
DE-RP,01-05-2020,RKI,4,4,0,1588291200000,07319,Worms,145,7,138,83330,766
DE-RP,06-05-2020,RKI,0,0,0,1588723200000,07319,Worms,145,7,138,83330,766
DE-RP,07-05-2020,RKI,1,1,0,1588809600000,07319,Worms,146,7,139,83330,766
DE-RP,09-05-2020,RKI,3,3,0,1588982400000,07319,Worms,149,7,142,83330,766
DE-RP,11-05-2020,RKI,1,1,0,1589155200000,07319,Worms,150,7,143,83330,766
DE-RP,12-05-2020,RKI,0,0,0,1589241600000,07319,Worms,150,7,143,83330,766
DE-RP,15-05-2020,RKI,0,0,0,1589500800000,07319,Worms,150,7,143,83330,766
DE-RP,17-05-2020,RKI,0,0,0,1589673600000,07319,Worms,150,7,143,83330,766
DE-RP,18-05-2020,RKI,0,0,0,1589760000000,07319,Worms,150,7,143,83330,766
DE-RP,19-05-2020,RKI,0,0,0,1589846400000,07319,Worms,150,7,143,83330,766
DE-RP,20-05-2020,RKI,3,3,0,1589932800000,07319,Worms,153,7,146,83330,766
DE-RP,22-05-2020,RKI,1,1,0,1590105600000,07319,Worms,154,7,147,83330,766
DE-RP,23-05-2020,RKI,0,0,0,1590192000000,07319,Worms,154,7,147,83330,766
DE-RP,26-05-2020,RKI,0,0,0,1590451200000,07319,Worms,154,7,147,83330,766
DE-RP,27-05-2020,RKI,4,4,0,1590537600000,07319,Worms,158,7,151,83330,766
DE-RP,29-05-2020,RKI,2,2,0,1590710400000,07319,Worms,160,7,153,83330,766
DE-RP,10-06-2020,RKI,0,0,0,1591747200000,07319,Worms,160,7,153,83330,766
DE-RP,14-06-2020,RKI,0,0,0,1592092800000,07319,Worms,160,7,153,83330,766
DE-RP,16-06-2020,RKI,0,0,0,1592265600000,07319,Worms,160,7,153,83330,766
DE-RP,22-06-2020,RKI,0,0,0,1592784000000,07319,Worms,160,7,153,83330,766
DE-RP,09-07-2020,RKI,0,0,0,1594252800000,07319,Worms,160,7,153,83330,766
DE-RP,11-07-2020,RKI,1,0,0,1594425600000,07319,Worms,161,7,153,83330,766
DE-RP,21-03-2020,RKI,0,0,0,1584748800000,07320,Zweibrücken,1,0,1,34209,484
DE-RP,24-03-2020,RKI,0,0,0,1585008000000,07320,Zweibrücken,1,0,1,34209,484
DE-RP,26-03-2020,RKI,0,0,0,1585180800000,07320,Zweibrücken,1,0,1,34209,484
DE-RP,27-03-2020,RKI,3,3,0,1585267200000,07320,Zweibrücken,4,0,4,34209,484
DE-RP,30-03-2020,RKI,1,1,0,1585526400000,07320,Zweibrücken,5,0,5,34209,484
DE-RP,31-03-2020,RKI,0,0,0,1585612800000,07320,Zweibrücken,5,0,5,34209,484
DE-RP,01-04-2020,RKI,4,4,0,1585699200000,07320,Zweibrücken,9,0,9,34209,484
DE-RP,02-04-2020,RKI,1,1,0,1585785600000,07320,Zweibrücken,10,0,10,34209,484
DE-RP,03-04-2020,RKI,1,1,0,1585872000000,07320,Zweibrücken,11,0,11,34209,484
DE-RP,04-04-2020,RKI,3,3,0,1585958400000,07320,Zweibrücken,14,0,14,34209,484
DE-RP,07-04-2020,RKI,0,0,0,1586217600000,07320,Zweibrücken,14,0,14,34209,484
DE-RP,11-04-2020,RKI,3,3,0,1586563200000,07320,Zweibrücken,17,0,17,34209,484
DE-RP,13-04-2020,RKI,0,0,0,1586736000000,07320,Zweibrücken,17,0,17,34209,484
DE-RP,14-04-2020,RKI,0,0,0,1586822400000,07320,Zweibrücken,17,0,17,34209,484
DE-RP,16-04-2020,RKI,1,0,1,1586995200000,07320,Zweibrücken,18,1,17,34209,484
DE-RP,17-04-2020,RKI,0,0,0,1587081600000,07320,Zweibrücken,18,1,17,34209,484
DE-RP,11-05-2020,RKI,0,0,0,1589155200000,07320,Zweibrücken,18,1,17,34209,484
DE-RP,15-06-2020,RKI,0,0,0,1592179200000,07320,Zweibrücken,18,1,17,34209,484
DE-RP,17-06-2020,RKI,1,1,0,1592352000000,07320,Zweibrücken,19,1,18,34209,484
DE-RP,18-06-2020,RKI,0,0,0,1592438400000,07320,Zweibrücken,19,1,18,34209,484
DE-RP,20-06-2020,RKI,0,0,0,1592611200000,07320,Zweibrücken,19,1,18,34209,484
DE-RP,23-06-2020,RKI,1,1,0,1592870400000,07320,Zweibrücken,20,1,19,34209,484
DE-RP,24-06-2020,RKI,0,0,0,1592956800000,07320,Zweibrücken,20,1,19,34209,484
DE-RP,14-03-2020,RKI,4,4,0,1584144000000,07331,Alzey-Worms,5,0,5,129244,220
DE-RP,16-03-2020,RKI,3,3,0,1584316800000,07331,Alzey-Worms,8,0,8,129244,220
DE-RP,17-03-2020,RKI,12,12,0,1584403200000,07331,Alzey-Worms,20,0,20,129244,220
DE-RP,18-03-2020,RKI,0,0,0,1584489600000,07331,Alzey-Worms,20,0,20,129244,220
DE-RP,19-03-2020,RKI,8,8,0,1584576000000,07331,Alzey-Worms,28,0,28,129244,220
DE-RP,20-03-2020,RKI,8,8,0,1584662400000,07331,Alzey-Worms,36,0,36,129244,220
DE-RP,21-03-2020,RKI,0,0,0,1584748800000,07331,Alzey-Worms,36,0,36,129244,220
DE-RP,22-03-2020,RKI,6,6,0,1584835200000,07331,Alzey-Worms,42,0,42,129244,220
DE-RP,23-03-2020,RKI,5,5,0,1584921600000,07331,Alzey-Worms,47,0,47,129244,220
DE-RP,24-03-2020,RKI,1,1,0,1585008000000,07331,Alzey-Worms,48,0,48,129244,220
DE-RP,25-03-2020,RKI,3,3,0,1585094400000,07331,Alzey-Worms,51,0,51,129244,220
DE-RP,26-03-2020,RKI,6,6,0,1585180800000,07331,Alzey-Worms,57,0,57,129244,220
DE-RP,27-03-2020,RKI,4,4,0,1585267200000,07331,Alzey-Worms,61,0,61,129244,220
DE-RP,28-03-2020,RKI,4,4,0,1585353600000,07331,Alzey-Worms,65,0,65,129244,220
DE-RP,29-03-2020,RKI,2,1,1,1585440000000,07331,Alzey-Worms,67,1,66,129244,220
DE-RP,30-03-2020,RKI,0,0,0,1585526400000,07331,Alzey-Worms,67,1,66,129244,220
DE-RP,31-03-2020,RKI,3,3,0,1585612800000,07331,Alzey-Worms,70,1,69,129244,220
DE-RP,01-04-2020,RKI,3,3,0,1585699200000,07331,Alzey-Worms,73,1,72,129244,220
DE-RP,02-04-2020,RKI,2,2,0,1585785600000,07331,Alzey-Worms,75,1,74,129244,220
DE-RP,03-04-2020,RKI,4,3,1,1585872000000,07331,Alzey-Worms,79,2,77,129244,220
DE-RP,04-04-2020,RKI,4,4,0,1585958400000,07331,Alzey-Worms,83,2,81,129244,220
DE-RP,07-04-2020,RKI,3,3,0,1586217600000,07331,Alzey-Worms,86,2,84,129244,220
DE-RP,08-04-2020,RKI,8,8,0,1586304000000,07331,Alzey-Worms,94,2,92,129244,220
DE-RP,09-04-2020,RKI,3,1,2,1586390400000,07331,Alzey-Worms,97,4,93,129244,220
DE-RP,10-04-2020,RKI,8,8,0,1586476800000,07331,Alzey-Worms,105,4,101,129244,220
DE-RP,11-04-2020,RKI,2,1,1,1586563200000,07331,Alzey-Worms,107,5,102,129244,220
DE-RP,13-04-2020,RKI,2,2,0,1586736000000,07331,Alzey-Worms,109,5,104,129244,220
DE-RP,14-04-2020,RKI,8,8,0,1586822400000,07331,Alzey-Worms,117,5,112,129244,220
DE-RP,15-04-2020,RKI,2,2,0,1586908800000,07331,Alzey-Worms,119,5,114,129244,220
DE-RP,16-04-2020,RKI,3,3,0,1586995200000,07331,Alzey-Worms,122,5,117,129244,220
DE-RP,17-04-2020,RKI,6,6,0,1587081600000,07331,Alzey-Worms,128,5,123,129244,220
DE-RP,18-04-2020,RKI,2,2,0,1587168000000,07331,Alzey-Worms,130,5,125,129244,220
DE-RP,19-04-2020,RKI,0,0,0,1587254400000,07331,Alzey-Worms,130,5,125,129244,220
DE-RP,20-04-2020,RKI,1,1,0,1587340800000,07331,Alzey-Worms,131,5,126,129244,220
DE-RP,21-04-2020,RKI,4,4,0,1587427200000,07331,Alzey-Worms,135,5,130,129244,220
DE-RP,22-04-2020,RKI,1,1,0,1587513600000,07331,Alzey-Worms,136,5,131,129244,220
DE-RP,23-04-2020,RKI,3,3,0,1587600000000,07331,Alzey-Worms,139,5,134,129244,220
DE-RP,24-04-2020,RKI,6,5,1,1587686400000,07331,Alzey-Worms,145,6,139,129244,220
DE-RP,25-04-2020,RKI,7,7,0,1587772800000,07331,Alzey-Worms,152,6,146,129244,220
DE-RP,26-04-2020,RKI,3,3,0,1587859200000,07331,Alzey-Worms,155,6,149,129244,220
DE-RP,27-04-2020,RKI,10,8,2,1587945600000,07331,Alzey-Worms,165,8,157,129244,220
DE-RP,28-04-2020,RKI,7,5,2,1588032000000,07331,Alzey-Worms,172,10,162,129244,220
DE-RP,29-04-2020,RKI,5,4,1,1588118400000,07331,Alzey-Worms,177,11,166,129244,220
DE-RP,30-04-2020,RKI,4,4,0,1588204800000,07331,Alzey-Worms,181,11,170,129244,220
DE-RP,01-05-2020,RKI,1,1,0,1588291200000,07331,Alzey-Worms,182,11,171,129244,220
DE-RP,05-05-2020,RKI,4,4,0,1588636800000,07331,Alzey-Worms,186,11,175,129244,220
DE-RP,06-05-2020,RKI,4,4,0,1588723200000,07331,Alzey-Worms,190,11,179,129244,220
DE-RP,07-05-2020,RKI,2,2,0,1588809600000,07331,Alzey-Worms,192,11,181,129244,220
DE-RP,08-05-2020,RKI,1,1,0,1588896000000,07331,Alzey-Worms,193,11,182,129244,220
DE-RP,09-05-2020,RKI,2,2,0,1588982400000,07331,Alzey-Worms,195,11,184,129244,220
DE-RP,12-05-2020,RKI,3,3,0,1589241600000,07331,Alzey-Worms,198,11,187,129244,220
DE-RP,13-05-2020,RKI,4,4,0,1589328000000,07331,Alzey-Worms,202,11,191,129244,220
DE-RP,14-05-2020,RKI,2,2,0,1589414400000,07331,Alzey-Worms,204,11,193,129244,220
DE-RP,15-05-2020,RKI,0,0,0,1589500800000,07331,Alzey-Worms,204,11,193,129244,220
DE-RP,19-05-2020,RKI,0,0,0,1589846400000,07331,Alzey-Worms,204,11,193,129244,220
DE-RP,20-05-2020,RKI,1,1,0,1589932800000,07331,Alzey-Worms,205,11,194,129244,220
DE-RP,22-05-2020,RKI,0,0,0,1590105600000,07331,Alzey-Worms,205,11,194,129244,220
DE-RP,30-05-2020,RKI,0,0,0,1590796800000,07331,Alzey-Worms,205,11,194,129244,220
DE-RP,05-06-2020,RKI,1,1,0,1591315200000,07331,Alzey-Worms,206,11,195,129244,220
DE-RP,14-06-2020,RKI,0,0,0,1592092800000,07331,Alzey-Worms,206,11,195,129244,220
DE-RP,16-06-2020,RKI,0,0,0,1592265600000,07331,Alzey-Worms,206,11,195,129244,220
DE-RP,23-06-2020,RKI,0,0,0,1592870400000,07331,Alzey-Worms,206,11,195,129244,220
DE-RP,07-03-2020,RKI,0,0,0,1583539200000,07332,Bad Dürkheim,0,0,0,132660,223
DE-RP,09-03-2020,RKI,2,2,0,1583712000000,07332,Bad Dürkheim,2,0,2,132660,223
DE-RP,11-03-2020,RKI,1,1,0,1583884800000,07332,Bad Dürkheim,3,0,3,132660,223
DE-RP,12-03-2020,RKI,0,0,0,1583971200000,07332,Bad Dürkheim,3,0,3,132660,223
DE-RP,13-03-2020,RKI,3,3,0,1584057600000,07332,Bad Dürkheim,6,0,6,132660,223
DE-RP,14-03-2020,RKI,1,1,0,1584144000000,07332,Bad Dürkheim,7,0,7,132660,223
DE-RP,15-03-2020,RKI,0,0,0,1584230400000,07332,Bad Dürkheim,7,0,7,132660,223
DE-RP,16-03-2020,RKI,5,5,0,1584316800000,07332,Bad Dürkheim,12,0,12,132660,223
DE-RP,17-03-2020,RKI,17,17,0,1584403200000,07332,Bad Dürkheim,29,0,29,132660,223
DE-RP,18-03-2020,RKI,8,8,0,1584489600000,07332,Bad Dürkheim,37,0,37,132660,223
DE-RP,19-03-2020,RKI,6,6,0,1584576000000,07332,Bad Dürkheim,43,0,43,132660,223
DE-RP,20-03-2020,RKI,12,12,0,1584662400000,07332,Bad Dürkheim,55,0,55,132660,223
DE-RP,21-03-2020,RKI,11,11,0,1584748800000,07332,Bad Dürkheim,66,0,66,132660,223
DE-RP,22-03-2020,RKI,4,2,2,1584835200000,07332,Bad Dürkheim,70,2,68,132660,223
DE-RP,23-03-2020,RKI,10,10,0,1584921600000,07332,Bad Dürkheim,80,2,78,132660,223
DE-RP,24-03-2020,RKI,11,11,0,1585008000000,07332,Bad Dürkheim,91,2,89,132660,223
DE-RP,25-03-2020,RKI,6,5,1,1585094400000,07332,Bad Dürkheim,97,3,94,132660,223
DE-RP,26-03-2020,RKI,14,13,1,1585180800000,07332,Bad Dürkheim,111,4,107,132660,223
DE-RP,27-03-2020,RKI,6,6,0,1585267200000,07332,Bad Dürkheim,117,4,113,132660,223
DE-RP,28-03-2020,RKI,17,16,1,1585353600000,07332,Bad Dürkheim,134,5,129,132660,223
DE-RP,29-03-2020,RKI,0,0,0,1585440000000,07332,Bad Dürkheim,134,5,129,132660,223
DE-RP,30-03-2020,RKI,6,6,0,1585526400000,07332,Bad Dürkheim,140,5,135,132660,223
DE-RP,31-03-2020,RKI,8,8,0,1585612800000,07332,Bad Dürkheim,148,5,143,132660,223
DE-RP,01-04-2020,RKI,9,9,0,1585699200000,07332,Bad Dürkheim,157,5,152,132660,223
DE-RP,02-04-2020,RKI,8,8,0,1585785600000,07332,Bad Dürkheim,165,5,160,132660,223
DE-RP,03-04-2020,RKI,7,6,1,1585872000000,07332,Bad Dürkheim,172,6,166,132660,223
DE-RP,04-04-2020,RKI,10,10,0,1585958400000,07332,Bad Dürkheim,182,6,176,132660,223
DE-RP,05-04-2020,RKI,1,1,0,1586044800000,07332,Bad Dürkheim,183,6,177,132660,223
DE-RP,06-04-2020,RKI,7,7,0,1586131200000,07332,Bad Dürkheim,190,6,184,132660,223
DE-RP,07-04-2020,RKI,3,3,0,1586217600000,07332,Bad Dürkheim,193,6,187,132660,223
DE-RP,08-04-2020,RKI,9,8,1,1586304000000,07332,Bad Dürkheim,202,7,195,132660,223
DE-RP,09-04-2020,RKI,9,8,1,1586390400000,07332,Bad Dürkheim,211,8,203,132660,223
DE-RP,10-04-2020,RKI,8,7,1,1586476800000,07332,Bad Dürkheim,219,9,210,132660,223
DE-RP,11-04-2020,RKI,4,4,0,1586563200000,07332,Bad Dürkheim,223,9,214,132660,223
DE-RP,12-04-2020,RKI,1,1,0,1586649600000,07332,Bad Dürkheim,224,9,215,132660,223
DE-RP,13-04-2020,RKI,1,1,0,1586736000000,07332,Bad Dürkheim,225,9,216,132660,223
DE-RP,14-04-2020,RKI,1,1,0,1586822400000,07332,Bad Dürkheim,226,9,217,132660,223
DE-RP,15-04-2020,RKI,3,3,0,1586908800000,07332,Bad Dürkheim,229,9,220,132660,223
DE-RP,16-04-2020,RKI,8,7,1,1586995200000,07332,Bad Dürkheim,237,10,227,132660,223
DE-RP,17-04-2020,RKI,10,9,1,1587081600000,07332,Bad Dürkheim,247,11,236,132660,223
DE-RP,18-04-2020,RKI,1,1,0,1587168000000,07332,Bad Dürkheim,248,11,237,132660,223
DE-RP,19-04-2020,RKI,2,2,0,1587254400000,07332,Bad Dürkheim,250,11,239,132660,223
DE-RP,20-04-2020,RKI,0,0,0,1587340800000,07332,Bad Dürkheim,250,11,239,132660,223
DE-RP,21-04-2020,RKI,1,1,0,1587427200000,07332,Bad Dürkheim,251,11,240,132660,223
DE-RP,22-04-2020,RKI,1,1,0,1587513600000,07332,Bad Dürkheim,252,11,241,132660,223
DE-RP,24-04-2020,RKI,2,2,0,1587686400000,07332,Bad Dürkheim,254,11,243,132660,223
DE-RP,25-04-2020,RKI,3,3,0,1587772800000,07332,Bad Dürkheim,257,11,246,132660,223
DE-RP,26-04-2020,RKI,0,0,0,1587859200000,07332,Bad Dürkheim,257,11,246,132660,223
DE-RP,27-04-2020,RKI,0,0,0,1587945600000,07332,Bad Dürkheim,257,11,246,132660,223
DE-RP,28-04-2020,RKI,1,0,1,1588032000000,07332,Bad Dürkheim,258,12,246,132660,223
DE-RP,29-04-2020,RKI,0,0,0,1588118400000,07332,Bad Dürkheim,258,12,246,132660,223
DE-RP,30-04-2020,RKI,1,1,0,1588204800000,07332,Bad Dürkheim,259,12,247,132660,223
DE-RP,01-05-2020,RKI,0,0,0,1588291200000,07332,Bad Dürkheim,259,12,247,132660,223
DE-RP,06-05-2020,RKI,0,0,0,1588723200000,07332,Bad Dürkheim,259,12,247,132660,223
DE-RP,09-05-2020,RKI,0,0,0,1588982400000,07332,Bad Dürkheim,259,12,247,132660,223
DE-RP,12-05-2020,RKI,0,0,0,1589241600000,07332,Bad Dürkheim,259,12,247,132660,223
DE-RP,13-05-2020,RKI,1,1,0,1589328000000,07332,Bad Dürkheim,260,12,248,132660,223
DE-RP,14-05-2020,RKI,2,2,0,1589414400000,07332,Bad Dürkheim,262,12,250,132660,223
DE-RP,04-06-2020,RKI,1,1,0,1591228800000,07332,Bad Dürkheim,263,12,251,132660,223
DE-RP,12-06-2020,RKI,1,1,0,1591920000000,07332,Bad Dürkheim,264,12,252,132660,223
DE-RP,16-06-2020,RKI,0,0,0,1592265600000,07332,Bad Dürkheim,264,12,252,132660,223
DE-RP,20-03-2020,RKI,0,0,0,1584662400000,07333,Donnersbergkreis,0,0,0,75101,116
DE-RP,22-03-2020,RKI,2,2,0,1584835200000,07333,Donnersbergkreis,2,0,2,75101,116
DE-RP,25-03-2020,RKI,0,0,0,1585094400000,07333,Donnersbergkreis,2,0,2,75101,116
DE-RP,26-03-2020,RKI,2,2,0,1585180800000,07333,Donnersbergkreis,4,0,4,75101,116
DE-RP,27-03-2020,RKI,1,1,0,1585267200000,07333,Donnersbergkreis,5,0,5,75101,116
DE-RP,29-03-2020,RKI,0,0,0,1585440000000,07333,Donnersbergkreis,5,0,5,75101,116
DE-RP,31-03-2020,RKI,0,0,0,1585612800000,07333,Donnersbergkreis,5,0,5,75101,116
DE-RP,01-04-2020,RKI,1,1,0,1585699200000,07333,Donnersbergkreis,6,0,6,75101,116
DE-RP,03-04-2020,RKI,0,0,0,1585872000000,07333,Donnersbergkreis,6,0,6,75101,116
DE-RP,07-04-2020,RKI,0,0,0,1586217600000,07333,Donnersbergkreis,6,0,6,75101,116
DE-RP,09-04-2020,RKI,0,0,0,1586390400000,07333,Donnersbergkreis,6,0,6,75101,116
DE-RP,10-04-2020,RKI,0,0,0,1586476800000,07333,Donnersbergkreis,6,0,6,75101,116
DE-RP,14-04-2020,RKI,3,3,0,1586822400000,07333,Donnersbergkreis,9,0,9,75101,116
DE-RP,15-04-2020,RKI,0,0,0,1586908800000,07333,Donnersbergkreis,9,0,9,75101,116
DE-RP,27-04-2020,RKI,0,0,0,1587945600000,07333,Donnersbergkreis,9,0,9,75101,116
DE-RP,28-04-2020,RKI,0,0,0,1588032000000,07333,Donnersbergkreis,9,0,9,75101,116
DE-RP,04-05-2020,RKI,0,0,0,1588550400000,07333,Donnersbergkreis,9,0,9,75101,116
DE-RP,08-05-2020,RKI,2,2,0,1588896000000,07333,Donnersbergkreis,11,0,11,75101,116
DE-RP,12-05-2020,RKI,0,0,0,1589241600000,07333,Donnersbergkreis,11,0,11,75101,116
DE-RP,04-06-2020,RKI,0,0,0,1591228800000,07333,Donnersbergkreis,11,0,11,75101,116
DE-RP,02-07-2020,RKI,0,0,0,1593648000000,07333,Donnersbergkreis,11,0,11,75101,116
DE-SL,11-03-2020,RKI,6,6,0,1583884800000,10041,Stadtverband Saarbrücken,6,0,6,329708,803
DE-SL,12-03-2020,RKI,1,1,0,1583971200000,10041,Stadtverband Saarbrücken,7,0,7,329708,803
DE-SL,13-03-2020,RKI,2,2,0,1584057600000,10041,Stadtverband Saarbrücken,9,0,9,329708,803
DE-SL,14-03-2020,RKI,5,5,0,1584144000000,10041,Stadtverband Saarbrücken,14,0,14,329708,803
DE-SL,15-03-2020,RKI,4,4,0,1584230400000,10041,Stadtverband Saarbrücken,18,0,18,329708,803
DE-SL,16-03-2020,RKI,9,9,0,1584316800000,10041,Stadtverband Saarbrücken,27,0,27,329708,803
DE-SL,17-03-2020,RKI,0,0,0,1584403200000,10041,Stadtverband Saarbrücken,27,0,27,329708,803
DE-SL,18-03-2020,RKI,23,22,1,1584489600000,10041,Stadtverband Saarbrücken,50,1,49,329708,803
DE-SL,19-03-2020,RKI,25,25,0,1584576000000,10041,Stadtverband Saarbrücken,75,1,74,329708,803
DE-SL,20-03-2020,RKI,17,17,0,1584662400000,10041,Stadtverband Saarbrücken,92,1,91,329708,803
DE-SL,21-03-2020,RKI,9,8,1,1584748800000,10041,Stadtverband Saarbrücken,101,2,99,329708,803
DE-SL,22-03-2020,RKI,9,9,0,1584835200000,10041,Stadtverband Saarbrücken,110,2,108,329708,803
DE-SL,23-03-2020,RKI,26,23,3,1584921600000,10041,Stadtverband Saarbrücken,136,5,131,329708,803
DE-SL,24-03-2020,RKI,11,7,4,1585008000000,10041,Stadtverband Saarbrücken,147,9,138,329708,803
DE-SL,25-03-2020,RKI,17,14,3,1585094400000,10041,Stadtverband Saarbrücken,164,12,152,329708,803
DE-SL,26-03-2020,RKI,13,13,0,1585180800000,10041,Stadtverband Saarbrücken,177,12,165,329708,803
DE-SL,27-03-2020,RKI,23,22,1,1585267200000,10041,Stadtverband Saarbrücken,200,13,187,329708,803
DE-SL,28-03-2020,RKI,42,41,1,1585353600000,10041,Stadtverband Saarbrücken,242,14,228,329708,803
DE-SL,29-03-2020,RKI,26,22,4,1585440000000,10041,Stadtverband Saarbrücken,268,18,250,329708,803
DE-SL,30-03-2020,RKI,27,25,2,1585526400000,10041,Stadtverband Saarbrücken,295,20,275,329708,803
DE-SL,31-03-2020,RKI,67,57,10,1585612800000,10041,Stadtverband Saarbrücken,362,30,332,329708,803
DE-SL,01-04-2020,RKI,60,58,2,1585699200000,10041,Stadtverband Saarbrücken,422,32,390,329708,803
DE-SL,02-04-2020,RKI,116,102,14,1585785600000,10041,Stadtverband Saarbrücken,538,46,492,329708,803
DE-SL,03-04-2020,RKI,14,13,1,1585872000000,10041,Stadtverband Saarbrücken,552,47,505,329708,803
DE-SL,04-04-2020,RKI,36,30,6,1585958400000,10041,Stadtverband Saarbrücken,588,53,535,329708,803
DE-SL,05-04-2020,RKI,63,56,7,1586044800000,10041,Stadtverband Saarbrücken,651,60,591,329708,803
DE-SL,06-04-2020,RKI,38,33,5,1586131200000,10041,Stadtverband Saarbrücken,689,65,624,329708,803
DE-SL,07-04-2020,RKI,32,31,1,1586217600000,10041,Stadtverband Saarbrücken,721,66,655,329708,803
DE-SL,08-04-2020,RKI,84,75,9,1586304000000,10041,Stadtverband Saarbrücken,805,75,730,329708,803
DE-SL,09-04-2020,RKI,62,57,5,1586390400000,10041,Stadtverband Saarbrücken,867,80,787,329708,803
DE-SL,10-04-2020,RKI,60,55,5,1586476800000,10041,Stadtverband Saarbrücken,927,85,842,329708,803
DE-SL,11-04-2020,RKI,5,4,1,1586563200000,10041,Stadtverband Saarbrücken,932,86,846,329708,803
DE-SL,12-04-2020,RKI,6,6,0,1586649600000,10041,Stadtverband Saarbrücken,938,86,852,329708,803
DE-SL,13-04-2020,RKI,7,5,2,1586736000000,10041,Stadtverband Saarbrücken,945,88,857,329708,803
DE-SL,14-04-2020,RKI,10,10,0,1586822400000,10041,Stadtverband Saarbrücken,955,88,867,329708,803
DE-SL,15-04-2020,RKI,20,17,3,1586908800000,10041,Stadtverband Saarbrücken,975,91,884,329708,803
DE-SL,16-04-2020,RKI,27,25,2,1586995200000,10041,Stadtverband Saarbrücken,1002,93,909,329708,803
DE-SL,17-04-2020,RKI,12,11,1,1587081600000,10041,Stadtverband Saarbrücken,1014,94,920,329708,803
DE-SL,18-04-2020,RKI,14,12,2,1587168000000,10041,Stadtverband Saarbrücken,1028,96,932,329708,803
DE-SL,19-04-2020,RKI,0,0,0,1587254400000,10041,Stadtverband Saarbrücken,1028,96,932,329708,803
DE-SL,20-04-2020,RKI,11,9,2,1587340800000,10041,Stadtverband Saarbrücken,1039,98,941,329708,803
DE-SL,21-04-2020,RKI,18,13,5,1587427200000,10041,Stadtverband Saarbrücken,1057,103,954,329708,803
DE-SL,22-04-2020,RKI,20,16,4,1587513600000,10041,Stadtverband Saarbrücken,1077,107,970,329708,803
DE-SL,23-04-2020,RKI,8,6,2,1587600000000,10041,Stadtverband Saarbrücken,1085,109,976,329708,803
DE-SL,24-04-2020,RKI,11,10,1,1587686400000,10041,Stadtverband Saarbrücken,1096,110,986,329708,803
DE-SL,25-04-2020,RKI,5,5,0,1587772800000,10041,Stadtverband Saarbrücken,1101,110,991,329708,803
DE-SL,26-04-2020,RKI,13,13,0,1587859200000,10041,Stadtverband Saarbrücken,1114,110,1004,329708,803
DE-SL,28-04-2020,RKI,14,14,0,1588032000000,10041,Stadtverband Saarbrücken,1128,110,1018,329708,803
DE-SL,29-04-2020,RKI,14,13,1,1588118400000,10041,Stadtverband Saarbrücken,1142,111,1031,329708,803
DE-SL,30-04-2020,RKI,8,8,0,1588204800000,10041,Stadtverband Saarbrücken,1150,111,1039,329708,803
DE-SL,01-05-2020,RKI,8,8,0,1588291200000,10041,Stadtverband Saarbrücken,1158,111,1047,329708,803
DE-SL,03-05-2020,RKI,1,1,0,1588464000000,10041,Stadtverband Saarbrücken,1159,111,1048,329708,803
DE-SL,05-05-2020,RKI,0,0,0,1588636800000,10041,Stadtverband Saarbrücken,1159,111,1048,329708,803
DE-SL,06-05-2020,RKI,0,0,0,1588723200000,10041,Stadtverband Saarbrücken,1159,111,1048,329708,803
DE-SL,07-05-2020,RKI,1,1,0,1588809600000,10041,Stadtverband Saarbrücken,1160,111,1049,329708,803
DE-SL,08-05-2020,RKI,0,0,0,1588896000000,10041,Stadtverband Saarbrücken,1160,111,1049,329708,803
DE-SL,09-05-2020,RKI,1,1,0,1588982400000,10041,Stadtverband Saarbrücken,1161,111,1050,329708,803
DE-SL,12-05-2020,RKI,1,1,0,1589241600000,10041,Stadtverband Saarbrücken,1162,111,1051,329708,803
DE-SL,13-05-2020,RKI,0,0,0,1589328000000,10041,Stadtverband Saarbrücken,1162,111,1051,329708,803
DE-SL,14-05-2020,RKI,1,1,0,1589414400000,10041,Stadtverband Saarbrücken,1163,111,1052,329708,803
DE-SL,15-05-2020,RKI,2,1,1,1589500800000,10041,Stadtverband Saarbrücken,1165,112,1053,329708,803
DE-SL,16-05-2020,RKI,0,0,0,1589587200000,10041,Stadtverband Saarbrücken,1165,112,1053,329708,803
DE-SL,18-05-2020,RKI,1,1,0,1589760000000,10041,Stadtverband Saarbrücken,1166,112,1054,329708,803
DE-SL,19-05-2020,RKI,0,0,0,1589846400000,10041,Stadtverband Saarbrücken,1166,112,1054,329708,803
DE-SL,20-05-2020,RKI,0,0,0,1589932800000,10041,Stadtverband Saarbrücken,1166,112,1054,329708,803
DE-SL,21-05-2020,RKI,0,0,0,1590019200000,10041,Stadtverband Saarbrücken,1166,112,1054,329708,803
DE-SL,22-05-2020,RKI,0,0,0,1590105600000,10041,Stadtverband Saarbrücken,1166,112,1054,329708,803
DE-SL,23-05-2020,RKI,0,0,0,1590192000000,10041,Stadtverband Saarbrücken,1166,112,1054,329708,803
DE-SL,25-05-2020,RKI,0,0,0,1590364800000,10041,Stadtverband Saarbrücken,1166,112,1054,329708,803
DE-SL,26-05-2020,RKI,0,0,0,1590451200000,10041,Stadtverband Saarbrücken,1166,112,1054,329708,803
DE-SL,27-05-2020,RKI,1,0,1,1590537600000,10041,Stadtverband Saarbrücken,1167,113,1054,329708,803
DE-SL,28-05-2020,RKI,3,3,0,1590624000000,10041,Stadtverband Saarbrücken,1170,113,1057,329708,803
DE-SL,29-05-2020,RKI,1,1,0,1590710400000,10041,Stadtverband Saarbrücken,1171,113,1058,329708,803
DE-SL,01-06-2020,RKI,1,1,0,1590969600000,10041,Stadtverband Saarbrücken,1172,113,1059,329708,803
DE-SL,03-06-2020,RKI,0,0,0,1591142400000,10041,Stadtverband Saarbrücken,1172,113,1059,329708,803
DE-SL,04-06-2020,RKI,0,0,0,1591228800000,10041,Stadtverband Saarbrücken,1172,113,1059,329708,803
DE-SL,08-06-2020,RKI,1,1,0,1591574400000,10041,Stadtverband Saarbrücken,1173,113,1060,329708,803
DE-SL,09-06-2020,RKI,0,0,0,1591660800000,10041,Stadtverband Saarbrücken,1173,113,1060,329708,803
DE-SL,16-06-2020,RKI,0,0,0,1592265600000,10041,Stadtverband Saarbrücken,1173,113,1060,329708,803
DE-SL,28-06-2020,RKI,0,0,0,1593302400000,10041,Stadtverband Saarbrücken,1173,113,1060,329708,803
DE-SL,04-07-2020,RKI,0,0,0,1593820800000,10041,Stadtverband Saarbrücken,1173,113,1060,329708,803
DE-SL,07-07-2020,RKI,0,0,0,1594080000000,10041,Stadtverband Saarbrücken,1173,113,1060,329708,803
DE-SL,13-07-2020,RKI,1,0,0,1594598400000,10041,Stadtverband Saarbrücken,1174,113,1060,329708,803
DE-SL,14-07-2020,RKI,0,0,0,1594684800000,10041,Stadtverband Saarbrücken,1174,113,1060,329708,803
DE-SL,12-03-2020,RKI,0,0,0,1583971200000,10042,Merzig-Wadern,0,0,0,103366,186
DE-SL,16-03-2020,RKI,0,0,0,1584316800000,10042,Merzig-Wadern,0,0,0,103366,186
DE-SL,17-03-2020,RKI,0,0,0,1584403200000,10042,Merzig-Wadern,0,0,0,103366,186
DE-SL,20-03-2020,RKI,0,0,0,1584662400000,10042,Merzig-Wadern,0,0,0,103366,186
DE-SL,21-03-2020,RKI,0,0,0,1584748800000,10042,Merzig-Wadern,0,0,0,103366,186
DE-SL,22-03-2020,RKI,11,11,0,1584835200000,10042,Merzig-Wadern,11,0,11,103366,186
DE-SL,23-03-2020,RKI,3,3,0,1584921600000,10042,Merzig-Wadern,14,0,14,103366,186
DE-SL,24-03-2020,RKI,1,1,0,1585008000000,10042,Merzig-Wadern,15,0,15,103366,186
DE-SL,25-03-2020,RKI,3,3,0,1585094400000,10042,Merzig-Wadern,18,0,18,103366,186
DE-SL,26-03-2020,RKI,7,7,0,1585180800000,10042,Merzig-Wadern,25,0,25,103366,186
DE-SL,27-03-2020,RKI,2,2,0,1585267200000,10042,Merzig-Wadern,27,0,27,103366,186
DE-SL,28-03-2020,RKI,3,3,0,1585353600000,10042,Merzig-Wadern,30,0,30,103366,186
DE-SL,29-03-2020,RKI,5,5,0,1585440000000,10042,Merzig-Wadern,35,0,35,103366,186
DE-SL,30-03-2020,RKI,4,4,0,1585526400000,10042,Merzig-Wadern,39,0,39,103366,186
DE-SL,31-03-2020,RKI,6,6,0,1585612800000,10042,Merzig-Wadern,45,0,45,103366,186
DE-SL,01-04-2020,RKI,1,1,0,1585699200000,10042,Merzig-Wadern,46,0,46,103366,186
DE-SL,02-04-2020,RKI,6,5,1,1585785600000,10042,Merzig-Wadern,52,1,51,103366,186
DE-SL,03-04-2020,RKI,13,13,0,1585872000000,10042,Merzig-Wadern,65,1,64,103366,186
DE-SL,04-04-2020,RKI,25,24,1,1585958400000,10042,Merzig-Wadern,90,2,88,103366,186
DE-SL,05-04-2020,RKI,5,5,0,1586044800000,10042,Merzig-Wadern,95,2,93,103366,186
DE-SL,06-04-2020,RKI,6,6,0,1586131200000,10042,Merzig-Wadern,101,2,99,103366,186
DE-SL,07-04-2020,RKI,7,7,0,1586217600000,10042,Merzig-Wadern,108,2,106,103366,186
DE-SL,08-04-2020,RKI,13,13,0,1586304000000,10042,Merzig-Wadern,121,2,119,103366,186
DE-SL,09-04-2020,RKI,8,8,0,1586390400000,10042,Merzig-Wadern,129,2,127,103366,186
DE-SL,10-04-2020,RKI,3,3,0,1586476800000,10042,Merzig-Wadern,132,2,130,103366,186
DE-SL,11-04-2020,RKI,1,1,0,1586563200000,10042,Merzig-Wadern,133,2,131,103366,186
DE-SL,12-04-2020,RKI,1,1,0,1586649600000,10042,Merzig-Wadern,134,2,132,103366,186
DE-SL,13-04-2020,RKI,0,0,0,1586736000000,10042,Merzig-Wadern,134,2,132,103366,186
DE-SL,14-04-2020,RKI,2,2,0,1586822400000,10042,Merzig-Wadern,136,2,134,103366,186
DE-SL,15-04-2020,RKI,2,2,0,1586908800000,10042,Merzig-Wadern,138,2,136,103366,186
DE-SL,17-04-2020,RKI,2,2,0,1587081600000,10042,Merzig-Wadern,140,2,138,103366,186
DE-SL,18-04-2020,RKI,1,1,0,1587168000000,10042,Merzig-Wadern,141,2,139,103366,186
DE-SL,19-04-2020,RKI,0,0,0,1587254400000,10042,Merzig-Wadern,141,2,139,103366,186
DE-SL,20-04-2020,RKI,0,0,0,1587340800000,10042,Merzig-Wadern,141,2,139,103366,186
DE-SL,22-04-2020,RKI,2,2,0,1587513600000,10042,Merzig-Wadern,143,2,141,103366,186
DE-SL,23-04-2020,RKI,1,1,0,1587600000000,10042,Merzig-Wadern,144,2,142,103366,186
DE-SL,24-04-2020,RKI,0,0,0,1587686400000,10042,Merzig-Wadern,144,2,142,103366,186
DE-SL,25-04-2020,RKI,0,0,0,1587772800000,10042,Merzig-Wadern,144,2,142,103366,186
DE-SL,29-04-2020,RKI,1,1,0,1588118400000,10042,Merzig-Wadern,145,2,143,103366,186
DE-SL,02-05-2020,RKI,1,1,0,1588377600000,10042,Merzig-Wadern,146,2,144,103366,186
DE-SL,07-05-2020,RKI,2,2,0,1588809600000,10042,Merzig-Wadern,148,2,146,103366,186
DE-SL,09-05-2020,RKI,0,0,0,1588982400000,10042,Merzig-Wadern,148,2,146,103366,186
DE-SL,14-05-2020,RKI,1,1,0,1589414400000,10042,Merzig-Wadern,149,2,147,103366,186
DE-SL,16-05-2020,RKI,0,0,0,1589587200000,10042,Merzig-Wadern,149,2,147,103366,186
DE-SL,19-05-2020,RKI,0,0,0,1589846400000,10042,Merzig-Wadern,149,2,147,103366,186
DE-SL,22-05-2020,RKI,0,0,0,1590105600000,10042,Merzig-Wadern,149,2,147,103366,186
DE-SL,29-05-2020,RKI,0,0,0,1590710400000,10042,Merzig-Wadern,149,2,147,103366,186
DE-SL,01-06-2020,RKI,1,1,0,1590969600000,10042,Merzig-Wadern,150,2,148,103366,186
DE-SL,02-06-2020,RKI,0,0,0,1591056000000,10042,Merzig-Wadern,150,2,148,103366,186
DE-SL,06-06-2020,RKI,0,0,0,1591401600000,10042,Merzig-Wadern,150,2,148,103366,186
DE-SL,08-06-2020,RKI,2,2,0,1591574400000,10042,Merzig-Wadern,152,2,150,103366,186
DE-SL,09-06-2020,RKI,0,0,0,1591660800000,10042,Merzig-Wadern,152,2,150,103366,186
DE-SL,10-06-2020,RKI,1,1,0,1591747200000,10042,Merzig-Wadern,153,2,151,103366,186
DE-SL,17-06-2020,RKI,0,0,0,1592352000000,10042,Merzig-Wadern,153,2,151,103366,186
DE-SL,24-06-2020,RKI,0,0,0,1592956800000,10042,Merzig-Wadern,153,2,151,103366,186
DE-SL,25-06-2020,RKI,0,0,0,1593043200000,10042,Merzig-Wadern,153,2,151,103366,186
DE-SL,09-07-2020,RKI,0,0,0,1594252800000,10042,Merzig-Wadern,153,2,151,103366,186
DE-SL,10-03-2020,RKI,0,0,0,1583798400000,10043,Neunkirchen,0,0,0,132206,530
DE-SL,12-03-2020,RKI,1,1,0,1583971200000,10043,Neunkirchen,1,0,1,132206,530
DE-SL,13-03-2020,RKI,4,4,0,1584057600000,10043,Neunkirchen,5,0,5,132206,530
DE-SL,16-03-2020,RKI,5,5,0,1584316800000,10043,Neunkirchen,10,0,10,132206,530
DE-SL,17-03-2020,RKI,9,9,0,1584403200000,10043,Neunkirchen,19,0,19,132206,530
DE-SL,18-03-2020,RKI,2,2,0,1584489600000,10043,Neunkirchen,21,0,21,132206,530
DE-SL,19-03-2020,RKI,2,2,0,1584576000000,10043,Neunkirchen,23,0,23,132206,530
DE-SL,20-03-2020,RKI,2,2,0,1584662400000,10043,Neunkirchen,25,0,25,132206,530
DE-SL,21-03-2020,RKI,3,3,0,1584748800000,10043,Neunkirchen,28,0,28,132206,530
DE-SL,23-03-2020,RKI,8,7,1,1584921600000,10043,Neunkirchen,36,1,35,132206,530
DE-SL,25-03-2020,RKI,0,0,0,1585094400000,10043,Neunkirchen,36,1,35,132206,530
DE-SL,26-03-2020,RKI,17,17,0,1585180800000,10043,Neunkirchen,53,1,52,132206,530
DE-SL,27-03-2020,RKI,10,10,0,1585267200000,10043,Neunkirchen,63,1,62,132206,530
DE-SL,28-03-2020,RKI,2,2,0,1585353600000,10043,Neunkirchen,65,1,64,132206,530
DE-SL,29-03-2020,RKI,13,13,0,1585440000000,10043,Neunkirchen,78,1,77,132206,530
DE-SL,30-03-2020,RKI,2,2,0,1585526400000,10043,Neunkirchen,80,1,79,132206,530
DE-SL,31-03-2020,RKI,7,6,1,1585612800000,10043,Neunkirchen,87,2,85,132206,530
DE-SL,01-04-2020,RKI,11,11,0,1585699200000,10043,Neunkirchen,98,2,96,132206,530
DE-SL,02-04-2020,RKI,9,8,1,1585785600000,10043,Neunkirchen,107,3,104,132206,530
DE-SL,03-04-2020,RKI,11,10,1,1585872000000,10043,Neunkirchen,118,4,114,132206,530
DE-SL,04-04-2020,RKI,9,9,0,1585958400000,10043,Neunkirchen,127,4,123,132206,530
DE-SL,05-04-2020,RKI,1,1,0,1586044800000,10043,Neunkirchen,128,4,124,132206,530
DE-SL,06-04-2020,RKI,3,2,1,1586131200000,10043,Neunkirchen,131,5,126,132206,530
DE-SL,07-04-2020,RKI,5,4,1,1586217600000,10043,Neunkirchen,136,6,130,132206,530
DE-SL,08-04-2020,RKI,2,2,0,1586304000000,10043,Neunkirchen,138,6,132,132206,530
DE-SL,09-04-2020,RKI,16,16,0,1586390400000,10043,Neunkirchen,154,6,148,132206,530
DE-SL,10-04-2020,RKI,2,1,1,1586476800000,10043,Neunkirchen,156,7,149,132206,530
DE-SL,11-04-2020,RKI,0,0,0,1586563200000,10043,Neunkirchen,156,7,149,132206,530
DE-SL,12-04-2020,RKI,3,3,0,1586649600000,10043,Neunkirchen,159,7,152,132206,530
DE-SL,13-04-2020,RKI,8,7,1,1586736000000,10043,Neunkirchen,167,8,159,132206,530
DE-SL,14-04-2020,RKI,1,1,0,1586822400000,10043,Neunkirchen,168,8,160,132206,530
DE-SL,15-04-2020,RKI,6,5,1,1586908800000,10043,Neunkirchen,174,9,165,132206,530
DE-SL,16-04-2020,RKI,2,2,0,1586995200000,10043,Neunkirchen,176,9,167,132206,530
DE-SL,17-04-2020,RKI,2,2,0,1587081600000,10043,Neunkirchen,178,9,169,132206,530
DE-SL,18-04-2020,RKI,2,2,0,1587168000000,10043,Neunkirchen,180,9,171,132206,530
DE-SL,21-04-2020,RKI,1,1,0,1587427200000,10043,Neunkirchen,181,9,172,132206,530
DE-SL,22-04-2020,RKI,2,2,0,1587513600000,10043,Neunkirchen,183,9,174,132206,530
DE-SL,23-04-2020,RKI,0,0,0,1587600000000,10043,Neunkirchen,183,9,174,132206,530
DE-SL,26-04-2020,RKI,0,0,0,1587859200000,10043,Neunkirchen,183,9,174,132206,530
DE-SL,27-04-2020,RKI,1,1,0,1587945600000,10043,Neunkirchen,184,9,175,132206,530
DE-SL,28-04-2020,RKI,1,1,0,1588032000000,10043,Neunkirchen,185,9,176,132206,530
DE-SL,29-04-2020,RKI,2,2,0,1588118400000,10043,Neunkirchen,187,9,178,132206,530
DE-SL,30-04-2020,RKI,4,4,0,1588204800000,10043,Neunkirchen,191,9,182,132206,530
DE-SL,01-05-2020,RKI,0,0,0,1588291200000,10043,Neunkirchen,191,9,182,132206,530
DE-SL,04-05-2020,RKI,0,0,0,1588550400000,10043,Neunkirchen,191,9,182,132206,530
DE-SL,06-05-2020,RKI,1,1,0,1588723200000,10043,Neunkirchen,192,9,183,132206,530
DE-SL,07-05-2020,RKI,1,1,0,1588809600000,10043,Neunkirchen,193,9,184,132206,530
DE-SL,08-05-2020,RKI,0,0,0,1588896000000,10043,Neunkirchen,193,9,184,132206,530
DE-SL,12-05-2020,RKI,1,1,0,1589241600000,10043,Neunkirchen,194,9,185,132206,530
DE-SL,13-05-2020,RKI,2,2,0,1589328000000,10043,Neunkirchen,196,9,187,132206,530
DE-SL,14-05-2020,RKI,3,3,0,1589414400000,10043,Neunkirchen,199,9,190,132206,530
DE-SL,15-05-2020,RKI,0,0,0,1589500800000,10043,Neunkirchen,199,9,190,132206,530
DE-SL,26-05-2020,RKI,0,0,0,1590451200000,10043,Neunkirchen,199,9,190,132206,530
DE-SL,27-05-2020,RKI,0,0,0,1590537600000,10043,Neunkirchen,199,9,190,132206,530
DE-SL,01-06-2020,RKI,1,0,1,1590969600000,10043,Neunkirchen,200,10,190,132206,530
DE-SL,05-06-2020,RKI,0,0,0,1591315200000,10043,Neunkirchen,200,10,190,132206,530
DE-SL,06-06-2020,RKI,3,3,0,1591401600000,10043,Neunkirchen,203,10,193,132206,530
DE-SL,08-06-2020,RKI,1,1,0,1591574400000,10043,Neunkirchen,204,10,194,132206,530
DE-SL,09-06-2020,RKI,1,1,0,1591660800000,10043,Neunkirchen,205,10,195,132206,530
DE-SL,13-06-2020,RKI,0,0,0,1592006400000,10043,Neunkirchen,205,10,195,132206,530
DE-SL,20-06-2020,RKI,0,0,0,1592611200000,10043,Neunkirchen,205,10,195,132206,530
DE-SL,09-07-2020,RKI,0,0,0,1594252800000,10043,Neunkirchen,205,10,195,132206,530
DE-SL,11-07-2020,RKI,0,0,0,1594425600000,10043,Neunkirchen,205,10,195,132206,530
DE-SL,10-03-2020,RKI,0,0,0,1583798400000,10044,Saarlouis,0,0,0,195201,425
DE-SL,11-03-2020,RKI,1,1,0,1583884800000,10044,Saarlouis,1,0,1,195201,425
DE-SL,13-03-2020,RKI,4,4,0,1584057600000,10044,Saarlouis,5,0,5,195201,425
DE-SL,14-03-2020,RKI,0,0,0,1584144000000,10044,Saarlouis,5,0,5,195201,425
DE-SL,15-03-2020,RKI,4,4,0,1584230400000,10044,Saarlouis,9,0,9,195201,425
DE-SL,16-03-2020,RKI,1,1,0,1584316800000,10044,Saarlouis,10,0,10,195201,425
DE-SL,17-03-2020,RKI,6,6,0,1584403200000,10044,Saarlouis,16,0,16,195201,425
DE-SL,18-03-2020,RKI,11,11,0,1584489600000,10044,Saarlouis,27,0,27,195201,425
DE-SL,19-03-2020,RKI,0,0,0,1584576000000,10044,Saarlouis,27,0,27,195201,425
DE-SL,20-03-2020,RKI,2,2,0,1584662400000,10044,Saarlouis,29,0,29,195201,425
DE-SL,21-03-2020,RKI,6,6,0,1584748800000,10044,Saarlouis,35,0,35,195201,425
DE-SL,22-03-2020,RKI,0,0,0,1584835200000,10044,Saarlouis,35,0,35,195201,425
DE-SL,23-03-2020,RKI,8,8,0,1584921600000,10044,Saarlouis,43,0,43,195201,425
DE-SL,24-03-2020,RKI,1,1,0,1585008000000,10044,Saarlouis,44,0,44,195201,425
DE-SL,25-03-2020,RKI,11,11,0,1585094400000,10044,Saarlouis,55,0,55,195201,425
DE-SL,26-03-2020,RKI,10,8,2,1585180800000,10044,Saarlouis,65,2,63,195201,425
DE-SL,27-03-2020,RKI,12,11,1,1585267200000,10044,Saarlouis,77,3,74,195201,425
DE-SL,28-03-2020,RKI,10,10,0,1585353600000,10044,Saarlouis,87,3,84,195201,425
DE-SL,29-03-2020,RKI,18,18,0,1585440000000,10044,Saarlouis,105,3,102,195201,425
DE-SL,30-03-2020,RKI,14,12,2,1585526400000,10044,Saarlouis,119,5,114,195201,425
DE-SL,31-03-2020,RKI,30,28,2,1585612800000,10044,Saarlouis,149,7,142,195201,425
DE-SL,01-04-2020,RKI,19,17,2,1585699200000,10044,Saarlouis,168,9,159,195201,425
DE-SL,02-04-2020,RKI,28,28,0,1585785600000,10044,Saarlouis,196,9,187,195201,425
DE-SL,03-04-2020,RKI,12,12,0,1585872000000,10044,Saarlouis,208,9,199,195201,425
DE-SL,04-04-2020,RKI,44,41,3,1585958400000,10044,Saarlouis,252,12,240,195201,425
DE-SL,05-04-2020,RKI,13,12,1,1586044800000,10044,Saarlouis,265,13,252,195201,425
DE-SL,06-04-2020,RKI,15,15,0,1586131200000,10044,Saarlouis,280,13,267,195201,425
DE-SL,07-04-2020,RKI,19,17,2,1586217600000,10044,Saarlouis,299,15,284,195201,425
DE-SL,08-04-2020,RKI,29,27,2,1586304000000,10044,Saarlouis,328,17,311,195201,425
DE-SL,09-04-2020,RKI,24,24,0,1586390400000,10044,Saarlouis,352,17,335,195201,425
DE-SL,10-04-2020,RKI,13,12,1,1586476800000,10044,Saarlouis,365,18,347,195201,425
DE-SL,11-04-2020,RKI,4,4,0,1586563200000,10044,Saarlouis,369,18,351,195201,425
DE-SL,12-04-2020,RKI,6,6,0,1586649600000,10044,Saarlouis,375,18,357,195201,425
DE-SL,13-04-2020,RKI,1,1,0,1586736000000,10044,Saarlouis,376,18,358,195201,425
DE-SL,14-04-2020,RKI,7,5,2,1586822400000,10044,Saarlouis,383,20,363,195201,425
DE-SL,15-04-2020,RKI,9,9,0,1586908800000,10044,Saarlouis,392,20,372,195201,425
DE-SL,16-04-2020,RKI,14,13,1,1586995200000,10044,Saarlouis,406,21,385,195201,425
DE-SL,17-04-2020,RKI,6,6,0,1587081600000,10044,Saarlouis,412,21,391,195201,425
DE-SL,18-04-2020,RKI,6,6,0,1587168000000,10044,Saarlouis,418,21,397,195201,425
DE-SL,20-04-2020,RKI,0,0,0,1587340800000,10044,Saarlouis,418,21,397,195201,425
DE-SL,21-04-2020,RKI,11,11,0,1587427200000,10044,Saarlouis,429,21,408,195201,425
DE-SL,22-04-2020,RKI,9,9,0,1587513600000,10044,Saarlouis,438,21,417,195201,425
DE-SL,23-04-2020,RKI,6,6,0,1587600000000,10044,Saarlouis,444,21,423,195201,425
DE-SL,24-04-2020,RKI,4,4,0,1587686400000,10044,Saarlouis,448,21,427,195201,425
DE-SL,25-04-2020,RKI,5,5,0,1587772800000,10044,Saarlouis,453,21,432,195201,425
DE-SL,26-04-2020,RKI,0,0,0,1587859200000,10044,Saarlouis,453,21,432,195201,425
DE-SL,27-04-2020,RKI,0,0,0,1587945600000,10044,Saarlouis,453,21,432,195201,425
DE-SL,28-04-2020,RKI,0,0,0,1588032000000,10044,Saarlouis,453,21,432,195201,425
DE-SL,29-04-2020,RKI,4,4,0,1588118400000,10044,Saarlouis,457,21,436,195201,425
DE-SL,30-04-2020,RKI,1,1,0,1588204800000,10044,Saarlouis,458,21,437,195201,425
DE-SL,01-05-2020,RKI,1,1,0,1588291200000,10044,Saarlouis,459,21,438,195201,425
DE-SL,03-05-2020,RKI,0,0,0,1588464000000,10044,Saarlouis,459,21,438,195201,425
DE-SL,05-05-2020,RKI,2,1,1,1588636800000,10044,Saarlouis,461,22,439,195201,425
DE-SL,06-05-2020,RKI,1,1,0,1588723200000,10044,Saarlouis,462,22,440,195201,425
DE-SL,07-05-2020,RKI,1,1,0,1588809600000,10044,Saarlouis,463,22,441,195201,425
DE-SL,08-05-2020,RKI,0,0,0,1588896000000,10044,Saarlouis,463,22,441,195201,425
DE-SL,09-05-2020,RKI,0,0,0,1588982400000,10044,Saarlouis,463,22,441,195201,425
DE-SL,12-05-2020,RKI,2,1,1,1589241600000,10044,Saarlouis,465,23,442,195201,425
DE-SL,13-05-2020,RKI,1,1,0,1589328000000,10044,Saarlouis,466,23,443,195201,425
DE-SL,19-05-2020,RKI,0,0,0,1589846400000,10044,Saarlouis,466,23,443,195201,425
DE-SL,20-05-2020,RKI,0,0,0,1589932800000,10044,Saarlouis,466,23,443,195201,425
DE-SL,21-05-2020,RKI,1,1,0,1590019200000,10044,Saarlouis,467,23,444,195201,425
DE-SL,22-05-2020,RKI,0,0,0,1590105600000,10044,Saarlouis,467,23,444,195201,425
DE-SL,23-05-2020,RKI,2,2,0,1590192000000,10044,Saarlouis,469,23,446,195201,425
DE-SL,24-05-2020,RKI,0,0,0,1590278400000,10044,Saarlouis,469,23,446,195201,425
DE-SL,25-05-2020,RKI,1,1,0,1590364800000,10044,Saarlouis,470,23,447,195201,425
DE-SL,27-05-2020,RKI,0,0,0,1590537600000,10044,Saarlouis,470,23,447,195201,425
DE-SL,03-06-2020,RKI,1,1,0,1591142400000,10044,Saarlouis,471,23,448,195201,425
DE-SL,05-06-2020,RKI,2,2,0,1591315200000,10044,Saarlouis,473,23,450,195201,425
DE-SL,07-06-2020,RKI,0,0,0,1591488000000,10044,Saarlouis,473,23,450,195201,425
DE-SL,10-06-2020,RKI,2,2,0,1591747200000,10044,Saarlouis,475,23,452,195201,425
DE-SL,12-06-2020,RKI,0,0,0,1591920000000,10044,Saarlouis,475,23,452,195201,425
DE-SL,18-06-2020,RKI,1,1,0,1592438400000,10044,Saarlouis,476,23,453,195201,425
DE-SL,19-06-2020,RKI,0,0,0,1592524800000,10044,Saarlouis,476,23,453,195201,425
DE-SL,22-06-2020,RKI,0,0,0,1592784000000,10044,Saarlouis,476,23,453,195201,425
DE-SL,26-06-2020,RKI,0,0,0,1593129600000,10044,Saarlouis,476,23,453,195201,425
DE-SL,27-06-2020,RKI,0,0,0,1593216000000,10044,Saarlouis,476,23,453,195201,425
DE-SL,02-07-2020,RKI,0,0,0,1593648000000,10044,Saarlouis,476,23,453,195201,425
DE-SL,07-07-2020,RKI,0,0,0,1594080000000,10044,Saarlouis,476,23,453,195201,425
DE-SL,15-07-2020,RKI,0,0,0,1594771200000,10044,Saarlouis,476,23,453,195201,425
DE-SL,16-07-2020,RKI,2,0,0,1594857600000,10044,Saarlouis,478,23,453,195201,425
DE-SL,11-03-2020,RKI,0,0,0,1583884800000,10045,Saar-Pfalz-Kreis,1,0,1,142631,341
DE-SL,13-03-2020,RKI,1,1,0,1584057600000,10045,Saar-Pfalz-Kreis,2,0,2,142631,341
DE-SL,15-03-2020,RKI,6,6,0,1584230400000,10045,Saar-Pfalz-Kreis,8,0,8,142631,341
DE-SL,16-03-2020,RKI,2,1,1,1584316800000,10045,Saar-Pfalz-Kreis,10,1,9,142631,341
DE-SL,17-03-2020,RKI,1,1,0,1584403200000,10045,Saar-Pfalz-Kreis,11,1,10,142631,341
DE-SL,18-03-2020,RKI,1,1,0,1584489600000,10045,Saar-Pfalz-Kreis,12,1,11,142631,341
DE-SL,19-03-2020,RKI,7,7,0,1584576000000,10045,Saar-Pfalz-Kreis,19,1,18,142631,341
DE-SL,20-03-2020,RKI,4,4,0,1584662400000,10045,Saar-Pfalz-Kreis,23,1,22,142631,341
DE-SL,21-03-2020,RKI,13,13,0,1584748800000,10045,Saar-Pfalz-Kreis,36,1,35,142631,341
DE-SL,22-03-2020,RKI,14,13,1,1584835200000,10045,Saar-Pfalz-Kreis,50,2,48,142631,341
DE-SL,23-03-2020,RKI,6,6,0,1584921600000,10045,Saar-Pfalz-Kreis,56,2,54,142631,341
DE-SL,24-03-2020,RKI,11,11,0,1585008000000,10045,Saar-Pfalz-Kreis,67,2,65,142631,341
DE-SL,25-03-2020,RKI,4,4,0,1585094400000,10045,Saar-Pfalz-Kreis,71,2,69,142631,341
DE-SL,26-03-2020,RKI,11,11,0,1585180800000,10045,Saar-Pfalz-Kreis,82,2,80,142631,341
DE-SL,27-03-2020,RKI,9,8,1,1585267200000,10045,Saar-Pfalz-Kreis,91,3,88,142631,341
DE-SL,28-03-2020,RKI,0,0,0,1585353600000,10045,Saar-Pfalz-Kreis,91,3,88,142631,341
DE-SL,29-03-2020,RKI,10,9,1,1585440000000,10045,Saar-Pfalz-Kreis,101,4,97,142631,341
DE-SL,30-03-2020,RKI,11,11,0,1585526400000,10045,Saar-Pfalz-Kreis,112,4,108,142631,341
DE-SL,31-03-2020,RKI,11,11,0,1585612800000,10045,Saar-Pfalz-Kreis,123,4,119,142631,341
DE-SL,01-04-2020,RKI,17,17,0,1585699200000,10045,Saar-Pfalz-Kreis,140,4,136,142631,341
DE-SL,02-04-2020,RKI,9,9,0,1585785600000,10045,Saar-Pfalz-Kreis,149,4,145,142631,341
DE-SL,03-04-2020,RKI,9,9,0,1585872000000,10045,Saar-Pfalz-Kreis,158,4,154,142631,341
DE-SL,04-04-2020,RKI,12,11,1,1585958400000,10045,Saar-Pfalz-Kreis,170,5,165,142631,341
DE-SL,05-04-2020,RKI,2,2,0,1586044800000,10045,Saar-Pfalz-Kreis,172,5,167,142631,341
DE-SL,06-04-2020,RKI,9,9,0,1586131200000,10045,Saar-Pfalz-Kreis,181,5,176,142631,341
DE-SL,07-04-2020,RKI,6,6,0,1586217600000,10045,Saar-Pfalz-Kreis,187,5,182,142631,341
DE-SL,08-04-2020,RKI,8,8,0,1586304000000,10045,Saar-Pfalz-Kreis,195,5,190,142631,341
DE-SL,09-04-2020,RKI,13,12,1,1586390400000,10045,Saar-Pfalz-Kreis,208,6,202,142631,341
DE-SL,10-04-2020,RKI,8,8,0,1586476800000,10045,Saar-Pfalz-Kreis,216,6,210,142631,341
DE-SL,11-04-2020,RKI,3,3,0,1586563200000,10045,Saar-Pfalz-Kreis,219,6,213,142631,341
DE-SL,12-04-2020,RKI,1,1,0,1586649600000,10045,Saar-Pfalz-Kreis,220,6,214,142631,341
DE-SL,13-04-2020,RKI,6,6,0,1586736000000,10045,Saar-Pfalz-Kreis,226,6,220,142631,341
DE-SL,14-04-2020,RKI,1,1,0,1586822400000,10045,Saar-Pfalz-Kreis,227,6,221,142631,341
DE-SL,15-04-2020,RKI,4,3,1,1586908800000,10045,Saar-Pfalz-Kreis,231,7,224,142631,341
DE-SL,16-04-2020,RKI,1,0,1,1586995200000,10045,Saar-Pfalz-Kreis,232,8,224,142631,341
DE-SL,17-04-2020,RKI,4,3,1,1587081600000,10045,Saar-Pfalz-Kreis,236,9,227,142631,341
DE-SL,20-04-2020,RKI,1,1,0,1587340800000,10045,Saar-Pfalz-Kreis,237,9,228,142631,341
DE-SL,21-04-2020,RKI,1,1,0,1587427200000,10045,Saar-Pfalz-Kreis,238,9,229,142631,341
DE-SL,22-04-2020,RKI,6,4,2,1587513600000,10045,Saar-Pfalz-Kreis,244,11,233,142631,341
DE-SL,24-04-2020,RKI,2,1,1,1587686400000,10045,Saar-Pfalz-Kreis,246,12,234,142631,341
DE-SL,26-04-2020,RKI,0,0,0,1587859200000,10045,Saar-Pfalz-Kreis,246,12,234,142631,341
DE-SL,28-04-2020,RKI,0,0,0,1588032000000,10045,Saar-Pfalz-Kreis,246,12,234,142631,341
DE-SL,29-04-2020,RKI,1,1,0,1588118400000,10045,Saar-Pfalz-Kreis,247,12,235,142631,341
DE-SL,30-04-2020,RKI,5,5,0,1588204800000,10045,Saar-Pfalz-Kreis,252,12,240,142631,341
DE-SL,02-05-2020,RKI,3,2,1,1588377600000,10045,Saar-Pfalz-Kreis,255,13,242,142631,341
DE-SL,03-05-2020,RKI,0,0,0,1588464000000,10045,Saar-Pfalz-Kreis,255,13,242,142631,341
DE-SL,04-05-2020,RKI,0,0,0,1588550400000,10045,Saar-Pfalz-Kreis,255,13,242,142631,341
DE-SL,05-05-2020,RKI,0,0,0,1588636800000,10045,Saar-Pfalz-Kreis,255,13,242,142631,341
DE-SL,06-05-2020,RKI,1,1,0,1588723200000,10045,Saar-Pfalz-Kreis,256,13,243,142631,341
DE-SL,08-05-2020,RKI,1,0,1,1588896000000,10045,Saar-Pfalz-Kreis,257,14,243,142631,341
DE-SL,11-05-2020,RKI,0,0,0,1589155200000,10045,Saar-Pfalz-Kreis,257,14,243,142631,341
DE-SL,14-05-2020,RKI,0,0,0,1589414400000,10045,Saar-Pfalz-Kreis,257,14,243,142631,341
DE-SL,19-05-2020,RKI,0,0,0,1589846400000,10045,Saar-Pfalz-Kreis,257,14,243,142631,341
DE-SL,26-05-2020,RKI,1,1,0,1590451200000,10045,Saar-Pfalz-Kreis,258,14,244,142631,341
DE-SL,29-05-2020,RKI,1,1,0,1590710400000,10045,Saar-Pfalz-Kreis,259,14,245,142631,341
DE-SL,30-05-2020,RKI,0,0,0,1590796800000,10045,Saar-Pfalz-Kreis,259,14,245,142631,341
DE-SL,31-05-2020,RKI,0,0,0,1590883200000,10045,Saar-Pfalz-Kreis,259,14,245,142631,341
DE-SL,01-06-2020,RKI,0,0,0,1590969600000,10045,Saar-Pfalz-Kreis,259,14,245,142631,341
DE-SL,09-06-2020,RKI,1,1,0,1591660800000,10045,Saar-Pfalz-Kreis,260,14,246,142631,341
DE-SL,08-07-2020,RKI,0,0,0,1594166400000,10045,Saar-Pfalz-Kreis,260,14,246,142631,341
DE-SL,09-07-2020,RKI,0,0,0,1594252800000,10045,Saar-Pfalz-Kreis,260,14,246,142631,341
DE-SL,10-07-2020,RKI,3,0,0,1594339200000,10045,Saar-Pfalz-Kreis,263,14,246,142631,341
DE-SL,11-07-2020,RKI,0,0,0,1594425600000,10045,Saar-Pfalz-Kreis,263,14,246,142631,341
DE-SL,12-07-2020,RKI,0,0,0,1594512000000,10045,Saar-Pfalz-Kreis,263,14,246,142631,341
DE-SL,14-07-2020,RKI,0,0,0,1594684800000,10045,Saar-Pfalz-Kreis,263,14,246,142631,341
DE-SL,13-03-2020,RKI,1,1,0,1584057600000,10046,Sankt Wendel,8,0,8,87397,184
DE-SL,14-03-2020,RKI,3,3,0,1584144000000,10046,Sankt Wendel,11,0,11,87397,184
DE-SL,15-03-2020,RKI,0,0,0,1584230400000,10046,Sankt Wendel,11,0,11,87397,184
DE-SL,16-03-2020,RKI,1,0,1,1584316800000,10046,Sankt Wendel,12,1,11,87397,184
DE-SL,17-03-2020,RKI,1,1,0,1584403200000,10046,Sankt Wendel,13,1,12,87397,184
DE-SL,18-03-2020,RKI,2,2,0,1584489600000,10046,Sankt Wendel,15,1,14,87397,184
DE-SL,19-03-2020,RKI,6,6,0,1584576000000,10046,Sankt Wendel,21,1,20,87397,184
DE-SL,20-03-2020,RKI,6,6,0,1584662400000,10046,Sankt Wendel,27,1,26,87397,184
DE-SL,21-03-2020,RKI,2,2,0,1584748800000,10046,Sankt Wendel,29,1,28,87397,184
DE-SL,22-03-2020,RKI,6,6,0,1584835200000,10046,Sankt Wendel,35,1,34,87397,184
DE-SL,23-03-2020,RKI,2,2,0,1584921600000,10046,Sankt Wendel,37,1,36,87397,184
DE-SL,24-03-2020,RKI,4,4,0,1585008000000,10046,Sankt Wendel,41,1,40,87397,184
DE-SL,25-03-2020,RKI,7,7,0,1585094400000,10046,Sankt Wendel,48,1,47,87397,184
DE-SL,26-03-2020,RKI,6,6,0,1585180800000,10046,Sankt Wendel,54,1,53,87397,184
DE-SL,27-03-2020,RKI,3,3,0,1585267200000,10046,Sankt Wendel,57,1,56,87397,184
DE-SL,28-03-2020,RKI,7,6,1,1585353600000,10046,Sankt Wendel,64,2,62,87397,184
DE-SL,30-03-2020,RKI,3,3,0,1585526400000,10046,Sankt Wendel,67,2,65,87397,184
DE-SL,31-03-2020,RKI,2,2,0,1585612800000,10046,Sankt Wendel,69,2,67,87397,184
DE-SL,01-04-2020,RKI,8,8,0,1585699200000,10046,Sankt Wendel,77,2,75,87397,184
DE-SL,02-04-2020,RKI,4,4,0,1585785600000,10046,Sankt Wendel,81,2,79,87397,184
DE-SL,03-04-2020,RKI,5,5,0,1585872000000,10046,Sankt Wendel,86,2,84,87397,184
DE-SL,04-04-2020,RKI,6,6,0,1585958400000,10046,Sankt Wendel,92,2,90,87397,184
DE-SL,06-04-2020,RKI,3,2,1,1586131200000,10046,Sankt Wendel,95,3,92,87397,184
DE-SL,07-04-2020,RKI,3,3,0,1586217600000,10046,Sankt Wendel,98,3,95,87397,184
DE-SL,08-04-2020,RKI,10,10,0,1586304000000,10046,Sankt Wendel,108,3,105,87397,184
DE-SL,09-04-2020,RKI,5,5,0,1586390400000,10046,Sankt Wendel,113,3,110,87397,184
DE-SL,11-04-2020,RKI,1,1,0,1586563200000,10046,Sankt Wendel,114,3,111,87397,184
DE-SL,12-04-2020,RKI,0,0,0,1586649600000,10046,Sankt Wendel,114,3,111,87397,184
DE-SL,14-04-2020,RKI,0,0,0,1586822400000,10046,Sankt Wendel,114,3,111,87397,184
DE-SL,15-04-2020,RKI,2,2,0,1586908800000,10046,Sankt Wendel,116,3,113,87397,184
DE-SL,21-04-2020,RKI,1,1,0,1587427200000,10046,Sankt Wendel,117,3,114,87397,184
DE-SL,23-04-2020,RKI,0,0,0,1587600000000,10046,Sankt Wendel,117,3,114,87397,184
DE-SL,27-04-2020,RKI,1,1,0,1587945600000,10046,Sankt Wendel,118,3,115,87397,184
DE-SL,30-04-2020,RKI,0,0,0,1588204800000,10046,Sankt Wendel,118,3,115,87397,184
DE-SL,01-05-2020,RKI,0,0,0,1588291200000,10046,Sankt Wendel,118,3,115,87397,184
DE-SL,04-05-2020,RKI,2,1,1,1588550400000,10046,Sankt Wendel,120,4,116,87397,184
DE-SL,05-05-2020,RKI,0,0,0,1588636800000,10046,Sankt Wendel,120,4,116,87397,184
DE-SL,06-05-2020,RKI,0,0,0,1588723200000,10046,Sankt Wendel,120,4,116,87397,184
DE-SL,07-05-2020,RKI,0,0,0,1588809600000,10046,Sankt Wendel,120,4,116,87397,184
DE-SL,11-05-2020,RKI,0,0,0,1589155200000,10046,Sankt Wendel,120,4,116,87397,184
DE-SL,13-05-2020,RKI,0,0,0,1589328000000,10046,Sankt Wendel,120,4,116,87397,184
DE-SL,18-05-2020,RKI,0,0,0,1589760000000,10046,Sankt Wendel,120,4,116,87397,184
DE-SL,29-05-2020,RKI,0,0,0,1590710400000,10046,Sankt Wendel,120,4,116,87397,184
DE-SL,02-06-2020,RKI,0,0,0,1591056000000,10046,Sankt Wendel,120,4,116,87397,184
DE-SL,08-06-2020,RKI,1,1,0,1591574400000,10046,Sankt Wendel,121,4,117,87397,184
DE-SL,17-06-2020,RKI,0,0,0,1592352000000,10046,Sankt Wendel,121,4,117,87397,184
DE-SL,01-07-2020,RKI,0,0,0,1593561600000,10046,Sankt Wendel,121,4,117,87397,184
DE-SN,13-03-2020,RKI,2,2,0,1584057600000,14511,Chemnitz,4,0,4,247237,1118
DE-SN,15-03-2020,RKI,3,3,0,1584230400000,14511,Chemnitz,7,0,7,247237,1118
DE-SN,16-03-2020,RKI,3,3,0,1584316800000,14511,Chemnitz,10,0,10,247237,1118
DE-SN,17-03-2020,RKI,2,2,0,1584403200000,14511,Chemnitz,12,0,12,247237,1118
DE-SN,18-03-2020,RKI,5,5,0,1584489600000,14511,Chemnitz,17,0,17,247237,1118
DE-SN,19-03-2020,RKI,8,8,0,1584576000000,14511,Chemnitz,25,0,25,247237,1118
DE-SN,20-03-2020,RKI,12,12,0,1584662400000,14511,Chemnitz,37,0,37,247237,1118
DE-SN,21-03-2020,RKI,5,5,0,1584748800000,14511,Chemnitz,42,0,42,247237,1118
DE-SN,22-03-2020,RKI,2,1,1,1584835200000,14511,Chemnitz,44,1,43,247237,1118
DE-SN,23-03-2020,RKI,3,3,0,1584921600000,14511,Chemnitz,47,1,46,247237,1118
DE-SN,24-03-2020,RKI,1,1,0,1585008000000,14511,Chemnitz,48,1,47,247237,1118
DE-SN,25-03-2020,RKI,1,1,0,1585094400000,14511,Chemnitz,49,1,48,247237,1118
DE-SN,26-03-2020,RKI,8,8,0,1585180800000,14511,Chemnitz,57,1,56,247237,1118
DE-SN,27-03-2020,RKI,14,13,1,1585267200000,14511,Chemnitz,71,2,69,247237,1118
DE-SN,28-03-2020,RKI,1,1,0,1585353600000,14511,Chemnitz,72,2,70,247237,1118
DE-SN,29-03-2020,RKI,11,11,0,1585440000000,14511,Chemnitz,83,2,81,247237,1118
DE-SN,30-03-2020,RKI,4,4,0,1585526400000,14511,Chemnitz,87,2,85,247237,1118
DE-SN,31-03-2020,RKI,8,7,1,1585612800000,14511,Chemnitz,95,3,92,247237,1118
DE-SN,01-04-2020,RKI,11,10,1,1585699200000,14511,Chemnitz,106,4,102,247237,1118
DE-SN,02-04-2020,RKI,6,6,0,1585785600000,14511,Chemnitz,112,4,108,247237,1118
DE-SN,03-04-2020,RKI,8,7,1,1585872000000,14511,Chemnitz,120,5,115,247237,1118
DE-SN,04-04-2020,RKI,2,2,0,1585958400000,14511,Chemnitz,122,5,117,247237,1118
DE-SN,05-04-2020,RKI,0,0,0,1586044800000,14511,Chemnitz,122,5,117,247237,1118
DE-SN,06-04-2020,RKI,1,1,0,1586131200000,14511,Chemnitz,123,5,118,247237,1118
DE-SN,07-04-2020,RKI,4,4,0,1586217600000,14511,Chemnitz,127,5,122,247237,1118
DE-SN,08-04-2020,RKI,6,6,0,1586304000000,14511,Chemnitz,133,5,128,247237,1118
DE-SN,09-04-2020,RKI,5,5,0,1586390400000,14511,Chemnitz,138,5,133,247237,1118
DE-SN,10-04-2020,RKI,0,0,0,1586476800000,14511,Chemnitz,138,5,133,247237,1118
DE-SN,11-04-2020,RKI,2,2,0,1586563200000,14511,Chemnitz,140,5,135,247237,1118
DE-SN,12-04-2020,RKI,4,4,0,1586649600000,14511,Chemnitz,144,5,139,247237,1118
DE-SN,13-04-2020,RKI,4,4,0,1586736000000,14511,Chemnitz,148,5,143,247237,1118
DE-SN,15-04-2020,RKI,3,3,0,1586908800000,14511,Chemnitz,151,5,146,247237,1118
DE-SN,16-04-2020,RKI,2,2,0,1586995200000,14511,Chemnitz,153,5,148,247237,1118
DE-SN,18-04-2020,RKI,1,1,0,1587168000000,14511,Chemnitz,154,5,149,247237,1118
DE-SN,19-04-2020,RKI,0,0,0,1587254400000,14511,Chemnitz,154,5,149,247237,1118
DE-SN,20-04-2020,RKI,0,0,0,1587340800000,14511,Chemnitz,154,5,149,247237,1118
DE-SN,21-04-2020,RKI,0,0,0,1587427200000,14511,Chemnitz,154,5,149,247237,1118
DE-SN,24-04-2020,RKI,0,0,0,1587686400000,14511,Chemnitz,154,5,149,247237,1118
DE-SN,25-04-2020,RKI,0,0,0,1587772800000,14511,Chemnitz,154,5,149,247237,1118
DE-SN,30-04-2020,RKI,1,1,0,1588204800000,14511,Chemnitz,155,5,150,247237,1118
DE-SN,07-05-2020,RKI,0,0,0,1588809600000,14511,Chemnitz,155,5,150,247237,1118
DE-SN,11-05-2020,RKI,0,0,0,1589155200000,14511,Chemnitz,155,5,150,247237,1118
DE-SN,14-05-2020,RKI,0,0,0,1589414400000,14511,Chemnitz,155,5,150,247237,1118
DE-SN,17-05-2020,RKI,0,0,0,1589673600000,14511,Chemnitz,155,5,150,247237,1118
DE-SN,22-05-2020,RKI,0,0,0,1590105600000,14511,Chemnitz,155,5,150,247237,1118
DE-SN,26-05-2020,RKI,0,0,0,1590451200000,14511,Chemnitz,155,5,150,247237,1118
DE-SN,05-06-2020,RKI,1,1,0,1591315200000,14511,Chemnitz,156,5,151,247237,1118
DE-SN,08-06-2020,RKI,0,0,0,1591574400000,14511,Chemnitz,156,5,151,247237,1118
DE-SN,16-06-2020,RKI,2,2,0,1592265600000,14511,Chemnitz,158,5,153,247237,1118
DE-SN,23-06-2020,RKI,0,0,0,1592870400000,14511,Chemnitz,158,5,153,247237,1118
DE-SN,15-07-2020,RKI,0,0,0,1594771200000,14511,Chemnitz,158,5,153,247237,1118
DE-SN,15-03-2020,RKI,4,4,0,1584230400000,14521,Erzgebirgskreis,5,0,5,337696,185
DE-SN,16-03-2020,RKI,1,1,0,1584316800000,14521,Erzgebirgskreis,6,0,6,337696,185
DE-SN,17-03-2020,RKI,3,3,0,1584403200000,14521,Erzgebirgskreis,9,0,9,337696,185
DE-SN,18-03-2020,RKI,8,8,0,1584489600000,14521,Erzgebirgskreis,17,0,17,337696,185
DE-SN,19-03-2020,RKI,9,9,0,1584576000000,14521,Erzgebirgskreis,26,0,26,337696,185
DE-SN,20-03-2020,RKI,4,4,0,1584662400000,14521,Erzgebirgskreis,30,0,30,337696,185
DE-SN,21-03-2020,RKI,11,10,1,1584748800000,14521,Erzgebirgskreis,41,1,40,337696,185
DE-SN,22-03-2020,RKI,3,3,0,1584835200000,14521,Erzgebirgskreis,44,1,43,337696,185
DE-SN,23-03-2020,RKI,4,4,0,1584921600000,14521,Erzgebirgskreis,48,1,47,337696,185
DE-SN,24-03-2020,RKI,2,0,2,1585008000000,14521,Erzgebirgskreis,50,3,47,337696,185
DE-SN,25-03-2020,RKI,8,7,1,1585094400000,14521,Erzgebirgskreis,58,4,54,337696,185
DE-SN,26-03-2020,RKI,11,10,1,1585180800000,14521,Erzgebirgskreis,69,5,64,337696,185
DE-SN,27-03-2020,RKI,14,13,1,1585267200000,14521,Erzgebirgskreis,83,6,77,337696,185
DE-SN,28-03-2020,RKI,4,3,1,1585353600000,14521,Erzgebirgskreis,87,7,80,337696,185
DE-SN,29-03-2020,RKI,4,4,0,1585440000000,14521,Erzgebirgskreis,91,7,84,337696,185
DE-SN,30-03-2020,RKI,13,9,4,1585526400000,14521,Erzgebirgskreis,104,11,93,337696,185
DE-SN,31-03-2020,RKI,38,34,4,1585612800000,14521,Erzgebirgskreis,142,15,127,337696,185
DE-SN,01-04-2020,RKI,23,23,0,1585699200000,14521,Erzgebirgskreis,165,15,150,337696,185
DE-SN,02-04-2020,RKI,82,73,9,1585785600000,14521,Erzgebirgskreis,247,24,223,337696,185
DE-SN,03-04-2020,RKI,10,9,1,1585872000000,14521,Erzgebirgskreis,257,25,232,337696,185
DE-SN,04-04-2020,RKI,12,11,1,1585958400000,14521,Erzgebirgskreis,269,26,243,337696,185
DE-SN,05-04-2020,RKI,11,9,2,1586044800000,14521,Erzgebirgskreis,280,28,252,337696,185
DE-SN,06-04-2020,RKI,19,16,3,1586131200000,14521,Erzgebirgskreis,299,31,268,337696,185
DE-SN,07-04-2020,RKI,5,5,0,1586217600000,14521,Erzgebirgskreis,304,31,273,337696,185
DE-SN,08-04-2020,RKI,26,25,1,1586304000000,14521,Erzgebirgskreis,330,32,298,337696,185
DE-SN,09-04-2020,RKI,8,7,1,1586390400000,14521,Erzgebirgskreis,338,33,305,337696,185
DE-SN,10-04-2020,RKI,35,31,4,1586476800000,14521,Erzgebirgskreis,373,37,336,337696,185
DE-SN,11-04-2020,RKI,9,7,2,1586563200000,14521,Erzgebirgskreis,382,39,343,337696,185
DE-SN,12-04-2020,RKI,8,8,0,1586649600000,14521,Erzgebirgskreis,390,39,351,337696,185
DE-SN,13-04-2020,RKI,5,4,1,1586736000000,14521,Erzgebirgskreis,395,40,355,337696,185
DE-SN,14-04-2020,RKI,5,4,1,1586822400000,14521,Erzgebirgskreis,400,41,359,337696,185
DE-SN,15-04-2020,RKI,5,5,0,1586908800000,14521,Erzgebirgskreis,405,41,364,337696,185
DE-SN,16-04-2020,RKI,11,9,2,1586995200000,14521,Erzgebirgskreis,416,43,373,337696,185
DE-SN,17-04-2020,RKI,0,0,0,1587081600000,14521,Erzgebirgskreis,416,43,373,337696,185
DE-SN,18-04-2020,RKI,14,14,0,1587168000000,14521,Erzgebirgskreis,430,43,387,337696,185
DE-SN,19-04-2020,RKI,2,2,0,1587254400000,14521,Erzgebirgskreis,432,43,389,337696,185
DE-SN,20-04-2020,RKI,1,1,0,1587340800000,14521,Erzgebirgskreis,433,43,390,337696,185
DE-SN,21-04-2020,RKI,3,3,0,1587427200000,14521,Erzgebirgskreis,436,43,393,337696,185
DE-SN,22-04-2020,RKI,7,7,0,1587513600000,14521,Erzgebirgskreis,443,43,400,337696,185
DE-SN,23-04-2020,RKI,6,6,0,1587600000000,14521,Erzgebirgskreis,449,43,406,337696,185
DE-SN,24-04-2020,RKI,8,8,0,1587686400000,14521,Erzgebirgskreis,457,43,414,337696,185
DE-SN,25-04-2020,RKI,1,1,0,1587772800000,14521,Erzgebirgskreis,458,43,415,337696,185
DE-SN,26-04-2020,RKI,8,8,0,1587859200000,14521,Erzgebirgskreis,466,43,423,337696,185
DE-SN,27-04-2020,RKI,0,0,0,1587945600000,14521,Erzgebirgskreis,466,43,423,337696,185
DE-SN,29-04-2020,RKI,3,3,0,1588118400000,14521,Erzgebirgskreis,469,43,426,337696,185
DE-SN,30-04-2020,RKI,2,2,0,1588204800000,14521,Erzgebirgskreis,471,43,428,337696,185
DE-SN,01-05-2020,RKI,0,0,0,1588291200000,14521,Erzgebirgskreis,471,43,428,337696,185
DE-SN,02-05-2020,RKI,4,4,0,1588377600000,14521,Erzgebirgskreis,475,43,432,337696,185
DE-SN,03-05-2020,RKI,0,0,0,1588464000000,14521,Erzgebirgskreis,475,43,432,337696,185
DE-SN,05-05-2020,RKI,5,5,0,1588636800000,14521,Erzgebirgskreis,480,43,437,337696,185
DE-SN,06-05-2020,RKI,4,4,0,1588723200000,14521,Erzgebirgskreis,484,43,441,337696,185
DE-SN,07-05-2020,RKI,0,0,0,1588809600000,14521,Erzgebirgskreis,484,43,441,337696,185
DE-SN,08-05-2020,RKI,1,1,0,1588896000000,14521,Erzgebirgskreis,485,43,442,337696,185
DE-SN,09-05-2020,RKI,0,0,0,1588982400000,14521,Erzgebirgskreis,485,43,442,337696,185
DE-SN,11-05-2020,RKI,0,0,0,1589155200000,14521,Erzgebirgskreis,485,43,442,337696,185
DE-SN,12-05-2020,RKI,1,1,0,1589241600000,14521,Erzgebirgskreis,486,43,443,337696,185
DE-SN,13-05-2020,RKI,0,0,0,1589328000000,14521,Erzgebirgskreis,486,43,443,337696,185
DE-SN,14-05-2020,RKI,0,0,0,1589414400000,14521,Erzgebirgskreis,486,43,443,337696,185
DE-SN,15-05-2020,RKI,1,1,0,1589500800000,14521,Erzgebirgskreis,487,43,444,337696,185
DE-SN,22-05-2020,RKI,0,0,0,1590105600000,14521,Erzgebirgskreis,487,43,444,337696,185
DE-SN,24-05-2020,RKI,1,1,0,1590278400000,14521,Erzgebirgskreis,488,43,445,337696,185
DE-SN,26-05-2020,RKI,0,0,0,1590451200000,14521,Erzgebirgskreis,488,43,445,337696,185
DE-SN,04-06-2020,RKI,0,0,0,1591228800000,14521,Erzgebirgskreis,488,43,445,337696,185
DE-SN,08-06-2020,RKI,0,0,0,1591574400000,14521,Erzgebirgskreis,488,43,445,337696,185
DE-SN,17-06-2020,RKI,2,2,0,1592352000000,14521,Erzgebirgskreis,490,43,447,337696,185
DE-SN,08-07-2020,RKI,1,1,0,1594166400000,14521,Erzgebirgskreis,491,43,448,337696,185
DE-SN,11-07-2020,RKI,0,0,0,1594425600000,14521,Erzgebirgskreis,491,43,448,337696,185
DE-SN,14-03-2020,RKI,0,0,0,1584144000000,14522,Mittelsachsen,3,0,3,306185,145
DE-SN,16-03-2020,RKI,3,3,0,1584316800000,14522,Mittelsachsen,6,0,6,306185,145
DE-SN,17-03-2020,RKI,2,2,0,1584403200000,14522,Mittelsachsen,8,0,8,306185,145
DE-SN,18-03-2020,RKI,4,4,0,1584489600000,14522,Mittelsachsen,12,0,12,306185,145
DE-SN,19-03-2020,RKI,7,7,0,1584576000000,14522,Mittelsachsen,19,0,19,306185,145
DE-SN,20-03-2020,RKI,7,7,0,1584662400000,14522,Mittelsachsen,26,0,26,306185,145
DE-SN,21-03-2020,RKI,3,3,0,1584748800000,14522,Mittelsachsen,29,0,29,306185,145
DE-SN,22-03-2020,RKI,0,0,0,1584835200000,14522,Mittelsachsen,29,0,29,306185,145
DE-SN,23-03-2020,RKI,2,2,0,1584921600000,14522,Mittelsachsen,31,0,31,306185,145
DE-SN,24-03-2020,RKI,10,10,0,1585008000000,14522,Mittelsachsen,41,0,41,306185,145
DE-SN,25-03-2020,RKI,6,6,0,1585094400000,14522,Mittelsachsen,47,0,47,306185,145
DE-SN,26-03-2020,RKI,11,11,0,1585180800000,14522,Mittelsachsen,58,0,58,306185,145
DE-SN,27-03-2020,RKI,10,9,1,1585267200000,14522,Mittelsachsen,68,1,67,306185,145
DE-SN,28-03-2020,RKI,14,14,0,1585353600000,14522,Mittelsachsen,82,1,81,306185,145
DE-SN,29-03-2020,RKI,4,4,0,1585440000000,14522,Mittelsachsen,86,1,85,306185,145
DE-SN,30-03-2020,RKI,5,4,1,1585526400000,14522,Mittelsachsen,91,2,89,306185,145
DE-SN,31-03-2020,RKI,11,10,1,1585612800000,14522,Mittelsachsen,102,3,99,306185,145
DE-SN,01-04-2020,RKI,12,11,1,1585699200000,14522,Mittelsachsen,114,4,110,306185,145
DE-SN,02-04-2020,RKI,13,11,2,1585785600000,14522,Mittelsachsen,127,6,121,306185,145
DE-SN,03-04-2020,RKI,14,12,2,1585872000000,14522,Mittelsachsen,141,8,133,306185,145
DE-SN,04-04-2020,RKI,5,5,0,1585958400000,14522,Mittelsachsen,146,8,138,306185,145
DE-SN,05-04-2020,RKI,3,3,0,1586044800000,14522,Mittelsachsen,149,8,141,306185,145
DE-SN,06-04-2020,RKI,7,7,0,1586131200000,14522,Mittelsachsen,156,8,148,306185,145
DE-SN,07-04-2020,RKI,5,5,0,1586217600000,14522,Mittelsachsen,161,8,153,306185,145
DE-SN,08-04-2020,RKI,17,16,1,1586304000000,14522,Mittelsachsen,178,9,169,306185,145
DE-SN,09-04-2020,RKI,5,5,0,1586390400000,14522,Mittelsachsen,183,9,174,306185,145
DE-SN,10-04-2020,RKI,6,6,0,1586476800000,14522,Mittelsachsen,189,9,180,306185,145
DE-SN,11-04-2020,RKI,8,8,0,1586563200000,14522,Mittelsachsen,197,9,188,306185,145
DE-SN,12-04-2020,RKI,0,0,0,1586649600000,14522,Mittelsachsen,197,9,188,306185,145
DE-SN,14-04-2020,RKI,7,7,0,1586822400000,14522,Mittelsachsen,204,9,195,306185,145
DE-SN,15-04-2020,RKI,0,0,0,1586908800000,14522,Mittelsachsen,204,9,195,306185,145
DE-SN,16-04-2020,RKI,6,6,0,1586995200000,14522,Mittelsachsen,210,9,201,306185,145
DE-SN,18-04-2020,RKI,2,2,0,1587168000000,14522,Mittelsachsen,212,9,203,306185,145
DE-SN,25-04-2020,RKI,1,1,0,1587772800000,14522,Mittelsachsen,213,9,204,306185,145
DE-SN,27-04-2020,RKI,1,1,0,1587945600000,14522,Mittelsachsen,214,9,205,306185,145
DE-SN,29-04-2020,RKI,0,0,0,1588118400000,14522,Mittelsachsen,214,9,205,306185,145
DE-SN,30-04-2020,RKI,0,0,0,1588204800000,14522,Mittelsachsen,214,9,205,306185,145
DE-SN,10-05-2020,RKI,0,0,0,1589068800000,14522,Mittelsachsen,214,9,205,306185,145
DE-SN,14-05-2020,RKI,1,1,0,1589414400000,14522,Mittelsachsen,215,9,206,306185,145
DE-SN,20-05-2020,RKI,0,0,0,1589932800000,14522,Mittelsachsen,215,9,206,306185,145
DE-SN,27-05-2020,RKI,1,1,0,1590537600000,14522,Mittelsachsen,216,9,207,306185,145
DE-SN,03-06-2020,RKI,0,0,0,1591142400000,14522,Mittelsachsen,216,9,207,306185,145
DE-SN,05-06-2020,RKI,0,0,0,1591315200000,14522,Mittelsachsen,216,9,207,306185,145
DE-SN,14-06-2020,RKI,0,0,0,1592092800000,14522,Mittelsachsen,216,9,207,306185,145
DE-SN,16-06-2020,RKI,0,0,0,1592265600000,14522,Mittelsachsen,216,9,207,306185,145
DE-SN,17-06-2020,RKI,15,15,0,1592352000000,14522,Mittelsachsen,231,9,222,306185,145
DE-SN,18-06-2020,RKI,3,3,0,1592438400000,14522,Mittelsachsen,234,9,225,306185,145
DE-SN,19-06-2020,RKI,0,0,0,1592524800000,14522,Mittelsachsen,234,9,225,306185,145
DE-SN,20-06-2020,RKI,5,3,0,1592611200000,14522,Mittelsachsen,239,9,228,306185,145
DE-SN,21-06-2020,RKI,2,0,0,1592697600000,14522,Mittelsachsen,241,9,228,306185,145
DE-SN,25-06-2020,RKI,3,0,0,1593043200000,14522,Mittelsachsen,244,9,228,306185,145
DE-SN,30-06-2020,RKI,0,0,0,1593475200000,14522,Mittelsachsen,244,9,228,306185,145
DE-SN,02-07-2020,RKI,1,1,0,1593648000000,14522,Mittelsachsen,245,9,229,306185,145
DE-SN,17-03-2020,RKI,0,0,0,1584403200000,14523,Vogtlandkreis,1,0,1,227796,161
DE-SN,18-03-2020,RKI,4,4,0,1584489600000,14523,Vogtlandkreis,5,0,5,227796,161
DE-SN,19-03-2020,RKI,6,6,0,1584576000000,14523,Vogtlandkreis,11,0,11,227796,161
DE-SN,20-03-2020,RKI,8,8,0,1584662400000,14523,Vogtlandkreis,19,0,19,227796,161
DE-SN,21-03-2020,RKI,7,7,0,1584748800000,14523,Vogtlandkreis,26,0,26,227796,161
DE-SN,23-03-2020,RKI,11,11,0,1584921600000,14523,Vogtlandkreis,37,0,37,227796,161
DE-SN,24-03-2020,RKI,17,17,0,1585008000000,14523,Vogtlandkreis,54,0,54,227796,161
DE-SN,25-03-2020,RKI,19,18,1,1585094400000,14523,Vogtlandkreis,73,1,72,227796,161
DE-SN,26-03-2020,RKI,4,3,1,1585180800000,14523,Vogtlandkreis,77,2,75,227796,161
DE-SN,27-03-2020,RKI,5,5,0,1585267200000,14523,Vogtlandkreis,82,2,80,227796,161
DE-SN,28-03-2020,RKI,12,12,0,1585353600000,14523,Vogtlandkreis,94,2,92,227796,161
DE-SN,29-03-2020,RKI,0,0,0,1585440000000,14523,Vogtlandkreis,94,2,92,227796,161
DE-SN,30-03-2020,RKI,6,6,0,1585526400000,14523,Vogtlandkreis,100,2,98,227796,161
DE-SN,31-03-2020,RKI,4,4,0,1585612800000,14523,Vogtlandkreis,104,2,102,227796,161
DE-SN,01-04-2020,RKI,8,8,0,1585699200000,14523,Vogtlandkreis,112,2,110,227796,161
DE-SN,02-04-2020,RKI,5,5,0,1585785600000,14523,Vogtlandkreis,117,2,115,227796,161
DE-SN,03-04-2020,RKI,15,15,0,1585872000000,14523,Vogtlandkreis,132,2,130,227796,161
DE-SN,04-04-2020,RKI,9,8,1,1585958400000,14523,Vogtlandkreis,141,3,138,227796,161
DE-SN,05-04-2020,RKI,6,6,0,1586044800000,14523,Vogtlandkreis,147,3,144,227796,161
DE-SN,06-04-2020,RKI,10,10,0,1586131200000,14523,Vogtlandkreis,157,3,154,227796,161
DE-SN,07-04-2020,RKI,9,8,1,1586217600000,14523,Vogtlandkreis,166,4,162,227796,161
DE-SN,08-04-2020,RKI,5,5,0,1586304000000,14523,Vogtlandkreis,171,4,167,227796,161
DE-SN,09-04-2020,RKI,8,8,0,1586390400000,14523,Vogtlandkreis,179,4,175,227796,161
DE-SN,10-04-2020,RKI,9,9,0,1586476800000,14523,Vogtlandkreis,188,4,184,227796,161
DE-SN,11-04-2020,RKI,2,1,1,1586563200000,14523,Vogtlandkreis,190,5,185,227796,161
DE-SN,12-04-2020,RKI,38,36,2,1586649600000,14523,Vogtlandkreis,228,7,221,227796,161
DE-SN,13-04-2020,RKI,1,1,0,1586736000000,14523,Vogtlandkreis,229,7,222,227796,161
DE-SN,14-04-2020,RKI,9,9,0,1586822400000,14523,Vogtlandkreis,238,7,231,227796,161
DE-SN,15-04-2020,RKI,1,1,0,1586908800000,14523,Vogtlandkreis,239,7,232,227796,161
DE-SN,16-04-2020,RKI,4,4,0,1586995200000,14523,Vogtlandkreis,243,7,236,227796,161
DE-SN,17-04-2020,RKI,1,1,0,1587081600000,14523,Vogtlandkreis,244,7,237,227796,161
DE-SN,18-04-2020,RKI,1,1,0,1587168000000,14523,Vogtlandkreis,245,7,238,227796,161
DE-SN,19-04-2020,RKI,0,0,0,1587254400000,14523,Vogtlandkreis,245,7,238,227796,161
DE-SN,20-04-2020,RKI,4,3,1,1587340800000,14523,Vogtlandkreis,249,8,241,227796,161
DE-SN,21-04-2020,RKI,2,1,1,1587427200000,14523,Vogtlandkreis,251,9,242,227796,161
DE-SN,22-04-2020,RKI,9,9,0,1587513600000,14523,Vogtlandkreis,260,9,251,227796,161
DE-SN,23-04-2020,RKI,1,1,0,1587600000000,14523,Vogtlandkreis,261,9,252,227796,161
DE-SN,24-04-2020,RKI,4,3,1,1587686400000,14523,Vogtlandkreis,265,10,255,227796,161
DE-SN,25-04-2020,RKI,1,1,0,1587772800000,14523,Vogtlandkreis,266,10,256,227796,161
DE-SN,26-04-2020,RKI,4,4,0,1587859200000,14523,Vogtlandkreis,270,10,260,227796,161
DE-SN,28-04-2020,RKI,4,3,1,1588032000000,14523,Vogtlandkreis,274,11,263,227796,161
DE-SN,29-04-2020,RKI,4,4,0,1588118400000,14523,Vogtlandkreis,278,11,267,227796,161
DE-SN,30-04-2020,RKI,13,11,2,1588204800000,14523,Vogtlandkreis,291,13,278,227796,161
DE-SN,01-05-2020,RKI,9,9,0,1588291200000,14523,Vogtlandkreis,300,13,287,227796,161
DE-SN,02-05-2020,RKI,10,10,0,1588377600000,14523,Vogtlandkreis,310,13,297,227796,161
DE-SN,03-05-2020,RKI,2,2,0,1588464000000,14523,Vogtlandkreis,312,13,299,227796,161
DE-SN,04-05-2020,RKI,3,3,0,1588550400000,14523,Vogtlandkreis,315,13,302,227796,161
DE-SN,05-05-2020,RKI,4,3,1,1588636800000,14523,Vogtlandkreis,319,14,305,227796,161
DE-SN,06-05-2020,RKI,6,6,0,1588723200000,14523,Vogtlandkreis,325,14,311,227796,161
DE-SN,07-05-2020,RKI,5,5,0,1588809600000,14523,Vogtlandkreis,330,14,316,227796,161
DE-SN,08-05-2020,RKI,5,5,0,1588896000000,14523,Vogtlandkreis,335,14,321,227796,161
DE-SN,09-05-2020,RKI,8,8,0,1588982400000,14523,Vogtlandkreis,343,14,329,227796,161
DE-SN,10-05-2020,RKI,2,2,0,1589068800000,14523,Vogtlandkreis,345,14,331,227796,161
DE-SN,11-05-2020,RKI,0,0,0,1589155200000,14523,Vogtlandkreis,345,14,331,227796,161
DE-SN,12-05-2020,RKI,2,2,0,1589241600000,14523,Vogtlandkreis,347,14,333,227796,161
DE-SN,13-05-2020,RKI,8,7,1,1589328000000,14523,Vogtlandkreis,355,15,340,227796,161
DE-SN,14-05-2020,RKI,3,2,1,1589414400000,14523,Vogtlandkreis,358,16,342,227796,161
DE-SN,15-05-2020,RKI,2,2,0,1589500800000,14523,Vogtlandkreis,360,16,344,227796,161
DE-SN,16-05-2020,RKI,1,0,1,1589587200000,14523,Vogtlandkreis,361,17,344,227796,161
DE-SN,18-05-2020,RKI,0,0,0,1589760000000,14523,Vogtlandkreis,361,17,344,227796,161
DE-SN,19-05-2020,RKI,3,3,0,1589846400000,14523,Vogtlandkreis,364,17,347,227796,161
DE-SN,20-05-2020,RKI,11,10,1,1589932800000,14523,Vogtlandkreis,375,18,357,227796,161
DE-SN,21-05-2020,RKI,3,3,0,1590019200000,14523,Vogtlandkreis,378,18,360,227796,161
DE-SN,22-05-2020,RKI,3,3,0,1590105600000,14523,Vogtlandkreis,381,18,363,227796,161
DE-SN,23-05-2020,RKI,2,2,0,1590192000000,14523,Vogtlandkreis,383,18,365,227796,161
DE-SN,24-05-2020,RKI,0,0,0,1590278400000,14523,Vogtlandkreis,383,18,365,227796,161
DE-SN,25-05-2020,RKI,2,2,0,1590364800000,14523,Vogtlandkreis,385,18,367,227796,161
DE-SN,26-05-2020,RKI,3,2,1,1590451200000,14523,Vogtlandkreis,388,19,369,227796,161
DE-SN,27-05-2020,RKI,10,9,1,1590537600000,14523,Vogtlandkreis,398,20,378,227796,161
DE-SN,28-05-2020,RKI,0,0,0,1590624000000,14523,Vogtlandkreis,398,20,378,227796,161
DE-SN,29-05-2020,RKI,1,1,0,1590710400000,14523,Vogtlandkreis,399,20,379,227796,161
DE-SN,30-05-2020,RKI,2,2,0,1590796800000,14523,Vogtlandkreis,401,20,381,227796,161
DE-SN,03-06-2020,RKI,3,3,0,1591142400000,14523,Vogtlandkreis,404,20,384,227796,161
DE-SN,04-06-2020,RKI,1,1,0,1591228800000,14523,Vogtlandkreis,405,20,385,227796,161
DE-SN,05-06-2020,RKI,1,0,1,1591315200000,14523,Vogtlandkreis,406,21,385,227796,161
DE-SN,06-06-2020,RKI,0,0,0,1591401600000,14523,Vogtlandkreis,406,21,385,227796,161
DE-SN,09-06-2020,RKI,0,0,0,1591660800000,14523,Vogtlandkreis,406,21,385,227796,161
DE-SN,10-06-2020,RKI,0,0,0,1591747200000,14523,Vogtlandkreis,406,21,385,227796,161
DE-SN,15-06-2020,RKI,0,0,0,1592179200000,14523,Vogtlandkreis,406,21,385,227796,161
DE-SN,16-06-2020,RKI,2,2,0,1592265600000,14523,Vogtlandkreis,408,21,387,227796,161
DE-SN,17-06-2020,RKI,8,8,0,1592352000000,14523,Vogtlandkreis,416,21,395,227796,161
DE-SN,18-06-2020,RKI,1,1,0,1592438400000,14523,Vogtlandkreis,417,21,396,227796,161
DE-SN,19-06-2020,RKI,1,1,0,1592524800000,14523,Vogtlandkreis,418,21,397,227796,161
DE-SN,21-06-2020,RKI,0,0,0,1592697600000,14523,Vogtlandkreis,418,21,397,227796,161
DE-SN,23-06-2020,RKI,0,0,0,1592870400000,14523,Vogtlandkreis,418,21,397,227796,161
DE-SN,24-06-2020,RKI,0,0,0,1592956800000,14523,Vogtlandkreis,418,21,397,227796,161
DE-SN,28-06-2020,RKI,0,0,0,1593302400000,14523,Vogtlandkreis,418,21,397,227796,161
DE-SN,13-07-2020,RKI,0,0,0,1594598400000,14523,Vogtlandkreis,418,21,397,227796,161
DE-SN,13-03-2020,RKI,2,2,0,1584057600000,14524,Zwickau,2,0,2,317531,334
DE-SN,14-03-2020,RKI,5,4,1,1584144000000,14524,Zwickau,7,1,6,317531,334
DE-SN,15-03-2020,RKI,3,3,0,1584230400000,14524,Zwickau,10,1,9,317531,334
DE-SN,16-03-2020,RKI,3,3,0,1584316800000,14524,Zwickau,13,1,12,317531,334
DE-SN,17-03-2020,RKI,16,16,0,1584403200000,14524,Zwickau,29,1,28,317531,334
DE-SN,18-03-2020,RKI,31,31,0,1584489600000,14524,Zwickau,60,1,59,317531,334
DE-SN,19-03-2020,RKI,41,41,0,1584576000000,14524,Zwickau,101,1,100,317531,334
DE-SN,20-03-2020,RKI,25,25,0,1584662400000,14524,Zwickau,126,1,125,317531,334
DE-SN,21-03-2020,RKI,19,19,0,1584748800000,14524,Zwickau,145,1,144,317531,334
DE-SN,22-03-2020,RKI,6,6,0,1584835200000,14524,Zwickau,151,1,150,317531,334
DE-SN,23-03-2020,RKI,19,17,2,1584921600000,14524,Zwickau,170,3,167,317531,334
DE-SN,24-03-2020,RKI,30,29,1,1585008000000,14524,Zwickau,200,4,196,317531,334
DE-SN,25-03-2020,RKI,28,26,2,1585094400000,14524,Zwickau,228,6,222,317531,334
DE-SN,26-03-2020,RKI,21,20,1,1585180800000,14524,Zwickau,249,7,242,317531,334
DE-SN,27-03-2020,RKI,25,24,1,1585267200000,14524,Zwickau,274,8,266,317531,334
DE-SN,28-03-2020,RKI,34,32,2,1585353600000,14524,Zwickau,308,10,298,317531,334
DE-SN,29-03-2020,RKI,13,12,1,1585440000000,14524,Zwickau,321,11,310,317531,334
DE-SN,30-03-2020,RKI,13,13,0,1585526400000,14524,Zwickau,334,11,323,317531,334
DE-SN,31-03-2020,RKI,24,18,6,1585612800000,14524,Zwickau,358,17,341,317531,334
DE-SN,01-04-2020,RKI,19,19,0,1585699200000,14524,Zwickau,377,17,360,317531,334
DE-SN,02-04-2020,RKI,41,37,4,1585785600000,14524,Zwickau,418,21,397,317531,334
DE-SN,03-04-2020,RKI,39,38,1,1585872000000,14524,Zwickau,457,22,435,317531,334
DE-SN,04-04-2020,RKI,23,19,4,1585958400000,14524,Zwickau,480,26,454,317531,334
DE-SN,05-04-2020,RKI,1,0,1,1586044800000,14524,Zwickau,481,27,454,317531,334
DE-SN,06-04-2020,RKI,3,2,1,1586131200000,14524,Zwickau,484,28,456,317531,334
DE-SN,07-04-2020,RKI,20,18,2,1586217600000,14524,Zwickau,504,30,474,317531,334
DE-SN,08-04-2020,RKI,40,37,3,1586304000000,14524,Zwickau,544,33,511,317531,334
DE-SN,09-04-2020,RKI,5,4,1,1586390400000,14524,Zwickau,549,34,515,317531,334
DE-SN,10-04-2020,RKI,17,16,1,1586476800000,14524,Zwickau,566,35,531,317531,334
DE-SN,11-04-2020,RKI,13,12,1,1586563200000,14524,Zwickau,579,36,543,317531,334
DE-SN,12-04-2020,RKI,7,7,0,1586649600000,14524,Zwickau,586,36,550,317531,334
DE-SN,13-04-2020,RKI,15,10,5,1586736000000,14524,Zwickau,601,41,560,317531,334
DE-SN,14-04-2020,RKI,19,17,2,1586822400000,14524,Zwickau,620,43,577,317531,334
DE-SN,15-04-2020,RKI,8,8,0,1586908800000,14524,Zwickau,628,43,585,317531,334
DE-SN,16-04-2020,RKI,18,18,0,1586995200000,14524,Zwickau,646,43,603,317531,334
DE-SN,17-04-2020,RKI,2,2,0,1587081600000,14524,Zwickau,648,43,605,317531,334
DE-SN,18-04-2020,RKI,8,8,0,1587168000000,14524,Zwickau,656,43,613,317531,334
DE-SN,19-04-2020,RKI,7,7,0,1587254400000,14524,Zwickau,663,43,620,317531,334
DE-SN,21-04-2020,RKI,8,8,0,1587427200000,14524,Zwickau,671,43,628,317531,334
DE-SN,22-04-2020,RKI,7,7,0,1587513600000,14524,Zwickau,678,43,635,317531,334
DE-SN,23-04-2020,RKI,5,4,1,1587600000000,14524,Zwickau,683,44,639,317531,334
DE-SN,24-04-2020,RKI,8,7,1,1587686400000,14524,Zwickau,691,45,646,317531,334
DE-SN,25-04-2020,RKI,2,2,0,1587772800000,14524,Zwickau,693,45,648,317531,334
DE-SN,27-04-2020,RKI,3,2,1,1587945600000,14524,Zwickau,696,46,650,317531,334
DE-SN,28-04-2020,RKI,7,7,0,1588032000000,14524,Zwickau,703,46,657,317531,334
DE-SN,29-04-2020,RKI,8,5,3,1588118400000,14524,Zwickau,711,49,662,317531,334
DE-SN,30-04-2020,RKI,1,1,0,1588204800000,14524,Zwickau,712,49,663,317531,334
DE-SN,01-05-2020,RKI,4,4,0,1588291200000,14524,Zwickau,716,49,667,317531,334
DE-SN,02-05-2020,RKI,0,0,0,1588377600000,14524,Zwickau,716,49,667,317531,334
DE-SN,03-05-2020,RKI,4,4,0,1588464000000,14524,Zwickau,720,49,671,317531,334
DE-SN,05-05-2020,RKI,15,13,2,1588636800000,14524,Zwickau,735,51,684,317531,334
DE-SN,06-05-2020,RKI,4,4,0,1588723200000,14524,Zwickau,739,51,688,317531,334
DE-SN,07-05-2020,RKI,6,6,0,1588809600000,14524,Zwickau,745,51,694,317531,334
DE-SN,08-05-2020,RKI,2,2,0,1588896000000,14524,Zwickau,747,51,696,317531,334
DE-SN,09-05-2020,RKI,3,3,0,1588982400000,14524,Zwickau,750,51,699,317531,334
DE-SN,10-05-2020,RKI,2,2,0,1589068800000,14524,Zwickau,752,51,701,317531,334
DE-SN,11-05-2020,RKI,3,2,1,1589155200000,14524,Zwickau,755,52,703,317531,334
DE-SN,12-05-2020,RKI,2,2,0,1589241600000,14524,Zwickau,757,52,705,317531,334
DE-SN,13-05-2020,RKI,5,5,0,1589328000000,14524,Zwickau,762,52,710,317531,334
DE-SN,14-05-2020,RKI,9,9,0,1589414400000,14524,Zwickau,771,52,719,317531,334
DE-SN,15-05-2020,RKI,2,2,0,1589500800000,14524,Zwickau,773,52,721,317531,334
DE-SN,16-05-2020,RKI,4,4,0,1589587200000,14524,Zwickau,777,52,725,317531,334
DE-SN,17-05-2020,RKI,0,0,0,1589673600000,14524,Zwickau,777,52,725,317531,334
DE-SN,19-05-2020,RKI,3,3,0,1589846400000,14524,Zwickau,780,52,728,317531,334
DE-SN,20-05-2020,RKI,4,4,0,1589932800000,14524,Zwickau,784,52,732,317531,334
DE-SN,21-05-2020,RKI,1,1,0,1590019200000,14524,Zwickau,785,52,733,317531,334
DE-SN,23-05-2020,RKI,0,0,0,1590192000000,14524,Zwickau,785,52,733,317531,334
DE-SN,25-05-2020,RKI,0,0,0,1590364800000,14524,Zwickau,785,52,733,317531,334
DE-SN,26-05-2020,RKI,3,3,0,1590451200000,14524,Zwickau,788,52,736,317531,334
DE-SN,28-05-2020,RKI,4,4,0,1590624000000,14524,Zwickau,792,52,740,317531,334
DE-SN,29-05-2020,RKI,1,1,0,1590710400000,14524,Zwickau,793,52,741,317531,334
DE-SN,30-05-2020,RKI,1,1,0,1590796800000,14524,Zwickau,794,52,742,317531,334
DE-SN,03-06-2020,RKI,3,3,0,1591142400000,14524,Zwickau,797,52,745,317531,334
DE-SN,04-06-2020,RKI,0,0,0,1591228800000,14524,Zwickau,797,52,745,317531,334
DE-SN,09-06-2020,RKI,1,1,0,1591660800000,14524,Zwickau,798,52,746,317531,334
DE-SN,10-06-2020,RKI,0,0,0,1591747200000,14524,Zwickau,798,52,746,317531,334
DE-SN,16-06-2020,RKI,1,1,0,1592265600000,14524,Zwickau,799,52,747,317531,334
DE-SN,17-06-2020,RKI,0,0,0,1592352000000,14524,Zwickau,799,52,747,317531,334
DE-SN,19-06-2020,RKI,1,1,0,1592524800000,14524,Zwickau,800,52,748,317531,334
DE-SN,27-06-2020,RKI,0,0,0,1593216000000,14524,Zwickau,800,52,748,317531,334
DE-SN,28-06-2020,RKI,0,0,0,1593302400000,14524,Zwickau,800,52,748,317531,334
DE-SN,14-07-2020,RKI,0,0,0,1594684800000,14524,Zwickau,800,52,748,317531,334
DE-SN,09-03-2020,RKI,0,0,0,1583712000000,14612,Dresden,1,0,1,554649,1689
DE-SN,10-03-2020,RKI,1,1,0,1583798400000,14612,Dresden,2,0,2,554649,1689
DE-SN,11-03-2020,RKI,3,3,0,1583884800000,14612,Dresden,5,0,5,554649,1689
DE-SN,12-03-2020,RKI,6,6,0,1583971200000,14612,Dresden,11,0,11,554649,1689
DE-SN,13-03-2020,RKI,6,6,0,1584057600000,14612,Dresden,17,0,17,554649,1689
DE-SN,14-03-2020,RKI,9,9,0,1584144000000,14612,Dresden,26,0,26,554649,1689
DE-SN,15-03-2020,RKI,3,3,0,1584230400000,14612,Dresden,29,0,29,554649,1689
DE-SN,16-03-2020,RKI,4,4,0,1584316800000,14612,Dresden,33,0,33,554649,1689
DE-SN,17-03-2020,RKI,16,16,0,1584403200000,14612,Dresden,49,0,49,554649,1689
DE-SN,18-03-2020,RKI,14,14,0,1584489600000,14612,Dresden,63,0,63,554649,1689
DE-SN,19-03-2020,RKI,27,26,1,1584576000000,14612,Dresden,90,1,89,554649,1689
DE-SN,20-03-2020,RKI,20,18,2,1584662400000,14612,Dresden,110,3,107,554649,1689
DE-SN,21-03-2020,RKI,34,34,0,1584748800000,14612,Dresden,144,3,141,554649,1689
DE-SN,23-03-2020,RKI,15,15,0,1584921600000,14612,Dresden,159,3,156,554649,1689
DE-SN,24-03-2020,RKI,40,39,1,1585008000000,14612,Dresden,199,4,195,554649,1689
DE-SN,25-03-2020,RKI,12,12,0,1585094400000,14612,Dresden,211,4,207,554649,1689
DE-SN,26-03-2020,RKI,33,33,0,1585180800000,14612,Dresden,244,4,240,554649,1689
DE-SN,27-03-2020,RKI,35,34,1,1585267200000,14612,Dresden,279,5,274,554649,1689
DE-SN,28-03-2020,RKI,23,23,0,1585353600000,14612,Dresden,302,5,297,554649,1689
DE-SN,29-03-2020,RKI,8,8,0,1585440000000,14612,Dresden,310,5,305,554649,1689
DE-SN,30-03-2020,RKI,17,16,1,1585526400000,14612,Dresden,327,6,321,554649,1689
DE-SN,31-03-2020,RKI,18,18,0,1585612800000,14612,Dresden,345,6,339,554649,1689
DE-SN,01-04-2020,RKI,20,20,0,1585699200000,14612,Dresden,365,6,359,554649,1689
DE-SN,02-04-2020,RKI,9,9,0,1585785600000,14612,Dresden,374,6,368,554649,1689
DE-SN,03-04-2020,RKI,25,25,0,1585872000000,14612,Dresden,399,6,393,554649,1689
DE-SN,04-04-2020,RKI,18,18,0,1585958400000,14612,Dresden,417,6,411,554649,1689
DE-SN,05-04-2020,RKI,3,3,0,1586044800000,14612,Dresden,420,6,414,554649,1689
DE-SN,06-04-2020,RKI,3,3,0,1586131200000,14612,Dresden,423,6,417,554649,1689
DE-SN,07-04-2020,RKI,8,8,0,1586217600000,14612,Dresden,431,6,425,554649,1689
DE-SN,08-04-2020,RKI,8,8,0,1586304000000,14612,Dresden,439,6,433,554649,1689
DE-SN,09-04-2020,RKI,6,6,0,1586390400000,14612,Dresden,445,6,439,554649,1689
DE-SN,11-04-2020,RKI,3,3,0,1586563200000,14612,Dresden,448,6,442,554649,1689
DE-SN,12-04-2020,RKI,3,3,0,1586649600000,14612,Dresden,451,6,445,554649,1689
DE-SN,13-04-2020,RKI,0,0,0,1586736000000,14612,Dresden,451,6,445,554649,1689
DE-SN,14-04-2020,RKI,4,4,0,1586822400000,14612,Dresden,455,6,449,554649,1689
DE-SN,15-04-2020,RKI,7,6,1,1586908800000,14612,Dresden,462,7,455,554649,1689
DE-SN,16-04-2020,RKI,1,1,0,1586995200000,14612,Dresden,463,7,456,554649,1689
DE-SN,17-04-2020,RKI,16,13,3,1587081600000,14612,Dresden,479,10,469,554649,1689
DE-SN,19-04-2020,RKI,0,0,0,1587254400000,14612,Dresden,479,10,469,554649,1689
DE-SN,20-04-2020,RKI,2,2,0,1587340800000,14612,Dresden,481,10,471,554649,1689
DE-SN,21-04-2020,RKI,7,7,0,1587427200000,14612,Dresden,488,10,478,554649,1689
DE-SN,22-04-2020,RKI,3,3,0,1587513600000,14612,Dresden,491,10,481,554649,1689
DE-SN,23-04-2020,RKI,0,0,0,1587600000000,14612,Dresden,491,10,481,554649,1689
DE-SN,24-04-2020,RKI,5,5,0,1587686400000,14612,Dresden,496,10,486,554649,1689
DE-SN,25-04-2020,RKI,1,1,0,1587772800000,14612,Dresden,497,10,487,554649,1689
DE-SN,26-04-2020,RKI,4,4,0,1587859200000,14612,Dresden,501,10,491,554649,1689
DE-SN,28-04-2020,RKI,2,2,0,1588032000000,14612,Dresden,503,10,493,554649,1689
DE-SN,29-04-2020,RKI,5,5,0,1588118400000,14612,Dresden,508,10,498,554649,1689
DE-SN,30-04-2020,RKI,2,2,0,1588204800000,14612,Dresden,510,10,500,554649,1689
DE-SN,01-05-2020,RKI,0,0,0,1588291200000,14612,Dresden,510,10,500,554649,1689
DE-SN,02-05-2020,RKI,0,0,0,1588377600000,14612,Dresden,510,10,500,554649,1689
DE-SN,03-05-2020,RKI,0,0,0,1588464000000,14612,Dresden,510,10,500,554649,1689
DE-SN,05-05-2020,RKI,7,7,0,1588636800000,14612,Dresden,517,10,507,554649,1689
DE-SN,06-05-2020,RKI,4,4,0,1588723200000,14612,Dresden,521,10,511,554649,1689
DE-SN,07-05-2020,RKI,2,2,0,1588809600000,14612,Dresden,523,10,513,554649,1689
DE-SN,08-05-2020,RKI,4,4,0,1588896000000,14612,Dresden,527,10,517,554649,1689
DE-SN,09-05-2020,RKI,1,1,0,1588982400000,14612,Dresden,528,10,518,554649,1689
DE-SN,11-05-2020,RKI,0,0,0,1589155200000,14612,Dresden,528,10,518,554649,1689
DE-SN,13-05-2020,RKI,2,2,0,1589328000000,14612,Dresden,530,10,520,554649,1689
DE-SN,14-05-2020,RKI,5,5,0,1589414400000,14612,Dresden,535,10,525,554649,1689
DE-SN,15-05-2020,RKI,2,2,0,1589500800000,14612,Dresden,537,10,527,554649,1689
DE-SN,18-05-2020,RKI,3,3,0,1589760000000,14612,Dresden,540,10,530,554649,1689
DE-SN,19-05-2020,RKI,3,3,0,1589846400000,14612,Dresden,543,10,533,554649,1689
DE-SN,20-05-2020,RKI,0,0,0,1589932800000,14612,Dresden,543,10,533,554649,1689
DE-SN,21-05-2020,RKI,3,3,0,1590019200000,14612,Dresden,546,10,536,554649,1689
DE-SN,26-05-2020,RKI,1,1,0,1590451200000,14612,Dresden,547,10,537,554649,1689
DE-SN,27-05-2020,RKI,0,0,0,1590537600000,14612,Dresden,547,10,537,554649,1689
DE-SN,28-05-2020,RKI,1,1,0,1590624000000,14612,Dresden,548,10,538,554649,1689
DE-SN,06-06-2020,RKI,0,0,0,1591401600000,14612,Dresden,548,10,538,554649,1689
DE-SN,12-06-2020,RKI,0,0,0,1591920000000,14612,Dresden,548,10,538,554649,1689
DE-SN,23-06-2020,RKI,1,0,0,1592870400000,14612,Dresden,549,10,538,554649,1689
DE-SN,08-07-2020,RKI,0,0,0,1594166400000,14612,Dresden,549,10,538,554649,1689
DE-SN,13-07-2020,RKI,0,0,0,1594598400000,14612,Dresden,549,10,538,554649,1689
DE-SN,16-07-2020,RKI,0,0,0,1594857600000,14612,Dresden,549,10,538,554649,1689
DE-SN,08-03-2020,RKI,2,2,0,1583625600000,14625,Bautzen,2,0,2,300880,126
DE-SN,10-03-2020,RKI,4,4,0,1583798400000,14625,Bautzen,6,0,6,300880,126
DE-SN,11-03-2020,RKI,1,1,0,1583884800000,14625,Bautzen,7,0,7,300880,126
DE-SN,12-03-2020,RKI,0,0,0,1583971200000,14625,Bautzen,7,0,7,300880,126
DE-SN,13-03-2020,RKI,2,1,1,1584057600000,14625,Bautzen,9,1,8,300880,126
DE-SN,14-03-2020,RKI,0,0,0,1584144000000,14625,Bautzen,9,1,8,300880,126
DE-SN,15-03-2020,RKI,0,0,0,1584230400000,14625,Bautzen,9,1,8,300880,126
DE-SN,16-03-2020,RKI,1,1,0,1584316800000,14625,Bautzen,10,1,9,300880,126
DE-SN,17-03-2020,RKI,9,9,0,1584403200000,14625,Bautzen,19,1,18,300880,126
DE-SN,18-03-2020,RKI,11,11,0,1584489600000,14625,Bautzen,30,1,29,300880,126
DE-SN,19-03-2020,RKI,5,5,0,1584576000000,14625,Bautzen,35,1,34,300880,126
DE-SN,20-03-2020,RKI,16,16,0,1584662400000,14625,Bautzen,51,1,50,300880,126
DE-SN,21-03-2020,RKI,11,11,0,1584748800000,14625,Bautzen,62,1,61,300880,126
DE-SN,22-03-2020,RKI,9,9,0,1584835200000,14625,Bautzen,71,1,70,300880,126
DE-SN,23-03-2020,RKI,5,5,0,1584921600000,14625,Bautzen,76,1,75,300880,126
DE-SN,24-03-2020,RKI,12,12,0,1585008000000,14625,Bautzen,88,1,87,300880,126
DE-SN,25-03-2020,RKI,10,10,0,1585094400000,14625,Bautzen,98,1,97,300880,126
DE-SN,26-03-2020,RKI,20,20,0,1585180800000,14625,Bautzen,118,1,117,300880,126
DE-SN,27-03-2020,RKI,12,12,0,1585267200000,14625,Bautzen,130,1,129,300880,126
DE-SN,28-03-2020,RKI,15,15,0,1585353600000,14625,Bautzen,145,1,144,300880,126
DE-SN,29-03-2020,RKI,0,0,0,1585440000000,14625,Bautzen,145,1,144,300880,126
DE-SN,30-03-2020,RKI,8,8,0,1585526400000,14625,Bautzen,153,1,152,300880,126
DE-SN,31-03-2020,RKI,9,8,1,1585612800000,14625,Bautzen,162,2,160,300880,126
DE-SN,01-04-2020,RKI,3,3,0,1585699200000,14625,Bautzen,165,2,163,300880,126
DE-SN,02-04-2020,RKI,6,6,0,1585785600000,14625,Bautzen,171,2,169,300880,126
DE-SN,03-04-2020,RKI,5,5,0,1585872000000,14625,Bautzen,176,2,174,300880,126
DE-SN,04-04-2020,RKI,3,3,0,1585958400000,14625,Bautzen,179,2,177,300880,126
DE-SN,05-04-2020,RKI,3,3,0,1586044800000,14625,Bautzen,182,2,180,300880,126
DE-SN,07-04-2020,RKI,11,10,1,1586217600000,14625,Bautzen,193,3,190,300880,126
DE-SN,08-04-2020,RKI,10,10,0,1586304000000,14625,Bautzen,203,3,200,300880,126
DE-SN,09-04-2020,RKI,4,4,0,1586390400000,14625,Bautzen,207,3,204,300880,126
DE-SN,10-04-2020,RKI,19,19,0,1586476800000,14625,Bautzen,226,3,223,300880,126
DE-SN,11-04-2020,RKI,15,14,1,1586563200000,14625,Bautzen,241,4,237,300880,126
DE-SN,12-04-2020,RKI,6,6,0,1586649600000,14625,Bautzen,247,4,243,300880,126
DE-SN,13-04-2020,RKI,2,2,0,1586736000000,14625,Bautzen,249,4,245,300880,126
DE-SN,14-04-2020,RKI,0,0,0,1586822400000,14625,Bautzen,249,4,245,300880,126
DE-SN,15-04-2020,RKI,7,7,0,1586908800000,14625,Bautzen,256,4,252,300880,126
DE-SN,16-04-2020,RKI,10,10,0,1586995200000,14625,Bautzen,266,4,262,300880,126
DE-SN,17-04-2020,RKI,7,5,2,1587081600000,14625,Bautzen,273,6,267,300880,126
DE-SN,18-04-2020,RKI,1,1,0,1587168000000,14625,Bautzen,274,6,268,300880,126
DE-SN,19-04-2020,RKI,1,1,0,1587254400000,14625,Bautzen,275,6,269,300880,126
DE-SN,20-04-2020,RKI,4,1,3,1587340800000,14625,Bautzen,279,9,270,300880,126
DE-SN,21-04-2020,RKI,3,3,0,1587427200000,14625,Bautzen,282,9,273,300880,126
DE-SN,22-04-2020,RKI,7,7,0,1587513600000,14625,Bautzen,289,9,280,300880,126
DE-SN,23-04-2020,RKI,2,2,0,1587600000000,14625,Bautzen,291,9,282,300880,126
DE-SN,24-04-2020,RKI,4,2,2,1587686400000,14625,Bautzen,295,11,284,300880,126
DE-SN,25-04-2020,RKI,0,0,0,1587772800000,14625,Bautzen,295,11,284,300880,126
DE-SN,28-04-2020,RKI,2,2,0,1588032000000,14625,Bautzen,297,11,286,300880,126
DE-SN,29-04-2020,RKI,3,3,0,1588118400000,14625,Bautzen,300,11,289,300880,126
DE-SN,30-04-2020,RKI,3,3,0,1588204800000,14625,Bautzen,303,11,292,300880,126
DE-SN,02-05-2020,RKI,0,0,0,1588377600000,14625,Bautzen,303,11,292,300880,126
DE-SN,04-05-2020,RKI,1,1,0,1588550400000,14625,Bautzen,304,11,293,300880,126
DE-SN,05-05-2020,RKI,13,13,0,1588636800000,14625,Bautzen,317,11,306,300880,126
DE-SN,06-05-2020,RKI,7,7,0,1588723200000,14625,Bautzen,324,11,313,300880,126
DE-SN,07-05-2020,RKI,6,6,0,1588809600000,14625,Bautzen,330,11,319,300880,126
DE-SN,08-05-2020,RKI,21,20,1,1588896000000,14625,Bautzen,351,12,339,300880,126
DE-SN,09-05-2020,RKI,3,3,0,1588982400000,14625,Bautzen,354,12,342,300880,126
DE-SN,11-05-2020,RKI,7,7,0,1589155200000,14625,Bautzen,361,12,349,300880,126
DE-SN,12-05-2020,RKI,9,9,0,1589241600000,14625,Bautzen,370,12,358,300880,126
DE-SN,13-05-2020,RKI,8,8,0,1589328000000,14625,Bautzen,378,12,366,300880,126
DE-SN,14-05-2020,RKI,3,3,0,1589414400000,14625,Bautzen,381,12,369,300880,126
DE-SN,15-05-2020,RKI,4,2,2,1589500800000,14625,Bautzen,385,14,371,300880,126
DE-SN,16-05-2020,RKI,3,2,1,1589587200000,14625,Bautzen,388,15,373,300880,126
DE-SN,18-05-2020,RKI,10,10,0,1589760000000,14625,Bautzen,398,15,383,300880,126
DE-SN,19-05-2020,RKI,5,4,1,1589846400000,14625,Bautzen,403,16,387,300880,126
DE-SN,20-05-2020,RKI,5,5,0,1589932800000,14625,Bautzen,408,16,392,300880,126
DE-SN,21-05-2020,RKI,0,0,0,1590019200000,14625,Bautzen,408,16,392,300880,126
DE-SN,23-05-2020,RKI,0,0,0,1590192000000,14625,Bautzen,408,16,392,300880,126
DE-SN,24-05-2020,RKI,1,0,1,1590278400000,14625,Bautzen,409,17,392,300880,126
DE-SN,25-05-2020,RKI,3,2,1,1590364800000,14625,Bautzen,412,18,394,300880,126
DE-SN,26-05-2020,RKI,0,0,0,1590451200000,14625,Bautzen,412,18,394,300880,126
DE-SN,27-05-2020,RKI,1,1,0,1590537600000,14625,Bautzen,413,18,395,300880,126
DE-SN,28-05-2020,RKI,4,4,0,1590624000000,14625,Bautzen,417,18,399,300880,126
DE-SN,29-05-2020,RKI,2,2,0,1590710400000,14625,Bautzen,419,18,401,300880,126
DE-SN,04-06-2020,RKI,0,0,0,1591228800000,14625,Bautzen,419,18,401,300880,126
DE-SN,05-06-2020,RKI,0,0,0,1591315200000,14625,Bautzen,419,18,401,300880,126
DE-SN,06-06-2020,RKI,0,0,0,1591401600000,14625,Bautzen,419,18,401,300880,126
DE-SN,12-06-2020,RKI,0,0,0,1591920000000,14625,Bautzen,419,18,401,300880,126
DE-SN,17-06-2020,RKI,0,0,0,1592352000000,14625,Bautzen,419,18,401,300880,126
DE-SN,07-07-2020,RKI,0,0,0,1594080000000,14625,Bautzen,419,18,401,300880,126
DE-SN,11-07-2020,RKI,0,0,0,1594425600000,14625,Bautzen,419,18,401,300880,126
DE-SN,10-03-2020,RKI,4,4,0,1583798400000,14626,Görlitz,4,0,4,254894,121
DE-SN,12-03-2020,RKI,0,0,0,1583971200000,14626,Görlitz,4,0,4,254894,121
DE-SN,16-03-2020,RKI,1,1,0,1584316800000,14626,Görlitz,5,0,5,254894,121
DE-SN,17-03-2020,RKI,1,1,0,1584403200000,14626,Görlitz,6,0,6,254894,121
DE-SN,18-03-2020,RKI,2,2,0,1584489600000,14626,Görlitz,8,0,8,254894,121
DE-SN,19-03-2020,RKI,7,7,0,1584576000000,14626,Görlitz,15,0,15,254894,121
DE-SN,20-03-2020,RKI,2,2,0,1584662400000,14626,Görlitz,17,0,17,254894,121
DE-SN,21-03-2020,RKI,1,1,0,1584748800000,14626,Görlitz,18,0,18,254894,121
DE-SN,23-03-2020,RKI,2,1,1,1584921600000,14626,Görlitz,20,1,19,254894,121
DE-SN,24-03-2020,RKI,1,1,0,1585008000000,14626,Görlitz,21,1,20,254894,121
DE-SN,25-03-2020,RKI,21,21,0,1585094400000,14626,Görlitz,42,1,41,254894,121
DE-SN,26-03-2020,RKI,3,3,0,1585180800000,14626,Görlitz,45,1,44,254894,121
DE-SN,27-03-2020,RKI,2,2,0,1585267200000,14626,Görlitz,47,1,46,254894,121
DE-SN,28-03-2020,RKI,5,5,0,1585353600000,14626,Görlitz,52,1,51,254894,121
DE-SN,29-03-2020,RKI,0,0,0,1585440000000,14626,Görlitz,52,1,51,254894,121
DE-SN,30-03-2020,RKI,5,3,2,1585526400000,14626,Görlitz,57,3,54,254894,121
DE-SN,31-03-2020,RKI,8,5,3,1585612800000,14626,Görlitz,65,6,59,254894,121
DE-SN,01-04-2020,RKI,12,12,0,1585699200000,14626,Görlitz,77,6,71,254894,121
DE-SN,02-04-2020,RKI,5,4,1,1585785600000,14626,Görlitz,82,7,75,254894,121
DE-SN,03-04-2020,RKI,56,45,11,1585872000000,14626,Görlitz,138,18,120,254894,121
DE-SN,04-04-2020,RKI,14,14,0,1585958400000,14626,Görlitz,152,18,134,254894,121
DE-SN,05-04-2020,RKI,3,3,0,1586044800000,14626,Görlitz,155,18,137,254894,121
DE-SN,06-04-2020,RKI,6,5,1,1586131200000,14626,Görlitz,161,19,142,254894,121
DE-SN,07-04-2020,RKI,16,16,0,1586217600000,14626,Görlitz,177,19,158,254894,121
DE-SN,08-04-2020,RKI,7,6,1,1586304000000,14626,Görlitz,184,20,164,254894,121
DE-SN,09-04-2020,RKI,7,6,1,1586390400000,14626,Görlitz,191,21,170,254894,121
DE-SN,10-04-2020,RKI,3,3,0,1586476800000,14626,Görlitz,194,21,173,254894,121
DE-SN,11-04-2020,RKI,0,0,0,1586563200000,14626,Görlitz,194,21,173,254894,121
DE-SN,12-04-2020,RKI,0,0,0,1586649600000,14626,Görlitz,194,21,173,254894,121
DE-SN,13-04-2020,RKI,0,0,0,1586736000000,14626,Görlitz,194,21,173,254894,121
DE-SN,14-04-2020,RKI,2,2,0,1586822400000,14626,Görlitz,196,21,175,254894,121
DE-SN,15-04-2020,RKI,5,5,0,1586908800000,14626,Görlitz,201,21,180,254894,121
DE-SN,16-04-2020,RKI,5,4,1,1586995200000,14626,Görlitz,206,22,184,254894,121
DE-SN,17-04-2020,RKI,0,0,0,1587081600000,14626,Görlitz,206,22,184,254894,121
DE-SN,18-04-2020,RKI,2,2,0,1587168000000,14626,Görlitz,208,22,186,254894,121
DE-SN,20-04-2020,RKI,4,4,0,1587340800000,14626,Görlitz,212,22,190,254894,121
DE-SN,22-04-2020,RKI,1,1,0,1587513600000,14626,Görlitz,213,22,191,254894,121
DE-SN,23-04-2020,RKI,0,0,0,1587600000000,14626,Görlitz,213,22,191,254894,121
DE-SN,26-04-2020,RKI,0,0,0,1587859200000,14626,Görlitz,213,22,191,254894,121
DE-SN,27-04-2020,RKI,2,2,0,1587945600000,14626,Görlitz,215,22,193,254894,121
DE-SN,28-04-2020,RKI,0,0,0,1588032000000,14626,Görlitz,215,22,193,254894,121
DE-SN,29-04-2020,RKI,3,3,0,1588118400000,14626,Görlitz,218,22,196,254894,121
DE-SN,01-05-2020,RKI,1,1,0,1588291200000,14626,Görlitz,219,22,197,254894,121
DE-SN,05-05-2020,RKI,1,0,1,1588636800000,14626,Görlitz,220,23,197,254894,121
DE-SN,27-05-2020,RKI,0,0,0,1590537600000,14626,Görlitz,220,23,197,254894,121
DE-SN,02-07-2020,RKI,0,0,0,1593648000000,14626,Görlitz,220,23,197,254894,121
DE-SN,14-07-2020,RKI,0,0,0,1594684800000,14626,Görlitz,220,23,197,254894,121
DE-SN,11-03-2020,RKI,1,1,0,1583884800000,14627,Meißen,2,0,2,242165,166
DE-SN,12-03-2020,RKI,0,0,0,1583971200000,14627,Meißen,2,0,2,242165,166
DE-SN,13-03-2020,RKI,3,3,0,1584057600000,14627,Meißen,5,0,5,242165,166
DE-SN,14-03-2020,RKI,0,0,0,1584144000000,14627,Meißen,5,0,5,242165,166
DE-SN,16-03-2020,RKI,1,1,0,1584316800000,14627,Meißen,6,0,6,242165,166
DE-SN,17-03-2020,RKI,1,1,0,1584403200000,14627,Meißen,7,0,7,242165,166
DE-SN,18-03-2020,RKI,3,3,0,1584489600000,14627,Meißen,10,0,10,242165,166
DE-SN,19-03-2020,RKI,0,0,0,1584576000000,14627,Meißen,10,0,10,242165,166
DE-SN,20-03-2020,RKI,3,3,0,1584662400000,14627,Meißen,13,0,13,242165,166
DE-SN,21-03-2020,RKI,4,4,0,1584748800000,14627,Meißen,17,0,17,242165,166
DE-SN,23-03-2020,RKI,3,3,0,1584921600000,14627,Meißen,20,0,20,242165,166
DE-SN,24-03-2020,RKI,6,3,3,1585008000000,14627,Meißen,26,3,23,242165,166
DE-SN,25-03-2020,RKI,4,3,1,1585094400000,14627,Meißen,30,4,26,242165,166
DE-SN,26-03-2020,RKI,10,10,0,1585180800000,14627,Meißen,40,4,36,242165,166
DE-SN,27-03-2020,RKI,8,7,1,1585267200000,14627,Meißen,48,5,43,242165,166
DE-SN,28-03-2020,RKI,5,5,0,1585353600000,14627,Meißen,53,5,48,242165,166
DE-SN,29-03-2020,RKI,2,2,0,1585440000000,14627,Meißen,55,5,50,242165,166
DE-SN,30-03-2020,RKI,11,11,0,1585526400000,14627,Meißen,66,5,61,242165,166
DE-SN,31-03-2020,RKI,6,6,0,1585612800000,14627,Meißen,72,5,67,242165,166
DE-SN,01-04-2020,RKI,7,6,1,1585699200000,14627,Meißen,79,6,73,242165,166
DE-SN,02-04-2020,RKI,12,11,1,1585785600000,14627,Meißen,91,7,84,242165,166
DE-SN,03-04-2020,RKI,7,6,1,1585872000000,14627,Meißen,98,8,90,242165,166
DE-SN,04-04-2020,RKI,4,4,0,1585958400000,14627,Meißen,102,8,94,242165,166
DE-SN,05-04-2020,RKI,0,0,0,1586044800000,14627,Meißen,102,8,94,242165,166
DE-SN,06-04-2020,RKI,5,5,0,1586131200000,14627,Meißen,107,8,99,242165,166
DE-SN,07-04-2020,RKI,10,8,2,1586217600000,14627,Meißen,117,10,107,242165,166
DE-SN,08-04-2020,RKI,11,11,0,1586304000000,14627,Meißen,128,10,118,242165,166
DE-SN,09-04-2020,RKI,5,2,3,1586390400000,14627,Meißen,133,13,120,242165,166
DE-SN,10-04-2020,RKI,6,6,0,1586476800000,14627,Meißen,139,13,126,242165,166
DE-SN,11-04-2020,RKI,4,3,1,1586563200000,14627,Meißen,143,14,129,242165,166
DE-SN,12-04-2020,RKI,1,1,0,1586649600000,14627,Meißen,144,14,130,242165,166
DE-SN,15-04-2020,RKI,4,3,1,1586908800000,14627,Meißen,148,15,133,242165,166
DE-SN,16-04-2020,RKI,7,6,1,1586995200000,14627,Meißen,155,16,139,242165,166
DE-SN,17-04-2020,RKI,1,1,0,1587081600000,14627,Meißen,156,16,140,242165,166
DE-SN,18-04-2020,RKI,2,2,0,1587168000000,14627,Meißen,158,16,142,242165,166
DE-SN,20-04-2020,RKI,2,2,0,1587340800000,14627,Meißen,160,16,144,242165,166
DE-SN,21-04-2020,RKI,10,8,2,1587427200000,14627,Meißen,170,18,152,242165,166
DE-SN,23-04-2020,RKI,2,2,0,1587600000000,14627,Meißen,172,18,154,242165,166
DE-SN,24-04-2020,RKI,2,2,0,1587686400000,14627,Meißen,174,18,156,242165,166
DE-SN,25-04-2020,RKI,0,0,0,1587772800000,14627,Meißen,174,18,156,242165,166
DE-SN,27-04-2020,RKI,4,3,1,1587945600000,14627,Meißen,178,19,159,242165,166
DE-SN,30-04-2020,RKI,0,0,0,1588204800000,14627,Meißen,178,19,159,242165,166
DE-SN,05-05-2020,RKI,2,2,0,1588636800000,14627,Meißen,180,19,161,242165,166
DE-SN,09-05-2020,RKI,0,0,0,1588982400000,14627,Meißen,180,19,161,242165,166
DE-SN,11-05-2020,RKI,0,0,0,1589155200000,14627,Meißen,180,19,161,242165,166
DE-SN,13-05-2020,RKI,0,0,0,1589328000000,14627,Meißen,180,19,161,242165,166
DE-SN,14-05-2020,RKI,1,1,0,1589414400000,14627,Meißen,181,19,162,242165,166
DE-SN,15-05-2020,RKI,0,0,0,1589500800000,14627,Meißen,181,19,162,242165,166
DE-SN,19-05-2020,RKI,1,1,0,1589846400000,14627,Meißen,182,19,163,242165,166
DE-SN,02-06-2020,RKI,0,0,0,1591056000000,14627,Meißen,182,19,163,242165,166
DE-SN,06-06-2020,RKI,1,1,0,1591401600000,14627,Meißen,183,19,164,242165,166
DE-SN,08-06-2020,RKI,0,0,0,1591574400000,14627,Meißen,183,19,164,242165,166
DE-SN,09-06-2020,RKI,2,2,0,1591660800000,14627,Meißen,185,19,166,242165,166
DE-SN,11-06-2020,RKI,0,0,0,1591833600000,14627,Meißen,185,19,166,242165,166
DE-SN,10-07-2020,RKI,0,0,0,1594339200000,14627,Meißen,185,19,166,242165,166
DE-SN,14-07-2020,RKI,0,0,0,1594684800000,14627,Meißen,185,19,166,242165,166
DE-SN,10-03-2020,RKI,0,0,0,1583798400000,14628,Sächsische Schweiz-Osterzgebirge,0,0,0,245611,148
DE-SN,11-03-2020,RKI,1,1,0,1583884800000,14628,Sächsische Schweiz-Osterzgebirge,1,0,1,245611,148
DE-SN,12-03-2020,RKI,2,2,0,1583971200000,14628,Sächsische Schweiz-Osterzgebirge,3,0,3,245611,148
DE-SN,13-03-2020,RKI,3,3,0,1584057600000,14628,Sächsische Schweiz-Osterzgebirge,6,0,6,245611,148
DE-SN,14-03-2020,RKI,0,0,0,1584144000000,14628,Sächsische Schweiz-Osterzgebirge,6,0,6,245611,148
DE-SN,17-03-2020,RKI,0,0,0,1584403200000,14628,Sächsische Schweiz-Osterzgebirge,6,0,6,245611,148
DE-SN,18-03-2020,RKI,11,11,0,1584489600000,14628,Sächsische Schweiz-Osterzgebirge,17,0,17,245611,148
DE-SN,19-03-2020,RKI,8,8,0,1584576000000,14628,Sächsische Schweiz-Osterzgebirge,25,0,25,245611,148
DE-SN,20-03-2020,RKI,9,9,0,1584662400000,14628,Sächsische Schweiz-Osterzgebirge,34,0,34,245611,148
DE-SN,21-03-2020,RKI,6,6,0,1584748800000,14628,Sächsische Schweiz-Osterzgebirge,40,0,40,245611,148
DE-SN,22-03-2020,RKI,7,7,0,1584835200000,14628,Sächsische Schweiz-Osterzgebirge,47,0,47,245611,148
DE-SN,23-03-2020,RKI,16,16,0,1584921600000,14628,Sächsische Schweiz-Osterzgebirge,63,0,63,245611,148
DE-SN,24-03-2020,RKI,11,11,0,1585008000000,14628,Sächsische Schweiz-Osterzgebirge,74,0,74,245611,148
DE-SN,25-03-2020,RKI,15,15,0,1585094400000,14628,Sächsische Schweiz-Osterzgebirge,89,0,89,245611,148
DE-SN,26-03-2020,RKI,9,9,0,1585180800000,14628,Sächsische Schweiz-Osterzgebirge,98,0,98,245611,148
DE-SN,27-03-2020,RKI,14,14,0,1585267200000,14628,Sächsische Schweiz-Osterzgebirge,112,0,112,245611,148
DE-SN,28-03-2020,RKI,10,10,0,1585353600000,14628,Sächsische Schweiz-Osterzgebirge,122,0,122,245611,148
DE-SN,29-03-2020,RKI,6,6,0,1585440000000,14628,Sächsische Schweiz-Osterzgebirge,128,0,128,245611,148
DE-SN,30-03-2020,RKI,25,24,1,1585526400000,14628,Sächsische Schweiz-Osterzgebirge,153,1,152,245611,148
DE-SN,31-03-2020,RKI,14,14,0,1585612800000,14628,Sächsische Schweiz-Osterzgebirge,167,1,166,245611,148
DE-SN,01-04-2020,RKI,10,10,0,1585699200000,14628,Sächsische Schweiz-Osterzgebirge,177,1,176,245611,148
DE-SN,02-04-2020,RKI,9,9,0,1585785600000,14628,Sächsische Schweiz-Osterzgebirge,186,1,185,245611,148
DE-SN,03-04-2020,RKI,8,8,0,1585872000000,14628,Sächsische Schweiz-Osterzgebirge,194,1,193,245611,148
DE-SN,04-04-2020,RKI,12,12,0,1585958400000,14628,Sächsische Schweiz-Osterzgebirge,206,1,205,245611,148
DE-SN,05-04-2020,RKI,13,13,0,1586044800000,14628,Sächsische Schweiz-Osterzgebirge,219,1,218,245611,148
DE-SN,06-04-2020,RKI,5,5,0,1586131200000,14628,Sächsische Schweiz-Osterzgebirge,224,1,223,245611,148
DE-SN,07-04-2020,RKI,10,10,0,1586217600000,14628,Sächsische Schweiz-Osterzgebirge,234,1,233,245611,148
DE-SN,08-04-2020,RKI,8,8,0,1586304000000,14628,Sächsische Schweiz-Osterzgebirge,242,1,241,245611,148
DE-SN,09-04-2020,RKI,3,2,1,1586390400000,14628,Sächsische Schweiz-Osterzgebirge,245,2,243,245611,148
DE-SN,10-04-2020,RKI,2,2,0,1586476800000,14628,Sächsische Schweiz-Osterzgebirge,247,2,245,245611,148
DE-SN,11-04-2020,RKI,2,2,0,1586563200000,14628,Sächsische Schweiz-Osterzgebirge,249,2,247,245611,148
DE-SN,12-04-2020,RKI,3,3,0,1586649600000,14628,Sächsische Schweiz-Osterzgebirge,252,2,250,245611,148
DE-SN,13-04-2020,RKI,1,1,0,1586736000000,14628,Sächsische Schweiz-Osterzgebirge,253,2,251,245611,148
DE-SN,14-04-2020,RKI,3,3,0,1586822400000,14628,Sächsische Schweiz-Osterzgebirge,256,2,254,245611,148
DE-SN,15-04-2020,RKI,1,1,0,1586908800000,14628,Sächsische Schweiz-Osterzgebirge,257,2,255,245611,148
DE-SN,16-04-2020,RKI,7,7,0,1586995200000,14628,Sächsische Schweiz-Osterzgebirge,264,2,262,245611,148
DE-SN,18-04-2020,RKI,1,1,0,1587168000000,14628,Sächsische Schweiz-Osterzgebirge,265,2,263,245611,148
DE-SN,19-04-2020,RKI,0,0,0,1587254400000,14628,Sächsische Schweiz-Osterzgebirge,265,2,263,245611,148
DE-SN,20-04-2020,RKI,3,3,0,1587340800000,14628,Sächsische Schweiz-Osterzgebirge,268,2,266,245611,148
DE-SN,21-04-2020,RKI,0,0,0,1587427200000,14628,Sächsische Schweiz-Osterzgebirge,268,2,266,245611,148
DE-SN,22-04-2020,RKI,3,3,0,1587513600000,14628,Sächsische Schweiz-Osterzgebirge,271,2,269,245611,148
DE-SN,23-04-2020,RKI,3,3,0,1587600000000,14628,Sächsische Schweiz-Osterzgebirge,274,2,272,245611,148
DE-SN,24-04-2020,RKI,1,1,0,1587686400000,14628,Sächsische Schweiz-Osterzgebirge,275,2,273,245611,148
DE-SN,28-04-2020,RKI,2,2,0,1588032000000,14628,Sächsische Schweiz-Osterzgebirge,277,2,275,245611,148
DE-SN,02-05-2020,RKI,0,0,0,1588377600000,14628,Sächsische Schweiz-Osterzgebirge,277,2,275,245611,148
DE-SN,05-05-2020,RKI,2,2,0,1588636800000,14628,Sächsische Schweiz-Osterzgebirge,279,2,277,245611,148
DE-SN,07-05-2020,RKI,2,2,0,1588809600000,14628,Sächsische Schweiz-Osterzgebirge,281,2,279,245611,148
DE-SN,08-05-2020,RKI,3,3,0,1588896000000,14628,Sächsische Schweiz-Osterzgebirge,284,2,282,245611,148
DE-SN,11-05-2020,RKI,1,1,0,1589155200000,14628,Sächsische Schweiz-Osterzgebirge,285,2,283,245611,148
DE-SN,12-05-2020,RKI,1,1,0,1589241600000,14628,Sächsische Schweiz-Osterzgebirge,286,2,284,245611,148
DE-SN,13-05-2020,RKI,2,2,0,1589328000000,14628,Sächsische Schweiz-Osterzgebirge,288,2,286,245611,148
DE-SN,14-05-2020,RKI,3,3,0,1589414400000,14628,Sächsische Schweiz-Osterzgebirge,291,2,289,245611,148
DE-SN,15-05-2020,RKI,1,1,0,1589500800000,14628,Sächsische Schweiz-Osterzgebirge,292,2,290,245611,148
DE-SN,16-05-2020,RKI,3,3,0,1589587200000,14628,Sächsische Schweiz-Osterzgebirge,295,2,293,245611,148
DE-SN,17-05-2020,RKI,0,0,0,1589673600000,14628,Sächsische Schweiz-Osterzgebirge,295,2,293,245611,148
DE-SN,18-05-2020,RKI,1,1,0,1589760000000,14628,Sächsische Schweiz-Osterzgebirge,296,2,294,245611,148
DE-SN,19-05-2020,RKI,11,11,0,1589846400000,14628,Sächsische Schweiz-Osterzgebirge,307,2,305,245611,148
DE-SN,20-05-2020,RKI,3,3,0,1589932800000,14628,Sächsische Schweiz-Osterzgebirge,310,2,308,245611,148
DE-SN,25-05-2020,RKI,0,0,0,1590364800000,14628,Sächsische Schweiz-Osterzgebirge,310,2,308,245611,148
DE-SN,26-05-2020,RKI,0,0,0,1590451200000,14628,Sächsische Schweiz-Osterzgebirge,310,2,308,245611,148
DE-SN,27-05-2020,RKI,0,0,0,1590537600000,14628,Sächsische Schweiz-Osterzgebirge,310,2,308,245611,148
DE-SN,04-06-2020,RKI,0,0,0,1591228800000,14628,Sächsische Schweiz-Osterzgebirge,310,2,308,245611,148
DE-SN,12-06-2020,RKI,1,1,0,1591920000000,14628,Sächsische Schweiz-Osterzgebirge,311,2,309,245611,148
DE-SN,03-07-2020,RKI,0,0,0,1593734400000,14628,Sächsische Schweiz-Osterzgebirge,311,2,309,245611,148
DE-SN,14-07-2020,RKI,0,0,0,1594684800000,14628,Sächsische Schweiz-Osterzgebirge,311,2,309,245611,148
DE-SN,08-03-2020,RKI,0,0,0,1583625600000,14713,Leipzig,0,0,0,587857,1974
DE-SN,10-03-2020,RKI,1,1,0,1583798400000,14713,Leipzig,1,0,1,587857,1974
DE-SN,11-03-2020,RKI,1,1,0,1583884800000,14713,Leipzig,2,0,2,587857,1974
DE-SN,12-03-2020,RKI,9,9,0,1583971200000,14713,Leipzig,11,0,11,587857,1974
DE-SN,13-03-2020,RKI,2,2,0,1584057600000,14713,Leipzig,13,0,13,587857,1974
DE-SN,14-03-2020,RKI,11,11,0,1584144000000,14713,Leipzig,24,0,24,587857,1974
DE-SN,15-03-2020,RKI,9,9,0,1584230400000,14713,Leipzig,33,0,33,587857,1974
DE-SN,16-03-2020,RKI,12,12,0,1584316800000,14713,Leipzig,45,0,45,587857,1974
DE-SN,17-03-2020,RKI,18,18,0,1584403200000,14713,Leipzig,63,0,63,587857,1974
DE-SN,18-03-2020,RKI,16,16,0,1584489600000,14713,Leipzig,79,0,79,587857,1974
DE-SN,19-03-2020,RKI,18,18,0,1584576000000,14713,Leipzig,97,0,97,587857,1974
DE-SN,20-03-2020,RKI,19,19,0,1584662400000,14713,Leipzig,116,0,116,587857,1974
DE-SN,21-03-2020,RKI,10,10,0,1584748800000,14713,Leipzig,126,0,126,587857,1974
DE-SN,22-03-2020,RKI,13,13,0,1584835200000,14713,Leipzig,139,0,139,587857,1974
DE-SN,23-03-2020,RKI,18,18,0,1584921600000,14713,Leipzig,157,0,157,587857,1974
DE-SN,24-03-2020,RKI,15,15,0,1585008000000,14713,Leipzig,172,0,172,587857,1974
DE-SN,25-03-2020,RKI,28,27,1,1585094400000,14713,Leipzig,200,1,199,587857,1974
DE-SN,26-03-2020,RKI,21,21,0,1585180800000,14713,Leipzig,221,1,220,587857,1974
DE-SN,27-03-2020,RKI,18,18,0,1585267200000,14713,Leipzig,239,1,238,587857,1974
DE-SN,28-03-2020,RKI,16,16,0,1585353600000,14713,Leipzig,255,1,254,587857,1974
DE-SN,29-03-2020,RKI,11,11,0,1585440000000,14713,Leipzig,266,1,265,587857,1974
DE-SN,30-03-2020,RKI,20,18,2,1585526400000,14713,Leipzig,286,3,283,587857,1974
DE-SN,31-03-2020,RKI,17,17,0,1585612800000,14713,Leipzig,303,3,300,587857,1974
DE-SN,01-04-2020,RKI,17,16,1,1585699200000,14713,Leipzig,320,4,316,587857,1974
DE-SN,02-04-2020,RKI,16,16,0,1585785600000,14713,Leipzig,336,4,332,587857,1974
DE-SN,03-04-2020,RKI,28,28,0,1585872000000,14713,Leipzig,364,4,360,587857,1974
DE-SN,04-04-2020,RKI,16,14,2,1585958400000,14713,Leipzig,380,6,374,587857,1974
DE-SN,05-04-2020,RKI,9,9,0,1586044800000,14713,Leipzig,389,6,383,587857,1974
DE-SN,06-04-2020,RKI,5,5,0,1586131200000,14713,Leipzig,394,6,388,587857,1974
DE-SN,07-04-2020,RKI,10,10,0,1586217600000,14713,Leipzig,404,6,398,587857,1974
DE-SN,08-04-2020,RKI,5,4,1,1586304000000,14713,Leipzig,409,7,402,587857,1974
DE-SN,09-04-2020,RKI,9,9,0,1586390400000,14713,Leipzig,418,7,411,587857,1974
DE-SN,10-04-2020,RKI,10,8,2,1586476800000,14713,Leipzig,428,9,419,587857,1974
DE-SN,11-04-2020,RKI,6,6,0,1586563200000,14713,Leipzig,434,9,425,587857,1974
DE-SN,12-04-2020,RKI,6,5,1,1586649600000,14713,Leipzig,440,10,430,587857,1974
DE-SN,13-04-2020,RKI,2,2,0,1586736000000,14713,Leipzig,442,10,432,587857,1974
DE-SN,14-04-2020,RKI,3,3,0,1586822400000,14713,Leipzig,445,10,435,587857,1974
DE-SN,15-04-2020,RKI,3,3,0,1586908800000,14713,Leipzig,448,10,438,587857,1974
DE-SN,16-04-2020,RKI,16,15,1,1586995200000,14713,Leipzig,464,11,453,587857,1974
DE-SN,17-04-2020,RKI,3,3,0,1587081600000,14713,Leipzig,467,11,456,587857,1974
DE-SN,18-04-2020,RKI,3,3,0,1587168000000,14713,Leipzig,470,11,459,587857,1974
DE-SN,19-04-2020,RKI,4,4,0,1587254400000,14713,Leipzig,474,11,463,587857,1974
DE-SN,20-04-2020,RKI,1,1,0,1587340800000,14713,Leipzig,475,11,464,587857,1974
DE-SN,21-04-2020,RKI,2,1,1,1587427200000,14713,Leipzig,477,12,465,587857,1974
DE-SN,22-04-2020,RKI,4,4,0,1587513600000,14713,Leipzig,481,12,469,587857,1974
DE-SN,23-04-2020,RKI,2,2,0,1587600000000,14713,Leipzig,483,12,471,587857,1974
DE-SN,24-04-2020,RKI,3,3,0,1587686400000,14713,Leipzig,486,12,474,587857,1974
DE-SN,25-04-2020,RKI,6,6,0,1587772800000,14713,Leipzig,492,12,480,587857,1974
DE-SN,27-04-2020,RKI,5,5,0,1587945600000,14713,Leipzig,497,12,485,587857,1974
DE-SN,28-04-2020,RKI,7,7,0,1588032000000,14713,Leipzig,504,12,492,587857,1974
DE-SN,29-04-2020,RKI,2,2,0,1588118400000,14713,Leipzig,506,12,494,587857,1974
DE-SN,30-04-2020,RKI,1,1,0,1588204800000,14713,Leipzig,507,12,495,587857,1974
DE-SN,01-05-2020,RKI,2,2,0,1588291200000,14713,Leipzig,509,12,497,587857,1974
DE-SN,02-05-2020,RKI,1,1,0,1588377600000,14713,Leipzig,510,12,498,587857,1974
DE-SN,05-05-2020,RKI,1,1,0,1588636800000,14713,Leipzig,511,12,499,587857,1974
DE-SN,06-05-2020,RKI,2,2,0,1588723200000,14713,Leipzig,513,12,501,587857,1974
DE-SN,07-05-2020,RKI,3,3,0,1588809600000,14713,Leipzig,516,12,504,587857,1974
DE-SN,08-05-2020,RKI,3,3,0,1588896000000,14713,Leipzig,519,12,507,587857,1974
DE-SN,09-05-2020,RKI,0,0,0,1588982400000,14713,Leipzig,519,12,507,587857,1974
DE-SN,10-05-2020,RKI,0,0,0,1589068800000,14713,Leipzig,519,12,507,587857,1974
DE-SN,11-05-2020,RKI,1,1,0,1589155200000,14713,Leipzig,520,12,508,587857,1974
DE-SN,12-05-2020,RKI,0,0,0,1589241600000,14713,Leipzig,520,12,508,587857,1974
DE-SN,13-05-2020,RKI,1,1,0,1589328000000,14713,Leipzig,521,12,509,587857,1974
DE-SN,14-05-2020,RKI,2,2,0,1589414400000,14713,Leipzig,523,12,511,587857,1974
DE-SN,15-05-2020,RKI,0,0,0,1589500800000,14713,Leipzig,523,12,511,587857,1974
DE-SN,26-05-2020,RKI,0,0,0,1590451200000,14713,Leipzig,523,12,511,587857,1974
DE-SN,29-05-2020,RKI,0,0,0,1590710400000,14713,Leipzig,523,12,511,587857,1974
DE-SN,02-06-2020,RKI,0,0,0,1591056000000,14713,Leipzig,523,12,511,587857,1974
DE-SN,16-06-2020,RKI,0,0,0,1592265600000,14713,Leipzig,523,12,511,587857,1974
DE-SN,17-06-2020,RKI,1,1,0,1592352000000,14713,Leipzig,524,12,512,587857,1974
DE-SN,18-06-2020,RKI,2,2,0,1592438400000,14713,Leipzig,526,12,514,587857,1974
DE-SN,19-06-2020,RKI,4,4,0,1592524800000,14713,Leipzig,530,12,518,587857,1974
DE-SN,22-06-2020,RKI,3,2,0,1592784000000,14713,Leipzig,533,12,520,587857,1974
DE-SN,23-06-2020,RKI,1,1,0,1592870400000,14713,Leipzig,534,12,521,587857,1974
DE-SN,29-06-2020,RKI,2,0,0,1593388800000,14713,Leipzig,536,12,521,587857,1974
DE-SN,30-06-2020,RKI,2,0,0,1593475200000,14713,Leipzig,538,12,521,587857,1974
DE-SN,01-07-2020,RKI,0,0,0,1593561600000,14713,Leipzig,538,12,521,587857,1974
DE-SN,02-07-2020,RKI,0,0,0,1593648000000,14713,Leipzig,538,12,521,587857,1974
DE-SN,03-07-2020,RKI,0,0,0,1593734400000,14713,Leipzig,538,12,521,587857,1974
DE-SN,06-07-2020,RKI,3,0,0,1593993600000,14713,Leipzig,541,12,521,587857,1974
DE-SN,07-07-2020,RKI,0,0,0,1594080000000,14713,Leipzig,541,12,521,587857,1974
DE-SN,09-07-2020,RKI,2,0,0,1594252800000,14713,Leipzig,543,12,521,587857,1974
DE-SN,15-07-2020,RKI,0,0,0,1594771200000,14713,Leipzig,543,12,521,587857,1974
DE-SN,10-03-2020,RKI,0,0,0,1583798400000,14729,Leipzig,2,0,2,257763,156
DE-SN,11-03-2020,RKI,3,3,0,1583884800000,14729,Leipzig,5,0,5,257763,156
DE-SN,12-03-2020,RKI,0,0,0,1583971200000,14729,Leipzig,5,0,5,257763,156
DE-SN,13-03-2020,RKI,0,0,0,1584057600000,14729,Leipzig,5,0,5,257763,156
DE-SN,16-03-2020,RKI,4,4,0,1584316800000,14729,Leipzig,9,0,9,257763,156
DE-SN,17-03-2020,RKI,2,2,0,1584403200000,14729,Leipzig,11,0,11,257763,156
DE-SN,18-03-2020,RKI,1,1,0,1584489600000,14729,Leipzig,12,0,12,257763,156
DE-SN,19-03-2020,RKI,5,5,0,1584576000000,14729,Leipzig,17,0,17,257763,156
DE-SN,20-03-2020,RKI,3,3,0,1584662400000,14729,Leipzig,20,0,20,257763,156
DE-SN,21-03-2020,RKI,4,4,0,1584748800000,14729,Leipzig,24,0,24,257763,156
DE-SN,23-03-2020,RKI,11,11,0,1584921600000,14729,Leipzig,35,0,35,257763,156
DE-SN,24-03-2020,RKI,0,0,0,1585008000000,14729,Leipzig,35,0,35,257763,156
DE-SN,25-03-2020,RKI,12,12,0,1585094400000,14729,Leipzig,47,0,47,257763,156
DE-SN,26-03-2020,RKI,5,4,1,1585180800000,14729,Leipzig,52,1,51,257763,156
DE-SN,27-03-2020,RKI,11,10,1,1585267200000,14729,Leipzig,63,2,61,257763,156
DE-SN,28-03-2020,RKI,7,7,0,1585353600000,14729,Leipzig,70,2,68,257763,156
DE-SN,29-03-2020,RKI,0,0,0,1585440000000,14729,Leipzig,70,2,68,257763,156
DE-SN,31-03-2020,RKI,6,5,1,1585612800000,14729,Leipzig,76,3,73,257763,156
DE-SN,01-04-2020,RKI,12,12,0,1585699200000,14729,Leipzig,88,3,85,257763,156
DE-SN,02-04-2020,RKI,4,3,1,1585785600000,14729,Leipzig,92,4,88,257763,156
DE-SN,03-04-2020,RKI,7,7,0,1585872000000,14729,Leipzig,99,4,95,257763,156
DE-SN,04-04-2020,RKI,5,5,0,1585958400000,14729,Leipzig,104,4,100,257763,156
DE-SN,05-04-2020,RKI,2,2,0,1586044800000,14729,Leipzig,106,4,102,257763,156
DE-SN,06-04-2020,RKI,4,4,0,1586131200000,14729,Leipzig,110,4,106,257763,156
DE-SN,07-04-2020,RKI,7,7,0,1586217600000,14729,Leipzig,117,4,113,257763,156
DE-SN,08-04-2020,RKI,0,0,0,1586304000000,14729,Leipzig,117,4,113,257763,156
DE-SN,09-04-2020,RKI,22,22,0,1586390400000,14729,Leipzig,139,4,135,257763,156
DE-SN,10-04-2020,RKI,4,4,0,1586476800000,14729,Leipzig,143,4,139,257763,156
DE-SN,11-04-2020,RKI,0,0,0,1586563200000,14729,Leipzig,143,4,139,257763,156
DE-SN,12-04-2020,RKI,0,0,0,1586649600000,14729,Leipzig,143,4,139,257763,156
DE-SN,14-04-2020,RKI,1,1,0,1586822400000,14729,Leipzig,144,4,140,257763,156
DE-SN,16-04-2020,RKI,0,0,0,1586995200000,14729,Leipzig,144,4,140,257763,156
DE-SN,17-04-2020,RKI,0,0,0,1587081600000,14729,Leipzig,144,4,140,257763,156
DE-SN,20-04-2020,RKI,0,0,0,1587340800000,14729,Leipzig,144,4,140,257763,156
DE-SN,21-04-2020,RKI,2,2,0,1587427200000,14729,Leipzig,146,4,142,257763,156
DE-SN,22-04-2020,RKI,0,0,0,1587513600000,14729,Leipzig,146,4,142,257763,156
DE-SN,28-04-2020,RKI,0,0,0,1588032000000,14729,Leipzig,146,4,142,257763,156
DE-SN,29-04-2020,RKI,0,0,0,1588118400000,14729,Leipzig,146,4,142,257763,156
DE-SN,06-05-2020,RKI,0,0,0,1588723200000,14729,Leipzig,146,4,142,257763,156
DE-SN,07-05-2020,RKI,0,0,0,1588809600000,14729,Leipzig,146,4,142,257763,156
DE-SN,12-05-2020,RKI,1,1,0,1589241600000,14729,Leipzig,147,4,143,257763,156
DE-SN,14-05-2020,RKI,0,0,0,1589414400000,14729,Leipzig,147,4,143,257763,156
DE-SN,27-05-2020,RKI,0,0,0,1590537600000,14729,Leipzig,147,4,143,257763,156
DE-SN,09-06-2020,RKI,0,0,0,1591660800000,14729,Leipzig,147,4,143,257763,156
DE-SN,10-06-2020,RKI,0,0,0,1591747200000,14729,Leipzig,147,4,143,257763,156
DE-SN,23-06-2020,RKI,0,0,0,1592870400000,14729,Leipzig,147,4,143,257763,156
DE-SN,10-07-2020,RKI,0,0,0,1594339200000,14729,Leipzig,147,4,143,257763,156
DE-SN,13-03-2020,RKI,0,0,0,1584057600000,14730,Nordsachsen,1,0,1,197673,97
DE-SN,17-03-2020,RKI,0,0,0,1584403200000,14730,Nordsachsen,1,0,1,197673,97
DE-SN,18-03-2020,RKI,6,6,0,1584489600000,14730,Nordsachsen,7,0,7,197673,97
DE-SN,19-03-2020,RKI,1,1,0,1584576000000,14730,Nordsachsen,8,0,8,197673,97
DE-SN,20-03-2020,RKI,2,2,0,1584662400000,14730,Nordsachsen,10,0,10,197673,97
DE-SN,21-03-2020,RKI,0,0,0,1584748800000,14730,Nordsachsen,10,0,10,197673,97
DE-SN,22-03-2020,RKI,1,1,0,1584835200000,14730,Nordsachsen,11,0,11,197673,97
DE-SN,24-03-2020,RKI,1,1,0,1585008000000,14730,Nordsachsen,12,0,12,197673,97
DE-SN,25-03-2020,RKI,3,3,0,1585094400000,14730,Nordsachsen,15,0,15,197673,97
DE-SN,27-03-2020,RKI,5,5,0,1585267200000,14730,Nordsachsen,20,0,20,197673,97
DE-SN,28-03-2020,RKI,2,2,0,1585353600000,14730,Nordsachsen,22,0,22,197673,97
DE-SN,31-03-2020,RKI,3,3,0,1585612800000,14730,Nordsachsen,25,0,25,197673,97
DE-SN,01-04-2020,RKI,15,15,0,1585699200000,14730,Nordsachsen,40,0,40,197673,97
DE-SN,02-04-2020,RKI,2,2,0,1585785600000,14730,Nordsachsen,42,0,42,197673,97
DE-SN,03-04-2020,RKI,12,12,0,1585872000000,14730,Nordsachsen,54,0,54,197673,97
DE-SN,04-04-2020,RKI,1,1,0,1585958400000,14730,Nordsachsen,55,0,55,197673,97
DE-SN,05-04-2020,RKI,0,0,0,1586044800000,14730,Nordsachsen,55,0,55,197673,97
DE-SN,06-04-2020,RKI,0,0,0,1586131200000,14730,Nordsachsen,55,0,55,197673,97
DE-SN,07-04-2020,RKI,13,13,0,1586217600000,14730,Nordsachsen,68,0,68,197673,97
DE-SN,08-04-2020,RKI,2,2,0,1586304000000,14730,Nordsachsen,70,0,70,197673,97
DE-SN,09-04-2020,RKI,1,1,0,1586390400000,14730,Nordsachsen,71,0,71,197673,97
DE-SN,10-04-2020,RKI,5,5,0,1586476800000,14730,Nordsachsen,76,0,76,197673,97
DE-SN,11-04-2020,RKI,1,1,0,1586563200000,14730,Nordsachsen,77,0,77,197673,97
DE-SN,14-04-2020,RKI,7,7,0,1586822400000,14730,Nordsachsen,84,0,84,197673,97
DE-SN,15-04-2020,RKI,1,1,0,1586908800000,14730,Nordsachsen,85,0,85,197673,97
DE-SN,16-04-2020,RKI,1,1,0,1586995200000,14730,Nordsachsen,86,0,86,197673,97
DE-SN,17-04-2020,RKI,3,3,0,1587081600000,14730,Nordsachsen,89,0,89,197673,97
DE-SN,18-04-2020,RKI,0,0,0,1587168000000,14730,Nordsachsen,89,0,89,197673,97
DE-SN,19-04-2020,RKI,0,0,0,1587254400000,14730,Nordsachsen,89,0,89,197673,97
DE-SN,20-04-2020,RKI,0,0,0,1587340800000,14730,Nordsachsen,89,0,89,197673,97
DE-SN,21-04-2020,RKI,1,1,0,1587427200000,14730,Nordsachsen,90,0,90,197673,97
DE-SN,22-04-2020,RKI,0,0,0,1587513600000,14730,Nordsachsen,90,0,90,197673,97
DE-SN,23-04-2020,RKI,3,3,0,1587600000000,14730,Nordsachsen,93,0,93,197673,97
DE-SN,24-04-2020,RKI,0,0,0,1587686400000,14730,Nordsachsen,93,0,93,197673,97
DE-SN,28-04-2020,RKI,0,0,0,1588032000000,14730,Nordsachsen,93,0,93,197673,97
DE-SN,30-04-2020,RKI,0,0,0,1588204800000,14730,Nordsachsen,93,0,93,197673,97
DE-SN,05-05-2020,RKI,1,1,0,1588636800000,14730,Nordsachsen,94,0,94,197673,97
DE-SN,12-05-2020,RKI,0,0,0,1589241600000,14730,Nordsachsen,94,0,94,197673,97
DE-SN,20-05-2020,RKI,0,0,0,1589932800000,14730,Nordsachsen,94,0,94,197673,97
DE-SN,29-05-2020,RKI,0,0,0,1590710400000,14730,Nordsachsen,94,0,94,197673,97
DE-SN,23-06-2020,RKI,0,0,0,1592870400000,14730,Nordsachsen,94,0,94,197673,97
DE-SN,07-07-2020,RKI,0,0,0,1594080000000,14730,Nordsachsen,94,0,94,197673,97
DE-ST,17-03-2020,RKI,0,0,0,1584403200000,15001,Dessau-Roßlau,1,0,1,81237,332
DE-ST,18-03-2020,RKI,0,0,0,1584489600000,15001,Dessau-Roßlau,1,0,1,81237,332
DE-ST,19-03-2020,RKI,0,0,0,1584576000000,15001,Dessau-Roßlau,1,0,1,81237,332
DE-ST,20-03-2020,RKI,3,3,0,1584662400000,15001,Dessau-Roßlau,4,0,4,81237,332
DE-ST,21-03-2020,RKI,0,0,0,1584748800000,15001,Dessau-Roßlau,4,0,4,81237,332
DE-ST,23-03-2020,RKI,1,0,1,1584921600000,15001,Dessau-Roßlau,5,1,4,81237,332
DE-ST,24-03-2020,RKI,2,2,0,1585008000000,15001,Dessau-Roßlau,7,1,6,81237,332
DE-ST,25-03-2020,RKI,0,0,0,1585094400000,15001,Dessau-Roßlau,7,1,6,81237,332
DE-ST,27-03-2020,RKI,3,3,0,1585267200000,15001,Dessau-Roßlau,10,1,9,81237,332
DE-ST,02-04-2020,RKI,2,2,0,1585785600000,15001,Dessau-Roßlau,12,1,11,81237,332
DE-ST,03-04-2020,RKI,5,5,0,1585872000000,15001,Dessau-Roßlau,17,1,16,81237,332
DE-ST,04-04-2020,RKI,1,1,0,1585958400000,15001,Dessau-Roßlau,18,1,17,81237,332
DE-ST,05-04-2020,RKI,3,3,0,1586044800000,15001,Dessau-Roßlau,21,1,20,81237,332
DE-ST,07-04-2020,RKI,5,5,0,1586217600000,15001,Dessau-Roßlau,26,1,25,81237,332
DE-ST,09-04-2020,RKI,5,5,0,1586390400000,15001,Dessau-Roßlau,31,1,30,81237,332
DE-ST,11-04-2020,RKI,2,2,0,1586563200000,15001,Dessau-Roßlau,33,1,32,81237,332
DE-ST,12-04-2020,RKI,0,0,0,1586649600000,15001,Dessau-Roßlau,33,1,32,81237,332
DE-ST,15-04-2020,RKI,0,0,0,1586908800000,15001,Dessau-Roßlau,33,1,32,81237,332
DE-ST,16-04-2020,RKI,1,1,0,1586995200000,15001,Dessau-Roßlau,34,1,33,81237,332
DE-ST,17-04-2020,RKI,0,0,0,1587081600000,15001,Dessau-Roßlau,34,1,33,81237,332
DE-ST,18-04-2020,RKI,1,1,0,1587168000000,15001,Dessau-Roßlau,35,1,34,81237,332
DE-ST,20-04-2020,RKI,0,0,0,1587340800000,15001,Dessau-Roßlau,35,1,34,81237,332
DE-ST,25-04-2020,RKI,1,1,0,1587772800000,15001,Dessau-Roßlau,36,1,35,81237,332
DE-ST,28-04-2020,RKI,0,0,0,1588032000000,15001,Dessau-Roßlau,36,1,35,81237,332
DE-ST,30-04-2020,RKI,0,0,0,1588204800000,15001,Dessau-Roßlau,36,1,35,81237,332
DE-ST,25-05-2020,RKI,0,0,0,1590364800000,15001,Dessau-Roßlau,36,1,35,81237,332
DE-ST,11-03-2020,RKI,2,1,1,1583884800000,15002,Halle,3,1,2,239257,1772
DE-ST,12-03-2020,RKI,3,3,0,1583971200000,15002,Halle,6,1,5,239257,1772
DE-ST,13-03-2020,RKI,2,2,0,1584057600000,15002,Halle,8,1,7,239257,1772
DE-ST,14-03-2020,RKI,1,1,0,1584144000000,15002,Halle,9,1,8,239257,1772
DE-ST,16-03-2020,RKI,4,4,0,1584316800000,15002,Halle,13,1,12,239257,1772
DE-ST,17-03-2020,RKI,4,4,0,1584403200000,15002,Halle,17,1,16,239257,1772
DE-ST,18-03-2020,RKI,15,15,0,1584489600000,15002,Halle,32,1,31,239257,1772
DE-ST,19-03-2020,RKI,3,3,0,1584576000000,15002,Halle,35,1,34,239257,1772
DE-ST,20-03-2020,RKI,17,16,1,1584662400000,15002,Halle,52,2,50,239257,1772
DE-ST,21-03-2020,RKI,3,3,0,1584748800000,15002,Halle,55,2,53,239257,1772
DE-ST,22-03-2020,RKI,3,2,1,1584835200000,15002,Halle,58,3,55,239257,1772
DE-ST,23-03-2020,RKI,6,6,0,1584921600000,15002,Halle,64,3,61,239257,1772
DE-ST,24-03-2020,RKI,6,6,0,1585008000000,15002,Halle,70,3,67,239257,1772
DE-ST,25-03-2020,RKI,10,10,0,1585094400000,15002,Halle,80,3,77,239257,1772
DE-ST,26-03-2020,RKI,5,5,0,1585180800000,15002,Halle,85,3,82,239257,1772
DE-ST,27-03-2020,RKI,15,15,0,1585267200000,15002,Halle,100,3,97,239257,1772
DE-ST,28-03-2020,RKI,15,15,0,1585353600000,15002,Halle,115,3,112,239257,1772
DE-ST,29-03-2020,RKI,5,5,0,1585440000000,15002,Halle,120,3,117,239257,1772
DE-ST,30-03-2020,RKI,26,20,6,1585526400000,15002,Halle,146,9,137,239257,1772
DE-ST,31-03-2020,RKI,6,6,0,1585612800000,15002,Halle,152,9,143,239257,1772
DE-ST,01-04-2020,RKI,8,8,0,1585699200000,15002,Halle,160,9,151,239257,1772
DE-ST,02-04-2020,RKI,8,8,0,1585785600000,15002,Halle,168,9,159,239257,1772
DE-ST,03-04-2020,RKI,8,8,0,1585872000000,15002,Halle,176,9,167,239257,1772
DE-ST,04-04-2020,RKI,6,6,0,1585958400000,15002,Halle,182,9,173,239257,1772
DE-ST,05-04-2020,RKI,0,0,0,1586044800000,15002,Halle,182,9,173,239257,1772
DE-ST,06-04-2020,RKI,4,3,1,1586131200000,15002,Halle,186,10,176,239257,1772
DE-ST,07-04-2020,RKI,12,11,1,1586217600000,15002,Halle,198,11,187,239257,1772
DE-ST,08-04-2020,RKI,8,8,0,1586304000000,15002,Halle,206,11,195,239257,1772
DE-ST,09-04-2020,RKI,4,4,0,1586390400000,15002,Halle,210,11,199,239257,1772
DE-ST,10-04-2020,RKI,0,0,0,1586476800000,15002,Halle,210,11,199,239257,1772
DE-ST,11-04-2020,RKI,10,9,1,1586563200000,15002,Halle,220,12,208,239257,1772
DE-ST,12-04-2020,RKI,1,1,0,1586649600000,15002,Halle,221,12,209,239257,1772
DE-ST,13-04-2020,RKI,1,0,1,1586736000000,15002,Halle,222,13,209,239257,1772
DE-ST,14-04-2020,RKI,3,3,0,1586822400000,15002,Halle,225,13,212,239257,1772
DE-ST,15-04-2020,RKI,7,7,0,1586908800000,15002,Halle,232,13,219,239257,1772
DE-ST,16-04-2020,RKI,1,1,0,1586995200000,15002,Halle,233,13,220,239257,1772
DE-ST,17-04-2020,RKI,0,0,0,1587081600000,15002,Halle,233,13,220,239257,1772
DE-ST,18-04-2020,RKI,1,1,0,1587168000000,15002,Halle,234,13,221,239257,1772
DE-ST,19-04-2020,RKI,3,3,0,1587254400000,15002,Halle,237,13,224,239257,1772
DE-ST,20-04-2020,RKI,1,1,0,1587340800000,15002,Halle,238,13,225,239257,1772
DE-ST,21-04-2020,RKI,2,2,0,1587427200000,15002,Halle,240,13,227,239257,1772
DE-ST,22-04-2020,RKI,3,3,0,1587513600000,15002,Halle,243,13,230,239257,1772
DE-ST,23-04-2020,RKI,11,10,1,1587600000000,15002,Halle,254,14,240,239257,1772
DE-ST,24-04-2020,RKI,2,2,0,1587686400000,15002,Halle,256,14,242,239257,1772
DE-ST,25-04-2020,RKI,4,4,0,1587772800000,15002,Halle,260,14,246,239257,1772
DE-ST,26-04-2020,RKI,1,1,0,1587859200000,15002,Halle,261,14,247,239257,1772
DE-ST,28-04-2020,RKI,0,0,0,1588032000000,15002,Halle,261,14,247,239257,1772
DE-ST,29-04-2020,RKI,10,10,0,1588118400000,15002,Halle,271,14,257,239257,1772
DE-ST,01-05-2020,RKI,2,2,0,1588291200000,15002,Halle,273,14,259,239257,1772
DE-ST,05-05-2020,RKI,0,0,0,1588636800000,15002,Halle,273,14,259,239257,1772
DE-ST,07-05-2020,RKI,4,4,0,1588809600000,15002,Halle,277,14,263,239257,1772
DE-ST,08-05-2020,RKI,5,5,0,1588896000000,15002,Halle,282,14,268,239257,1772
DE-ST,09-05-2020,RKI,1,1,0,1588982400000,15002,Halle,283,14,269,239257,1772
DE-ST,10-05-2020,RKI,0,0,0,1589068800000,15002,Halle,283,14,269,239257,1772
DE-ST,11-05-2020,RKI,0,0,0,1589155200000,15002,Halle,283,14,269,239257,1772
DE-ST,12-05-2020,RKI,2,2,0,1589241600000,15002,Halle,285,14,271,239257,1772
DE-ST,13-05-2020,RKI,2,2,0,1589328000000,15002,Halle,287,14,273,239257,1772
DE-ST,14-05-2020,RKI,1,1,0,1589414400000,15002,Halle,288,14,274,239257,1772
DE-ST,16-05-2020,RKI,0,0,0,1589587200000,15002,Halle,288,14,274,239257,1772
DE-ST,30-05-2020,RKI,1,1,0,1590796800000,15002,Halle,289,14,275,239257,1772
DE-ST,02-06-2020,RKI,1,1,0,1591056000000,15002,Halle,290,14,276,239257,1772
DE-ST,05-06-2020,RKI,0,0,0,1591315200000,15002,Halle,290,14,276,239257,1772
DE-ST,09-06-2020,RKI,0,0,0,1591660800000,15002,Halle,290,14,276,239257,1772
DE-ST,10-06-2020,RKI,0,0,0,1591747200000,15002,Halle,290,14,276,239257,1772
DE-ST,13-06-2020,RKI,0,0,0,1592006400000,15002,Halle,290,14,276,239257,1772
DE-ST,14-06-2020,RKI,0,0,0,1592092800000,15002,Halle,290,14,276,239257,1772
DE-ST,16-06-2020,RKI,1,1,0,1592265600000,15002,Halle,291,14,277,239257,1772
DE-ST,21-06-2020,RKI,0,0,0,1592697600000,15002,Halle,291,14,277,239257,1772
DE-ST,24-06-2020,RKI,0,0,0,1592956800000,15002,Halle,291,14,277,239257,1772
DE-ST,26-06-2020,RKI,0,0,0,1593129600000,15002,Halle,291,14,277,239257,1772
DE-ST,28-06-2020,RKI,0,0,0,1593302400000,15002,Halle,291,14,277,239257,1772
DE-ST,05-07-2020,RKI,0,0,0,1593907200000,15002,Halle,291,14,277,239257,1772
DE-ST,07-07-2020,RKI,0,0,0,1594080000000,15002,Halle,291,14,277,239257,1772
DE-ST,15-07-2020,RKI,0,0,0,1594771200000,15002,Halle,291,14,277,239257,1772
DE-ST,11-03-2020,RKI,2,2,0,1583884800000,15003,Magdeburg,2,0,2,238697,1188
DE-ST,12-03-2020,RKI,1,1,0,1583971200000,15003,Magdeburg,3,0,3,238697,1188
DE-ST,13-03-2020,RKI,3,3,0,1584057600000,15003,Magdeburg,6,0,6,238697,1188
DE-ST,16-03-2020,RKI,3,3,0,1584316800000,15003,Magdeburg,9,0,9,238697,1188
DE-ST,17-03-2020,RKI,3,3,0,1584403200000,15003,Magdeburg,12,0,12,238697,1188
DE-ST,18-03-2020,RKI,6,6,0,1584489600000,15003,Magdeburg,18,0,18,238697,1188
DE-ST,19-03-2020,RKI,1,1,0,1584576000000,15003,Magdeburg,19,0,19,238697,1188
DE-ST,20-03-2020,RKI,9,9,0,1584662400000,15003,Magdeburg,28,0,28,238697,1188
DE-ST,23-03-2020,RKI,11,10,1,1584921600000,15003,Magdeburg,39,1,38,238697,1188
DE-ST,24-03-2020,RKI,4,4,0,1585008000000,15003,Magdeburg,43,1,42,238697,1188
DE-ST,25-03-2020,RKI,2,2,0,1585094400000,15003,Magdeburg,45,1,44,238697,1188
DE-ST,26-03-2020,RKI,6,6,0,1585180800000,15003,Magdeburg,51,1,50,238697,1188
DE-ST,27-03-2020,RKI,5,5,0,1585267200000,15003,Magdeburg,56,1,55,238697,1188
DE-ST,30-03-2020,RKI,6,6,0,1585526400000,15003,Magdeburg,62,1,61,238697,1188
DE-ST,31-03-2020,RKI,4,4,0,1585612800000,15003,Magdeburg,66,1,65,238697,1188
DE-ST,01-04-2020,RKI,2,2,0,1585699200000,15003,Magdeburg,68,1,67,238697,1188
DE-ST,03-04-2020,RKI,0,0,0,1585872000000,15003,Magdeburg,68,1,67,238697,1188
DE-ST,06-04-2020,RKI,0,0,0,1586131200000,15003,Magdeburg,68,1,67,238697,1188
DE-ST,07-04-2020,RKI,0,0,0,1586217600000,15003,Magdeburg,68,1,67,238697,1188
DE-ST,08-04-2020,RKI,0,0,0,1586304000000,15003,Magdeburg,68,1,67,238697,1188
DE-ST,10-04-2020,RKI,0,0,0,1586476800000,15003,Magdeburg,68,1,67,238697,1188
DE-ST,11-04-2020,RKI,0,0,0,1586563200000,15003,Magdeburg,68,1,67,238697,1188
DE-ST,12-04-2020,RKI,0,0,0,1586649600000,15003,Magdeburg,68,1,67,238697,1188
DE-ST,13-04-2020,RKI,0,0,0,1586736000000,15003,Magdeburg,68,1,67,238697,1188
DE-ST,14-04-2020,RKI,0,0,0,1586822400000,15003,Magdeburg,68,1,67,238697,1188
DE-ST,15-04-2020,RKI,0,0,0,1586908800000,15003,Magdeburg,68,1,67,238697,1188
DE-ST,17-04-2020,RKI,2,2,0,1587081600000,15003,Magdeburg,70,1,69,238697,1188
DE-ST,19-04-2020,RKI,0,0,0,1587254400000,15003,Magdeburg,70,1,69,238697,1188
DE-ST,21-04-2020,RKI,0,0,0,1587427200000,15003,Magdeburg,70,1,69,238697,1188
DE-ST,25-04-2020,RKI,0,0,0,1587772800000,15003,Magdeburg,70,1,69,238697,1188
DE-ST,28-04-2020,RKI,0,0,0,1588032000000,15003,Magdeburg,70,1,69,238697,1188
DE-ST,02-05-2020,RKI,0,0,0,1588377600000,15003,Magdeburg,70,1,69,238697,1188
DE-ST,04-06-2020,RKI,1,1,0,1591228800000,15003,Magdeburg,71,1,70,238697,1188
DE-ST,07-06-2020,RKI,0,0,0,1591488000000,15003,Magdeburg,71,1,70,238697,1188
DE-ST,09-06-2020,RKI,6,6,0,1591660800000,15003,Magdeburg,77,1,76,238697,1188
DE-ST,10-06-2020,RKI,1,0,1,1591747200000,15003,Magdeburg,78,2,76,238697,1188
DE-ST,11-06-2020,RKI,2,2,0,1591833600000,15003,Magdeburg,80,2,78,238697,1188
DE-ST,12-06-2020,RKI,9,8,1,1591920000000,15003,Magdeburg,89,3,86,238697,1188
DE-ST,13-06-2020,RKI,8,8,0,1592006400000,15003,Magdeburg,97,3,94,238697,1188
DE-ST,14-06-2020,RKI,9,9,0,1592092800000,15003,Magdeburg,106,3,103,238697,1188
DE-ST,15-06-2020,RKI,5,5,0,1592179200000,15003,Magdeburg,111,3,108,238697,1188
DE-ST,16-06-2020,RKI,7,7,0,1592265600000,15003,Magdeburg,118,3,115,238697,1188
DE-ST,17-06-2020,RKI,18,18,0,1592352000000,15003,Magdeburg,136,3,133,238697,1188
DE-ST,18-06-2020,RKI,7,7,0,1592438400000,15003,Magdeburg,143,3,140,238697,1188
DE-ST,19-06-2020,RKI,19,19,0,1592524800000,15003,Magdeburg,162,3,159,238697,1188
DE-ST,20-06-2020,RKI,1,1,0,1592611200000,15003,Magdeburg,163,3,160,238697,1188
DE-ST,21-06-2020,RKI,6,6,0,1592697600000,15003,Magdeburg,169,3,166,238697,1188
DE-ST,22-06-2020,RKI,1,1,0,1592784000000,15003,Magdeburg,170,3,167,238697,1188
DE-ST,23-06-2020,RKI,0,0,0,1592870400000,15003,Magdeburg,170,3,167,238697,1188
DE-ST,24-06-2020,RKI,0,0,0,1592956800000,15003,Magdeburg,170,3,167,238697,1188
DE-ST,30-06-2020,RKI,0,0,0,1593475200000,15003,Magdeburg,170,3,167,238697,1188
DE-ST,02-07-2020,RKI,1,1,0,1593648000000,15003,Magdeburg,171,3,168,238697,1188
DE-ST,03-07-2020,RKI,2,2,0,1593734400000,15003,Magdeburg,173,3,170,238697,1188
DE-ST,05-07-2020,RKI,3,0,0,1593907200000,15003,Magdeburg,176,3,170,238697,1188
DE-ST,06-07-2020,RKI,2,0,0,1593993600000,15003,Magdeburg,178,3,170,238697,1188
DE-ST,12-07-2020,RKI,0,0,0,1594512000000,15003,Magdeburg,178,3,170,238697,1188
DE-ST,14-07-2020,RKI,3,0,0,1594684800000,15003,Magdeburg,181,3,170,238697,1188
DE-ST,15-07-2020,RKI,1,1,0,1594771200000,15003,Magdeburg,182,3,171,238697,1188
DE-ST,16-03-2020,RKI,1,1,0,1584316800000,15081,Altmarkkreis Salzwedel,1,0,1,83765,37
DE-ST,22-03-2020,RKI,0,0,0,1584835200000,15081,Altmarkkreis Salzwedel,1,0,1,83765,37
DE-ST,23-03-2020,RKI,3,3,0,1584921600000,15081,Altmarkkreis Salzwedel,4,0,4,83765,37
DE-ST,24-03-2020,RKI,0,0,0,1585008000000,15081,Altmarkkreis Salzwedel,4,0,4,83765,37
DE-ST,25-03-2020,RKI,0,0,0,1585094400000,15081,Altmarkkreis Salzwedel,4,0,4,83765,37
DE-ST,27-03-2020,RKI,1,1,0,1585267200000,15081,Altmarkkreis Salzwedel,5,0,5,83765,37
DE-ST,30-03-2020,RKI,1,1,0,1585526400000,15081,Altmarkkreis Salzwedel,6,0,6,83765,37
DE-ST,31-03-2020,RKI,0,0,0,1585612800000,15081,Altmarkkreis Salzwedel,6,0,6,83765,37
DE-ST,01-04-2020,RKI,0,0,0,1585699200000,15081,Altmarkkreis Salzwedel,6,0,6,83765,37
DE-ST,02-04-2020,RKI,0,0,0,1585785600000,15081,Altmarkkreis Salzwedel,6,0,6,83765,37
DE-ST,04-04-2020,RKI,1,1,0,1585958400000,15081,Altmarkkreis Salzwedel,7,0,7,83765,37
DE-ST,05-04-2020,RKI,0,0,0,1586044800000,15081,Altmarkkreis Salzwedel,7,0,7,83765,37
DE-ST,06-04-2020,RKI,0,0,0,1586131200000,15081,Altmarkkreis Salzwedel,7,0,7,83765,37
DE-ST,07-04-2020,RKI,1,1,0,1586217600000,15081,Altmarkkreis Salzwedel,8,0,8,83765,37
DE-ST,08-04-2020,RKI,1,1,0,1586304000000,15081,Altmarkkreis Salzwedel,9,0,9,83765,37
DE-ST,09-04-2020,RKI,1,1,0,1586390400000,15081,Altmarkkreis Salzwedel,10,0,10,83765,37
DE-ST,10-04-2020,RKI,0,0,0,1586476800000,15081,Altmarkkreis Salzwedel,10,0,10,83765,37
DE-ST,15-04-2020,RKI,0,0,0,1586908800000,15081,Altmarkkreis Salzwedel,10,0,10,83765,37
DE-ST,25-04-2020,RKI,0,0,0,1587772800000,15081,Altmarkkreis Salzwedel,10,0,10,83765,37
DE-ST,28-04-2020,RKI,0,0,0,1588032000000,15081,Altmarkkreis Salzwedel,10,0,10,83765,37
DE-ST,19-05-2020,RKI,0,0,0,1589846400000,15081,Altmarkkreis Salzwedel,10,0,10,83765,37
DE-ST,12-06-2020,RKI,0,0,0,1591920000000,15081,Altmarkkreis Salzwedel,10,0,10,83765,37
DE-ST,25-06-2020,RKI,0,0,0,1593043200000,15081,Altmarkkreis Salzwedel,10,0,10,83765,37
DE-ST,12-03-2020,RKI,0,0,0,1583971200000,15082,Anhalt-Bitterfeld,0,0,0,159854,110
DE-ST,16-03-2020,RKI,3,3,0,1584316800000,15082,Anhalt-Bitterfeld,3,0,3,159854,110
DE-ST,19-03-2020,RKI,1,1,0,1584576000000,15082,Anhalt-Bitterfeld,4,0,4,159854,110
DE-ST,20-03-2020,RKI,0,0,0,1584662400000,15082,Anhalt-Bitterfeld,4,0,4,159854,110
DE-ST,23-03-2020,RKI,6,6,0,1584921600000,15082,Anhalt-Bitterfeld,10,0,10,159854,110
DE-ST,24-03-2020,RKI,0,0,0,1585008000000,15082,Anhalt-Bitterfeld,10,0,10,159854,110
DE-ST,25-03-2020,RKI,5,5,0,1585094400000,15082,Anhalt-Bitterfeld,15,0,15,159854,110
DE-ST,26-03-2020,RKI,3,3,0,1585180800000,15082,Anhalt-Bitterfeld,18,0,18,159854,110
DE-ST,27-03-2020,RKI,2,2,0,1585267200000,15082,Anhalt-Bitterfeld,20,0,20,159854,110
DE-ST,29-03-2020,RKI,1,1,0,1585440000000,15082,Anhalt-Bitterfeld,21,0,21,159854,110
DE-ST,30-03-2020,RKI,4,4,0,1585526400000,15082,Anhalt-Bitterfeld,25,0,25,159854,110
DE-ST,01-04-2020,RKI,0,0,0,1585699200000,15082,Anhalt-Bitterfeld,25,0,25,159854,110
DE-ST,02-04-2020,RKI,0,0,0,1585785600000,15082,Anhalt-Bitterfeld,25,0,25,159854,110
DE-ST,03-04-2020,RKI,1,1,0,1585872000000,15082,Anhalt-Bitterfeld,26,0,26,159854,110
DE-ST,04-04-2020,RKI,1,1,0,1585958400000,15082,Anhalt-Bitterfeld,27,0,27,159854,110
DE-ST,05-04-2020,RKI,4,4,0,1586044800000,15082,Anhalt-Bitterfeld,31,0,31,159854,110
DE-ST,08-04-2020,RKI,0,0,0,1586304000000,15082,Anhalt-Bitterfeld,31,0,31,159854,110
DE-ST,10-04-2020,RKI,0,0,0,1586476800000,15082,Anhalt-Bitterfeld,31,0,31,159854,110
DE-ST,16-04-2020,RKI,2,2,0,1586995200000,15082,Anhalt-Bitterfeld,33,0,33,159854,110
DE-ST,17-04-2020,RKI,0,0,0,1587081600000,15082,Anhalt-Bitterfeld,33,0,33,159854,110
DE-ST,19-04-2020,RKI,2,2,0,1587254400000,15082,Anhalt-Bitterfeld,35,0,35,159854,110
DE-ST,20-04-2020,RKI,1,0,1,1587340800000,15082,Anhalt-Bitterfeld,36,1,35,159854,110
DE-ST,21-04-2020,RKI,3,3,0,1587427200000,15082,Anhalt-Bitterfeld,39,1,38,159854,110
DE-ST,22-04-2020,RKI,1,1,0,1587513600000,15082,Anhalt-Bitterfeld,40,1,39,159854,110
DE-ST,25-04-2020,RKI,2,1,1,1587772800000,15082,Anhalt-Bitterfeld,42,2,40,159854,110
DE-ST,01-05-2020,RKI,0,0,0,1588291200000,15082,Anhalt-Bitterfeld,42,2,40,159854,110
DE-ST,17-05-2020,RKI,0,0,0,1589673600000,15082,Anhalt-Bitterfeld,42,2,40,159854,110
DE-ST,19-05-2020,RKI,0,0,0,1589846400000,15082,Anhalt-Bitterfeld,42,2,40,159854,110
DE-ST,25-05-2020,RKI,0,0,0,1590364800000,15082,Anhalt-Bitterfeld,42,2,40,159854,110
DE-ST,27-05-2020,RKI,0,0,0,1590537600000,15082,Anhalt-Bitterfeld,42,2,40,159854,110
DE-ST,12-03-2020,RKI,0,0,0,1583971200000,15083,Börde,1,0,1,171734,73
DE-ST,16-03-2020,RKI,9,9,0,1584316800000,15083,Börde,10,0,10,171734,73
DE-ST,17-03-2020,RKI,3,3,0,1584403200000,15083,Börde,13,0,13,171734,73
DE-ST,18-03-2020,RKI,4,4,0,1584489600000,15083,Börde,17,0,17,171734,73
DE-ST,19-03-2020,RKI,2,2,0,1584576000000,15083,Börde,19,0,19,171734,73
DE-ST,20-03-2020,RKI,3,3,0,1584662400000,15083,Börde,22,0,22,171734,73
DE-ST,22-03-2020,RKI,5,5,0,1584835200000,15083,Börde,27,0,27,171734,73
DE-ST,23-03-2020,RKI,4,4,0,1584921600000,15083,Börde,31,0,31,171734,73
DE-ST,24-03-2020,RKI,2,1,1,1585008000000,15083,Börde,33,1,32,171734,73
DE-ST,25-03-2020,RKI,0,0,0,1585094400000,15083,Börde,33,1,32,171734,73
DE-ST,26-03-2020,RKI,1,1,0,1585180800000,15083,Börde,34,1,33,171734,73
DE-ST,27-03-2020,RKI,2,2,0,1585267200000,15083,Börde,36,1,35,171734,73
DE-ST,30-03-2020,RKI,5,5,0,1585526400000,15083,Börde,41,1,40,171734,73
DE-ST,31-03-2020,RKI,1,1,0,1585612800000,15083,Börde,42,1,41,171734,73
DE-ST,01-04-2020,RKI,2,2,0,1585699200000,15083,Börde,44,1,43,171734,73
DE-ST,02-04-2020,RKI,1,1,0,1585785600000,15083,Börde,45,1,44,171734,73
DE-ST,03-04-2020,RKI,4,4,0,1585872000000,15083,Börde,49,1,48,171734,73
DE-ST,04-04-2020,RKI,0,0,0,1585958400000,15083,Börde,49,1,48,171734,73
DE-ST,05-04-2020,RKI,1,1,0,1586044800000,15083,Börde,50,1,49,171734,73
DE-ST,07-04-2020,RKI,6,5,1,1586217600000,15083,Börde,56,2,54,171734,73
DE-ST,08-04-2020,RKI,0,0,0,1586304000000,15083,Börde,56,2,54,171734,73
DE-ST,09-04-2020,RKI,4,4,0,1586390400000,15083,Börde,60,2,58,171734,73
DE-ST,10-04-2020,RKI,3,2,1,1586476800000,15083,Börde,63,3,60,171734,73
DE-ST,12-04-2020,RKI,1,0,1,1586649600000,15083,Börde,64,4,60,171734,73
DE-ST,13-04-2020,RKI,1,1,0,1586736000000,15083,Börde,65,4,61,171734,73
DE-ST,14-04-2020,RKI,4,4,0,1586822400000,15083,Börde,69,4,65,171734,73
DE-ST,16-04-2020,RKI,2,1,1,1586995200000,15083,Börde,71,5,66,171734,73
DE-ST,17-04-2020,RKI,2,1,1,1587081600000,15083,Börde,73,6,67,171734,73
DE-ST,18-04-2020,RKI,0,0,0,1587168000000,15083,Börde,73,6,67,171734,73
DE-ST,19-04-2020,RKI,0,0,0,1587254400000,15083,Börde,73,6,67,171734,73
DE-ST,21-04-2020,RKI,10,10,0,1587427200000,15083,Börde,83,6,77,171734,73
DE-ST,22-04-2020,RKI,3,3,0,1587513600000,15083,Börde,86,6,80,171734,73
DE-ST,23-04-2020,RKI,1,0,1,1587600000000,15083,Börde,87,7,80,171734,73
DE-ST,24-04-2020,RKI,9,7,2,1587686400000,15083,Börde,96,9,87,171734,73
DE-ST,25-04-2020,RKI,0,0,0,1587772800000,15083,Börde,96,9,87,171734,73
DE-ST,27-04-2020,RKI,1,1,0,1587945600000,15083,Börde,97,9,88,171734,73
DE-ST,28-04-2020,RKI,4,4,0,1588032000000,15083,Börde,101,9,92,171734,73
DE-ST,30-04-2020,RKI,0,0,0,1588204800000,15083,Börde,101,9,92,171734,73
DE-ST,01-05-2020,RKI,0,0,0,1588291200000,15083,Börde,101,9,92,171734,73
DE-ST,02-05-2020,RKI,0,0,0,1588377600000,15083,Börde,101,9,92,171734,73
DE-ST,03-05-2020,RKI,0,0,0,1588464000000,15083,Börde,101,9,92,171734,73
DE-ST,05-05-2020,RKI,8,7,1,1588636800000,15083,Börde,109,10,99,171734,73
DE-ST,06-05-2020,RKI,1,1,0,1588723200000,15083,Börde,110,10,100,171734,73
DE-ST,07-05-2020,RKI,2,1,1,1588809600000,15083,Börde,112,11,101,171734,73
DE-ST,13-05-2020,RKI,0,0,0,1589328000000,15083,Börde,112,11,101,171734,73
DE-ST,20-05-2020,RKI,0,0,0,1589932800000,15083,Börde,112,11,101,171734,73
DE-ST,27-05-2020,RKI,0,0,0,1590537600000,15083,Börde,112,11,101,171734,73
DE-ST,01-06-2020,RKI,0,0,0,1590969600000,15083,Börde,112,11,101,171734,73
DE-ST,04-06-2020,RKI,1,1,0,1591228800000,15083,Börde,113,11,102,171734,73
DE-ST,17-06-2020,RKI,0,0,0,1592352000000,15083,Börde,113,11,102,171734,73
DE-ST,26-06-2020,RKI,0,0,0,1593129600000,15083,Börde,113,11,102,171734,73
DE-ST,30-06-2020,RKI,0,0,0,1593475200000,15083,Börde,113,11,102,171734,73
DE-ST,08-07-2020,RKI,0,0,0,1594166400000,15083,Börde,113,11,102,171734,73
DE-ST,14-07-2020,RKI,1,0,0,1594684800000,15083,Börde,114,11,102,171734,73
DE-ST,13-03-2020,RKI,0,0,0,1584057600000,15084,Burgenlandkreis,0,0,0,180190,127
DE-ST,16-03-2020,RKI,3,3,0,1584316800000,15084,Burgenlandkreis,3,0,3,180190,127
DE-ST,17-03-2020,RKI,0,0,0,1584403200000,15084,Burgenlandkreis,3,0,3,180190,127
DE-ST,18-03-2020,RKI,4,4,0,1584489600000,15084,Burgenlandkreis,7,0,7,180190,127
DE-ST,19-03-2020,RKI,1,1,0,1584576000000,15084,Burgenlandkreis,8,0,8,180190,127
DE-ST,20-03-2020,RKI,0,0,0,1584662400000,15084,Burgenlandkreis,8,0,8,180190,127
DE-ST,23-03-2020,RKI,2,2,0,1584921600000,15084,Burgenlandkreis,10,0,10,180190,127
DE-ST,24-03-2020,RKI,0,0,0,1585008000000,15084,Burgenlandkreis,10,0,10,180190,127
DE-ST,25-03-2020,RKI,4,3,1,1585094400000,15084,Burgenlandkreis,14,1,13,180190,127
DE-ST,26-03-2020,RKI,0,0,0,1585180800000,15084,Burgenlandkreis,14,1,13,180190,127
DE-ST,27-03-2020,RKI,0,0,0,1585267200000,15084,Burgenlandkreis,14,1,13,180190,127
DE-ST,30-03-2020,RKI,3,3,0,1585526400000,15084,Burgenlandkreis,17,1,16,180190,127
DE-ST,31-03-2020,RKI,2,2,0,1585612800000,15084,Burgenlandkreis,19,1,18,180190,127
DE-ST,02-04-2020,RKI,5,5,0,1585785600000,15084,Burgenlandkreis,24,1,23,180190,127
DE-ST,03-04-2020,RKI,1,1,0,1585872000000,15084,Burgenlandkreis,25,1,24,180190,127
DE-ST,04-04-2020,RKI,0,0,0,1585958400000,15084,Burgenlandkreis,25,1,24,180190,127
DE-ST,05-04-2020,RKI,0,0,0,1586044800000,15084,Burgenlandkreis,25,1,24,180190,127
DE-ST,06-04-2020,RKI,0,0,0,1586131200000,15084,Burgenlandkreis,25,1,24,180190,127
DE-ST,08-04-2020,RKI,6,6,0,1586304000000,15084,Burgenlandkreis,31,1,30,180190,127
DE-ST,09-04-2020,RKI,4,4,0,1586390400000,15084,Burgenlandkreis,35,1,34,180190,127
DE-ST,11-04-2020,RKI,0,0,0,1586563200000,15084,Burgenlandkreis,35,1,34,180190,127
DE-ST,13-04-2020,RKI,0,0,0,1586736000000,15084,Burgenlandkreis,35,1,34,180190,127
DE-ST,14-04-2020,RKI,3,3,0,1586822400000,15084,Burgenlandkreis,38,1,37,180190,127
DE-ST,16-04-2020,RKI,2,2,0,1586995200000,15084,Burgenlandkreis,40,1,39,180190,127
DE-ST,17-04-2020,RKI,0,0,0,1587081600000,15084,Burgenlandkreis,40,1,39,180190,127
DE-ST,18-04-2020,RKI,1,1,0,1587168000000,15084,Burgenlandkreis,41,1,40,180190,127
DE-ST,20-04-2020,RKI,1,1,0,1587340800000,15084,Burgenlandkreis,42,1,41,180190,127
DE-ST,21-04-2020,RKI,2,1,1,1587427200000,15084,Burgenlandkreis,44,2,42,180190,127
DE-ST,22-04-2020,RKI,1,1,0,1587513600000,15084,Burgenlandkreis,45,2,43,180190,127
DE-ST,23-04-2020,RKI,6,6,0,1587600000000,15084,Burgenlandkreis,51,2,49,180190,127
DE-ST,24-04-2020,RKI,4,4,0,1587686400000,15084,Burgenlandkreis,55,2,53,180190,127
DE-ST,26-04-2020,RKI,0,0,0,1587859200000,15084,Burgenlandkreis,55,2,53,180190,127
DE-ST,29-04-2020,RKI,0,0,0,1588118400000,15084,Burgenlandkreis,55,2,53,180190,127
DE-ST,30-04-2020,RKI,0,0,0,1588204800000,15084,Burgenlandkreis,55,2,53,180190,127
DE-ST,01-05-2020,RKI,0,0,0,1588291200000,15084,Burgenlandkreis,55,2,53,180190,127
DE-ST,05-05-2020,RKI,0,0,0,1588636800000,15084,Burgenlandkreis,55,2,53,180190,127
DE-ST,06-05-2020,RKI,1,1,0,1588723200000,15084,Burgenlandkreis,56,2,54,180190,127
DE-ST,07-05-2020,RKI,2,2,0,1588809600000,15084,Burgenlandkreis,58,2,56,180190,127
DE-ST,08-05-2020,RKI,0,0,0,1588896000000,15084,Burgenlandkreis,58,2,56,180190,127
DE-ST,13-05-2020,RKI,1,1,0,1589328000000,15084,Burgenlandkreis,59,2,57,180190,127
DE-ST,14-05-2020,RKI,5,5,0,1589414400000,15084,Burgenlandkreis,64,2,62,180190,127
DE-ST,15-05-2020,RKI,0,0,0,1589500800000,15084,Burgenlandkreis,64,2,62,180190,127
DE-ST,19-05-2020,RKI,3,3,0,1589846400000,15084,Burgenlandkreis,67,2,65,180190,127
DE-ST,20-05-2020,RKI,0,0,0,1589932800000,15084,Burgenlandkreis,67,2,65,180190,127
DE-ST,21-05-2020,RKI,0,0,0,1590019200000,15084,Burgenlandkreis,67,2,65,180190,127
DE-ST,22-05-2020,RKI,0,0,0,1590105600000,15084,Burgenlandkreis,67,2,65,180190,127
DE-ST,29-05-2020,RKI,0,0,0,1590710400000,15084,Burgenlandkreis,67,2,65,180190,127
DE-ST,30-05-2020,RKI,0,0,0,1590796800000,15084,Burgenlandkreis,67,2,65,180190,127
DE-ST,04-06-2020,RKI,1,1,0,1591228800000,15084,Burgenlandkreis,68,2,66,180190,127
DE-ST,12-06-2020,RKI,0,0,0,1591920000000,15084,Burgenlandkreis,68,2,66,180190,127
DE-ST,24-06-2020,RKI,1,0,0,1592956800000,15084,Burgenlandkreis,69,2,66,180190,127
DE-ST,26-06-2020,RKI,0,0,0,1593129600000,15084,Burgenlandkreis,69,2,66,180190,127
DE-ST,28-06-2020,RKI,0,0,0,1593302400000,15084,Burgenlandkreis,69,2,66,180190,127
DE-ST,02-07-2020,RKI,1,1,0,1593648000000,15084,Burgenlandkreis,70,2,67,180190,127
DE-ST,04-07-2020,RKI,0,0,0,1593820800000,15084,Burgenlandkreis,70,2,67,180190,127
DE-ST,05-07-2020,RKI,0,0,0,1593907200000,15084,Burgenlandkreis,70,2,67,180190,127
DE-ST,08-07-2020,RKI,1,0,0,1594166400000,15084,Burgenlandkreis,71,2,67,180190,127
DE-ST,09-07-2020,RKI,0,0,0,1594252800000,15084,Burgenlandkreis,71,2,67,180190,127
DE-ST,17-03-2020,RKI,5,5,0,1584403200000,15085,Harz,6,0,6,214446,102
DE-ST,19-03-2020,RKI,5,5,0,1584576000000,15085,Harz,11,0,11,214446,102
DE-ST,23-03-2020,RKI,7,7,0,1584921600000,15085,Harz,18,0,18,214446,102
DE-ST,24-03-2020,RKI,2,1,1,1585008000000,15085,Harz,20,1,19,214446,102
DE-ST,25-03-2020,RKI,3,3,0,1585094400000,15085,Harz,23,1,22,214446,102
DE-ST,26-03-2020,RKI,5,4,1,1585180800000,15085,Harz,28,2,26,214446,102
DE-ST,27-03-2020,RKI,6,6,0,1585267200000,15085,Harz,34,2,32,214446,102
DE-ST,28-03-2020,RKI,1,1,0,1585353600000,15085,Harz,35,2,33,214446,102
DE-ST,29-03-2020,RKI,1,1,0,1585440000000,15085,Harz,36,2,34,214446,102
DE-ST,30-03-2020,RKI,3,3,0,1585526400000,15085,Harz,39,2,37,214446,102
DE-ST,31-03-2020,RKI,7,7,0,1585612800000,15085,Harz,46,2,44,214446,102
DE-ST,02-04-2020,RKI,4,3,1,1585785600000,15085,Harz,50,3,47,214446,102
DE-ST,03-04-2020,RKI,3,3,0,1585872000000,15085,Harz,53,3,50,214446,102
DE-ST,04-04-2020,RKI,1,1,0,1585958400000,15085,Harz,54,3,51,214446,102
DE-ST,05-04-2020,RKI,4,4,0,1586044800000,15085,Harz,58,3,55,214446,102
DE-ST,06-04-2020,RKI,12,12,0,1586131200000,15085,Harz,70,3,67,214446,102
DE-ST,07-04-2020,RKI,3,3,0,1586217600000,15085,Harz,73,3,70,214446,102
DE-ST,08-04-2020,RKI,12,12,0,1586304000000,15085,Harz,85,3,82,214446,102
DE-ST,09-04-2020,RKI,3,3,0,1586390400000,15085,Harz,88,3,85,214446,102
DE-ST,10-04-2020,RKI,10,10,0,1586476800000,15085,Harz,98,3,95,214446,102
DE-ST,11-04-2020,RKI,3,3,0,1586563200000,15085,Harz,101,3,98,214446,102
DE-ST,14-04-2020,RKI,4,4,0,1586822400000,15085,Harz,105,3,102,214446,102
DE-ST,15-04-2020,RKI,2,2,0,1586908800000,15085,Harz,107,3,104,214446,102
DE-ST,16-04-2020,RKI,8,7,1,1586995200000,15085,Harz,115,4,111,214446,102
DE-ST,17-04-2020,RKI,44,44,0,1587081600000,15085,Harz,159,4,155,214446,102
DE-ST,18-04-2020,RKI,10,10,0,1587168000000,15085,Harz,169,4,165,214446,102
DE-ST,19-04-2020,RKI,1,1,0,1587254400000,15085,Harz,170,4,166,214446,102
DE-ST,21-04-2020,RKI,0,0,0,1587427200000,15085,Harz,170,4,166,214446,102
DE-ST,22-04-2020,RKI,0,0,0,1587513600000,15085,Harz,170,4,166,214446,102
DE-ST,23-04-2020,RKI,2,2,0,1587600000000,15085,Harz,172,4,168,214446,102
DE-ST,24-04-2020,RKI,1,1,0,1587686400000,15085,Harz,173,4,169,214446,102
DE-ST,25-04-2020,RKI,0,0,0,1587772800000,15085,Harz,173,4,169,214446,102
DE-ST,27-04-2020,RKI,2,2,0,1587945600000,15085,Harz,175,4,171,214446,102
DE-ST,28-04-2020,RKI,0,0,0,1588032000000,15085,Harz,175,4,171,214446,102
DE-ST,29-04-2020,RKI,0,0,0,1588118400000,15085,Harz,175,4,171,214446,102
DE-ST,30-04-2020,RKI,1,0,1,1588204800000,15085,Harz,176,5,171,214446,102
DE-ST,01-05-2020,RKI,1,1,0,1588291200000,15085,Harz,177,5,172,214446,102
DE-ST,03-05-2020,RKI,0,0,0,1588464000000,15085,Harz,177,5,172,214446,102
DE-ST,04-05-2020,RKI,1,1,0,1588550400000,15085,Harz,178,5,173,214446,102
DE-ST,05-05-2020,RKI,2,2,0,1588636800000,15085,Harz,180,5,175,214446,102
DE-ST,13-05-2020,RKI,0,0,0,1589328000000,15085,Harz,180,5,175,214446,102
DE-ST,16-05-2020,RKI,1,1,0,1589587200000,15085,Harz,181,5,176,214446,102
DE-ST,17-05-2020,RKI,0,0,0,1589673600000,15085,Harz,181,5,176,214446,102
DE-ST,09-07-2020,RKI,0,0,0,1594252800000,15085,Harz,181,5,176,214446,102
DE-ST,10-07-2020,RKI,1,1,0,1594339200000,15085,Harz,182,5,177,214446,102
DE-ST,18-03-2020,RKI,1,1,0,1584489600000,15086,Jerichower Land,1,0,1,89928,57
DE-ST,20-03-2020,RKI,0,0,0,1584662400000,15086,Jerichower Land,1,0,1,89928,57
DE-ST,23-03-2020,RKI,2,2,0,1584921600000,15086,Jerichower Land,3,0,3,89928,57
DE-ST,24-03-2020,RKI,2,1,1,1585008000000,15086,Jerichower Land,5,1,4,89928,57
DE-ST,25-03-2020,RKI,2,2,0,1585094400000,15086,Jerichower Land,7,1,6,89928,57
DE-ST,26-03-2020,RKI,2,2,0,1585180800000,15086,Jerichower Land,9,1,8,89928,57
DE-ST,30-03-2020,RKI,1,1,0,1585526400000,15086,Jerichower Land,10,1,9,89928,57
DE-ST,31-03-2020,RKI,1,1,0,1585612800000,15086,Jerichower Land,11,1,10,89928,57
DE-ST,03-04-2020,RKI,1,1,0,1585872000000,15086,Jerichower Land,12,1,11,89928,57
DE-ST,04-04-2020,RKI,2,1,1,1585958400000,15086,Jerichower Land,14,2,12,89928,57
DE-ST,06-04-2020,RKI,0,0,0,1586131200000,15086,Jerichower Land,14,2,12,89928,57
DE-ST,07-04-2020,RKI,0,0,0,1586217600000,15086,Jerichower Land,14,2,12,89928,57
DE-ST,08-04-2020,RKI,0,0,0,1586304000000,15086,Jerichower Land,14,2,12,89928,57
DE-ST,14-04-2020,RKI,0,0,0,1586822400000,15086,Jerichower Land,14,2,12,89928,57
DE-ST,16-04-2020,RKI,0,0,0,1586995200000,15086,Jerichower Land,14,2,12,89928,57
DE-ST,17-04-2020,RKI,0,0,0,1587081600000,15086,Jerichower Land,14,2,12,89928,57
DE-ST,23-04-2020,RKI,0,0,0,1587600000000,15086,Jerichower Land,14,2,12,89928,57
DE-ST,25-05-2020,RKI,0,0,0,1590364800000,15086,Jerichower Land,14,2,12,89928,57
DE-ST,27-06-2020,RKI,0,0,0,1593216000000,15086,Jerichower Land,14,2,12,89928,57
DE-ST,05-07-2020,RKI,1,0,0,1593907200000,15086,Jerichower Land,15,2,12,89928,57
DE-ST,09-07-2020,RKI,0,0,0,1594252800000,15086,Jerichower Land,15,2,12,89928,57
DE-ST,10-07-2020,RKI,0,0,0,1594339200000,15086,Jerichower Land,15,2,12,89928,57
DE-ST,11-07-2020,RKI,0,0,0,1594425600000,15086,Jerichower Land,15,2,12,89928,57
DE-ST,15-07-2020,RKI,0,0,0,1594771200000,15086,Jerichower Land,15,2,12,89928,57
DE-ST,17-03-2020,RKI,1,1,0,1584403200000,15087,Mansfeld-Südharz,1,0,1,136249,94
DE-ST,19-03-2020,RKI,2,2,0,1584576000000,15087,Mansfeld-Südharz,3,0,3,136249,94
DE-ST,21-03-2020,RKI,4,3,1,1584748800000,15087,Mansfeld-Südharz,7,1,6,136249,94
DE-ST,24-03-2020,RKI,0,0,0,1585008000000,15087,Mansfeld-Südharz,7,1,6,136249,94
DE-ST,26-03-2020,RKI,1,1,0,1585180800000,15087,Mansfeld-Südharz,8,1,7,136249,94
DE-ST,27-03-2020,RKI,0,0,0,1585267200000,15087,Mansfeld-Südharz,8,1,7,136249,94
DE-ST,30-03-2020,RKI,3,3,0,1585526400000,15087,Mansfeld-Südharz,11,1,10,136249,94
DE-ST,31-03-2020,RKI,3,3,0,1585612800000,15087,Mansfeld-Südharz,14,1,13,136249,94
DE-ST,02-04-2020,RKI,2,2,0,1585785600000,15087,Mansfeld-Südharz,16,1,15,136249,94
DE-ST,03-04-2020,RKI,1,1,0,1585872000000,15087,Mansfeld-Südharz,17,1,16,136249,94
DE-ST,04-04-2020,RKI,0,0,0,1585958400000,15087,Mansfeld-Südharz,17,1,16,136249,94
DE-ST,08-04-2020,RKI,1,1,0,1586304000000,15087,Mansfeld-Südharz,18,1,17,136249,94
DE-ST,09-04-2020,RKI,0,0,0,1586390400000,15087,Mansfeld-Südharz,18,1,17,136249,94
DE-ST,10-04-2020,RKI,0,0,0,1586476800000,15087,Mansfeld-Südharz,18,1,17,136249,94
DE-ST,11-04-2020,RKI,0,0,0,1586563200000,15087,Mansfeld-Südharz,18,1,17,136249,94
DE-ST,20-04-2020,RKI,0,0,0,1587340800000,15087,Mansfeld-Südharz,18,1,17,136249,94
DE-ST,26-04-2020,RKI,0,0,0,1587859200000,15087,Mansfeld-Südharz,18,1,17,136249,94
DE-ST,30-04-2020,RKI,0,0,0,1588204800000,15087,Mansfeld-Südharz,18,1,17,136249,94
DE-ST,02-05-2020,RKI,0,0,0,1588377600000,15087,Mansfeld-Südharz,18,1,17,136249,94
DE-ST,06-05-2020,RKI,0,0,0,1588723200000,15087,Mansfeld-Südharz,18,1,17,136249,94
DE-ST,10-05-2020,RKI,0,0,0,1589068800000,15087,Mansfeld-Südharz,18,1,17,136249,94
DE-ST,12-05-2020,RKI,0,0,0,1589241600000,15087,Mansfeld-Südharz,18,1,17,136249,94
DE-ST,13-05-2020,RKI,0,0,0,1589328000000,15087,Mansfeld-Südharz,18,1,17,136249,94
DE-ST,19-05-2020,RKI,0,0,0,1589846400000,15087,Mansfeld-Südharz,18,1,17,136249,94
DE-ST,21-05-2020,RKI,1,1,0,1590019200000,15087,Mansfeld-Südharz,19,1,18,136249,94
DE-ST,25-05-2020,RKI,0,0,0,1590364800000,15087,Mansfeld-Südharz,19,1,18,136249,94
DE-ST,02-06-2020,RKI,0,0,0,1591056000000,15087,Mansfeld-Südharz,19,1,18,136249,94
DE-ST,05-06-2020,RKI,0,0,0,1591315200000,15087,Mansfeld-Südharz,19,1,18,136249,94
DE-ST,13-06-2020,RKI,0,0,0,1592006400000,15087,Mansfeld-Südharz,19,1,18,136249,94
DE-ST,30-06-2020,RKI,0,0,0,1593475200000,15087,Mansfeld-Südharz,19,1,18,136249,94
DE-ST,09-07-2020,RKI,0,0,0,1594252800000,15087,Mansfeld-Südharz,19,1,18,136249,94
DE-ST,10-07-2020,RKI,4,0,0,1594339200000,15087,Mansfeld-Südharz,23,1,18,136249,94
DE-ST,14-07-2020,RKI,2,0,0,1594684800000,15087,Mansfeld-Südharz,25,1,18,136249,94
DE-ST,15-07-2020,RKI,0,0,0,1594771200000,15087,Mansfeld-Südharz,25,1,18,136249,94
DE-ST,16-03-2020,RKI,1,1,0,1584316800000,15088,Saalekreis,1,0,1,184582,129
DE-ST,17-03-2020,RKI,0,0,0,1584403200000,15088,Saalekreis,1,0,1,184582,129
DE-ST,18-03-2020,RKI,1,1,0,1584489600000,15088,Saalekreis,2,0,2,184582,129
DE-ST,19-03-2020,RKI,5,5,0,1584576000000,15088,Saalekreis,7,0,7,184582,129
DE-ST,20-03-2020,RKI,1,1,0,1584662400000,15088,Saalekreis,8,0,8,184582,129
DE-ST,21-03-2020,RKI,4,4,0,1584748800000,15088,Saalekreis,12,0,12,184582,129
DE-ST,22-03-2020,RKI,1,1,0,1584835200000,15088,Saalekreis,13,0,13,184582,129
DE-ST,23-03-2020,RKI,0,0,0,1584921600000,15088,Saalekreis,13,0,13,184582,129
DE-ST,24-03-2020,RKI,16,15,1,1585008000000,15088,Saalekreis,29,1,28,184582,129
DE-ST,25-03-2020,RKI,1,1,0,1585094400000,15088,Saalekreis,30,1,29,184582,129
DE-ST,26-03-2020,RKI,3,3,0,1585180800000,15088,Saalekreis,33,1,32,184582,129
DE-ST,27-03-2020,RKI,3,2,1,1585267200000,15088,Saalekreis,36,2,34,184582,129
DE-ST,28-03-2020,RKI,5,5,0,1585353600000,15088,Saalekreis,41,2,39,184582,129
DE-ST,30-03-2020,RKI,2,2,0,1585526400000,15088,Saalekreis,43,2,41,184582,129
DE-ST,31-03-2020,RKI,4,4,0,1585612800000,15088,Saalekreis,47,2,45,184582,129
DE-ST,01-04-2020,RKI,7,7,0,1585699200000,15088,Saalekreis,54,2,52,184582,129
DE-ST,02-04-2020,RKI,5,5,0,1585785600000,15088,Saalekreis,59,2,57,184582,129
DE-ST,03-04-2020,RKI,2,1,1,1585872000000,15088,Saalekreis,61,3,58,184582,129
DE-ST,04-04-2020,RKI,2,2,0,1585958400000,15088,Saalekreis,63,3,60,184582,129
DE-ST,05-04-2020,RKI,0,0,0,1586044800000,15088,Saalekreis,63,3,60,184582,129
DE-ST,06-04-2020,RKI,0,0,0,1586131200000,15088,Saalekreis,63,3,60,184582,129
DE-ST,07-04-2020,RKI,0,0,0,1586217600000,15088,Saalekreis,63,3,60,184582,129
DE-ST,08-04-2020,RKI,3,3,0,1586304000000,15088,Saalekreis,66,3,63,184582,129
DE-ST,09-04-2020,RKI,3,3,0,1586390400000,15088,Saalekreis,69,3,66,184582,129
DE-ST,10-04-2020,RKI,1,1,0,1586476800000,15088,Saalekreis,70,3,67,184582,129
DE-ST,12-04-2020,RKI,0,0,0,1586649600000,15088,Saalekreis,70,3,67,184582,129
DE-ST,13-04-2020,RKI,1,1,0,1586736000000,15088,Saalekreis,71,3,68,184582,129
DE-ST,14-04-2020,RKI,0,0,0,1586822400000,15088,Saalekreis,71,3,68,184582,129
DE-ST,17-04-2020,RKI,1,1,0,1587081600000,15088,Saalekreis,72,3,69,184582,129
DE-ST,18-04-2020,RKI,0,0,0,1587168000000,15088,Saalekreis,72,3,69,184582,129
DE-ST,20-04-2020,RKI,1,1,0,1587340800000,15088,Saalekreis,73,3,70,184582,129
DE-ST,24-04-2020,RKI,0,0,0,1587686400000,15088,Saalekreis,73,3,70,184582,129
DE-ST,29-04-2020,RKI,0,0,0,1588118400000,15088,Saalekreis,73,3,70,184582,129
DE-ST,30-04-2020,RKI,2,2,0,1588204800000,15088,Saalekreis,75,3,72,184582,129
DE-ST,01-05-2020,RKI,1,1,0,1588291200000,15088,Saalekreis,76,3,73,184582,129
DE-ST,02-05-2020,RKI,0,0,0,1588377600000,15088,Saalekreis,76,3,73,184582,129
DE-ST,04-05-2020,RKI,0,0,0,1588550400000,15088,Saalekreis,76,3,73,184582,129
DE-ST,05-05-2020,RKI,3,3,0,1588636800000,15088,Saalekreis,79,3,76,184582,129
DE-ST,06-05-2020,RKI,0,0,0,1588723200000,15088,Saalekreis,79,3,76,184582,129
DE-ST,07-05-2020,RKI,0,0,0,1588809600000,15088,Saalekreis,79,3,76,184582,129
DE-ST,08-05-2020,RKI,0,0,0,1588896000000,15088,Saalekreis,79,3,76,184582,129
DE-ST,09-05-2020,RKI,1,1,0,1588982400000,15088,Saalekreis,80,3,77,184582,129
DE-ST,11-05-2020,RKI,0,0,0,1589155200000,15088,Saalekreis,80,3,77,184582,129
DE-ST,12-05-2020,RKI,0,0,0,1589241600000,15088,Saalekreis,80,3,77,184582,129
DE-ST,19-05-2020,RKI,0,0,0,1589846400000,15088,Saalekreis,80,3,77,184582,129
DE-ST,25-05-2020,RKI,0,0,0,1590364800000,15088,Saalekreis,80,3,77,184582,129
DE-ST,26-05-2020,RKI,0,0,0,1590451200000,15088,Saalekreis,80,3,77,184582,129
DE-ST,28-05-2020,RKI,0,0,0,1590624000000,15088,Saalekreis,80,3,77,184582,129
DE-ST,16-06-2020,RKI,0,0,0,1592265600000,15088,Saalekreis,80,3,77,184582,129
DE-ST,22-06-2020,RKI,1,1,0,1592784000000,15088,Saalekreis,81,3,78,184582,129
DE-ST,23-06-2020,RKI,0,0,0,1592870400000,15088,Saalekreis,81,3,78,184582,129
DE-ST,05-07-2020,RKI,1,1,0,1593907200000,15088,Saalekreis,82,3,79,184582,129
DE-ST,07-07-2020,RKI,1,0,0,1594080000000,15088,Saalekreis,83,3,79,184582,129
DE-ST,11-03-2020,RKI,4,4,0,1583884800000,15089,Salzlandkreis,4,0,4,190560,134
DE-ST,12-03-2020,RKI,0,0,0,1583971200000,15089,Salzlandkreis,4,0,4,190560,134
DE-ST,13-03-2020,RKI,0,0,0,1584057600000,15089,Salzlandkreis,4,0,4,190560,134
DE-ST,19-03-2020,RKI,3,3,0,1584576000000,15089,Salzlandkreis,7,0,7,190560,134
DE-ST,20-03-2020,RKI,5,5,0,1584662400000,15089,Salzlandkreis,12,0,12,190560,134
DE-ST,21-03-2020,RKI,1,1,0,1584748800000,15089,Salzlandkreis,13,0,13,190560,134
DE-ST,23-03-2020,RKI,5,5,0,1584921600000,15089,Salzlandkreis,18,0,18,190560,134
DE-ST,24-03-2020,RKI,3,3,0,1585008000000,15089,Salzlandkreis,21,0,21,190560,134
DE-ST,25-03-2020,RKI,1,1,0,1585094400000,15089,Salzlandkreis,22,0,22,190560,134
DE-ST,26-03-2020,RKI,6,6,0,1585180800000,15089,Salzlandkreis,28,0,28,190560,134
DE-ST,28-03-2020,RKI,0,0,0,1585353600000,15089,Salzlandkreis,28,0,28,190560,134
DE-ST,29-03-2020,RKI,0,0,0,1585440000000,15089,Salzlandkreis,28,0,28,190560,134
DE-ST,31-03-2020,RKI,1,1,0,1585612800000,15089,Salzlandkreis,29,0,29,190560,134
DE-ST,01-04-2020,RKI,2,2,0,1585699200000,15089,Salzlandkreis,31,0,31,190560,134
DE-ST,02-04-2020,RKI,0,0,0,1585785600000,15089,Salzlandkreis,31,0,31,190560,134
DE-ST,03-04-2020,RKI,2,2,0,1585872000000,15089,Salzlandkreis,33,0,33,190560,134
DE-ST,04-04-2020,RKI,2,2,0,1585958400000,15089,Salzlandkreis,35,0,35,190560,134
DE-ST,06-04-2020,RKI,1,1,0,1586131200000,15089,Salzlandkreis,36,0,36,190560,134
DE-ST,07-04-2020,RKI,1,1,0,1586217600000,15089,Salzlandkreis,37,0,37,190560,134
DE-ST,08-04-2020,RKI,0,0,0,1586304000000,15089,Salzlandkreis,37,0,37,190560,134
DE-ST,12-04-2020,RKI,0,0,0,1586649600000,15089,Salzlandkreis,37,0,37,190560,134
DE-ST,17-04-2020,RKI,0,0,0,1587081600000,15089,Salzlandkreis,37,0,37,190560,134
DE-ST,18-04-2020,RKI,0,0,0,1587168000000,15089,Salzlandkreis,37,0,37,190560,134
DE-ST,22-04-2020,RKI,0,0,0,1587513600000,15089,Salzlandkreis,37,0,37,190560,134
DE-ST,28-04-2020,RKI,0,0,0,1588032000000,15089,Salzlandkreis,37,0,37,190560,134
DE-ST,30-04-2020,RKI,0,0,0,1588204800000,15089,Salzlandkreis,37,0,37,190560,134
DE-ST,12-05-2020,RKI,0,0,0,1589241600000,15089,Salzlandkreis,37,0,37,190560,134
DE-ST,13-05-2020,RKI,0,0,0,1589328000000,15089,Salzlandkreis,37,0,37,190560,134
DE-ST,14-05-2020,RKI,0,0,0,1589414400000,15089,Salzlandkreis,37,0,37,190560,134
DE-ST,25-06-2020,RKI,0,0,0,1593043200000,15089,Salzlandkreis,37,0,37,190560,134
DE-ST,26-06-2020,RKI,0,0,0,1593129600000,15089,Salzlandkreis,37,0,37,190560,134
DE-ST,27-06-2020,RKI,0,0,0,1593216000000,15089,Salzlandkreis,37,0,37,190560,134
DE-ST,17-03-2020,RKI,3,3,0,1584403200000,15090,Stendal,3,0,3,111982,46
DE-ST,19-03-2020,RKI,1,1,0,1584576000000,15090,Stendal,4,0,4,111982,46
DE-ST,20-03-2020,RKI,2,2,0,1584662400000,15090,Stendal,6,0,6,111982,46
DE-ST,23-03-2020,RKI,1,1,0,1584921600000,15090,Stendal,7,0,7,111982,46
DE-ST,24-03-2020,RKI,5,5,0,1585008000000,15090,Stendal,12,0,12,111982,46
DE-ST,25-03-2020,RKI,3,2,1,1585094400000,15090,Stendal,15,1,14,111982,46
DE-ST,26-03-2020,RKI,2,1,1,1585180800000,15090,Stendal,17,2,15,111982,46
DE-ST,27-03-2020,RKI,14,13,1,1585267200000,15090,Stendal,31,3,28,111982,46
DE-ST,28-03-2020,RKI,10,10,0,1585353600000,15090,Stendal,41,3,38,111982,46
DE-ST,29-03-2020,RKI,0,0,0,1585440000000,15090,Stendal,41,3,38,111982,46
DE-ST,31-03-2020,RKI,2,2,0,1585612800000,15090,Stendal,43,3,40,111982,46
DE-ST,01-04-2020,RKI,3,3,0,1585699200000,15090,Stendal,46,3,43,111982,46
DE-ST,02-04-2020,RKI,2,2,0,1585785600000,15090,Stendal,48,3,45,111982,46
DE-ST,03-04-2020,RKI,0,0,0,1585872000000,15090,Stendal,48,3,45,111982,46
DE-ST,04-04-2020,RKI,0,0,0,1585958400000,15090,Stendal,48,3,45,111982,46
DE-ST,05-04-2020,RKI,0,0,0,1586044800000,15090,Stendal,48,3,45,111982,46
DE-ST,06-04-2020,RKI,0,0,0,1586131200000,15090,Stendal,48,3,45,111982,46
DE-ST,08-04-2020,RKI,0,0,0,1586304000000,15090,Stendal,48,3,45,111982,46
DE-ST,09-04-2020,RKI,2,0,2,1586390400000,15090,Stendal,50,5,45,111982,46
DE-ST,10-04-2020,RKI,0,0,0,1586476800000,15090,Stendal,50,5,45,111982,46
DE-ST,11-04-2020,RKI,2,2,0,1586563200000,15090,Stendal,52,5,47,111982,46
DE-ST,12-04-2020,RKI,0,0,0,1586649600000,15090,Stendal,52,5,47,111982,46
DE-ST,15-04-2020,RKI,3,3,0,1586908800000,15090,Stendal,55,5,50,111982,46
DE-ST,16-04-2020,RKI,0,0,0,1586995200000,15090,Stendal,55,5,50,111982,46
DE-ST,17-04-2020,RKI,1,1,0,1587081600000,15090,Stendal,56,5,51,111982,46
DE-ST,18-04-2020,RKI,2,1,1,1587168000000,15090,Stendal,58,6,52,111982,46
DE-ST,21-04-2020,RKI,2,2,0,1587427200000,15090,Stendal,60,6,54,111982,46
DE-ST,22-04-2020,RKI,1,1,0,1587513600000,15090,Stendal,61,6,55,111982,46
DE-ST,23-04-2020,RKI,1,1,0,1587600000000,15090,Stendal,62,6,56,111982,46
DE-ST,24-04-2020,RKI,1,1,0,1587686400000,15090,Stendal,63,6,57,111982,46
DE-ST,25-04-2020,RKI,2,2,0,1587772800000,15090,Stendal,65,6,59,111982,46
DE-ST,28-04-2020,RKI,1,1,0,1588032000000,15090,Stendal,66,6,60,111982,46
DE-ST,29-04-2020,RKI,1,1,0,1588118400000,15090,Stendal,67,6,61,111982,46
DE-ST,30-04-2020,RKI,1,1,0,1588204800000,15090,Stendal,68,6,62,111982,46
DE-ST,01-05-2020,RKI,0,0,0,1588291200000,15090,Stendal,68,6,62,111982,46
DE-ST,03-05-2020,RKI,0,0,0,1588464000000,15090,Stendal,68,6,62,111982,46
DE-ST,06-05-2020,RKI,0,0,0,1588723200000,15090,Stendal,68,6,62,111982,46
DE-ST,20-05-2020,RKI,0,0,0,1589932800000,15090,Stendal,68,6,62,111982,46
DE-ST,12-07-2020,RKI,0,0,0,1594512000000,15090,Stendal,68,6,62,111982,46
DE-ST,16-07-2020,RKI,0,0,0,1594857600000,15090,Stendal,68,6,62,111982,46
DE-ST,17-03-2020,RKI,0,0,0,1584403200000,15091,Wittenberg,1,0,1,125840,65
DE-ST,19-03-2020,RKI,5,5,0,1584576000000,15091,Wittenberg,6,0,6,125840,65
DE-ST,20-03-2020,RKI,0,0,0,1584662400000,15091,Wittenberg,6,0,6,125840,65
DE-ST,23-03-2020,RKI,5,4,1,1584921600000,15091,Wittenberg,11,1,10,125840,65
DE-ST,24-03-2020,RKI,6,6,0,1585008000000,15091,Wittenberg,17,1,16,125840,65
DE-ST,25-03-2020,RKI,7,7,0,1585094400000,15091,Wittenberg,24,1,23,125840,65
DE-ST,26-03-2020,RKI,11,11,0,1585180800000,15091,Wittenberg,35,1,34,125840,65
DE-ST,27-03-2020,RKI,15,14,1,1585267200000,15091,Wittenberg,50,2,48,125840,65
DE-ST,28-03-2020,RKI,3,3,0,1585353600000,15091,Wittenberg,53,2,51,125840,65
DE-ST,29-03-2020,RKI,6,6,0,1585440000000,15091,Wittenberg,59,2,57,125840,65
DE-ST,30-03-2020,RKI,7,6,1,1585526400000,15091,Wittenberg,66,3,63,125840,65
DE-ST,31-03-2020,RKI,7,7,0,1585612800000,15091,Wittenberg,73,3,70,125840,65
DE-ST,01-04-2020,RKI,3,3,0,1585699200000,15091,Wittenberg,76,3,73,125840,65
DE-ST,02-04-2020,RKI,4,4,0,1585785600000,15091,Wittenberg,80,3,77,125840,65
DE-ST,03-04-2020,RKI,2,2,0,1585872000000,15091,Wittenberg,82,3,79,125840,65
DE-ST,04-04-2020,RKI,5,5,0,1585958400000,15091,Wittenberg,87,3,84,125840,65
DE-ST,05-04-2020,RKI,5,5,0,1586044800000,15091,Wittenberg,92,3,89,125840,65
DE-ST,07-04-2020,RKI,7,7,0,1586217600000,15091,Wittenberg,99,3,96,125840,65
DE-ST,08-04-2020,RKI,4,4,0,1586304000000,15091,Wittenberg,103,3,100,125840,65
DE-ST,09-04-2020,RKI,3,3,0,1586390400000,15091,Wittenberg,106,3,103,125840,65
DE-ST,10-04-2020,RKI,1,1,0,1586476800000,15091,Wittenberg,107,3,104,125840,65
DE-ST,11-04-2020,RKI,4,4,0,1586563200000,15091,Wittenberg,111,3,108,125840,65
DE-ST,12-04-2020,RKI,1,1,0,1586649600000,15091,Wittenberg,112,3,109,125840,65
DE-ST,13-04-2020,RKI,1,1,0,1586736000000,15091,Wittenberg,113,3,110,125840,65
DE-ST,15-04-2020,RKI,2,2,0,1586908800000,15091,Wittenberg,115,3,112,125840,65
DE-ST,16-04-2020,RKI,0,0,0,1586995200000,15091,Wittenberg,115,3,112,125840,65
DE-ST,19-04-2020,RKI,1,1,0,1587254400000,15091,Wittenberg,116,3,113,125840,65
DE-ST,20-04-2020,RKI,0,0,0,1587340800000,15091,Wittenberg,116,3,113,125840,65
DE-ST,21-04-2020,RKI,0,0,0,1587427200000,15091,Wittenberg,116,3,113,125840,65
DE-ST,23-04-2020,RKI,1,1,0,1587600000000,15091,Wittenberg,117,3,114,125840,65
DE-ST,26-04-2020,RKI,0,0,0,1587859200000,15091,Wittenberg,117,3,114,125840,65
DE-ST,14-05-2020,RKI,0,0,0,1589414400000,15091,Wittenberg,117,3,114,125840,65
DE-ST,16-06-2020,RKI,0,0,0,1592265600000,15091,Wittenberg,117,3,114,125840,65
DE-ST,20-06-2020,RKI,0,0,0,1592611200000,15091,Wittenberg,117,3,114,125840,65
DE-ST,22-06-2020,RKI,0,0,0,1592784000000,15091,Wittenberg,117,3,114,125840,65
DE-ST,01-07-2020,RKI,0,0,0,1593561600000,15091,Wittenberg,117,3,114,125840,65
DE-ST,11-07-2020,RKI,0,0,0,1594425600000,15091,Wittenberg,117,3,114,125840,65
DE-SH,18-03-2020,RKI,1,1,0,1584489600000,01001,Flensburg,4,0,4,89504,1577
DE-SH,19-03-2020,RKI,3,3,0,1584576000000,01001,Flensburg,7,0,7,89504,1577
DE-SH,20-03-2020,RKI,1,1,0,1584662400000,01001,Flensburg,8,0,8,89504,1577
DE-SH,21-03-2020,RKI,0,0,0,1584748800000,01001,Flensburg,8,0,8,89504,1577
DE-SH,24-03-2020,RKI,0,0,0,1585008000000,01001,Flensburg,8,0,8,89504,1577
DE-SH,26-03-2020,RKI,3,3,0,1585180800000,01001,Flensburg,11,0,11,89504,1577
DE-SH,27-03-2020,RKI,0,0,0,1585267200000,01001,Flensburg,11,0,11,89504,1577
DE-SH,28-03-2020,RKI,1,1,0,1585353600000,01001,Flensburg,12,0,12,89504,1577
DE-SH,29-03-2020,RKI,0,0,0,1585440000000,01001,Flensburg,12,0,12,89504,1577
DE-SH,30-03-2020,RKI,0,0,0,1585526400000,01001,Flensburg,12,0,12,89504,1577
DE-SH,31-03-2020,RKI,1,0,1,1585612800000,01001,Flensburg,13,1,12,89504,1577
DE-SH,03-04-2020,RKI,1,1,0,1585872000000,01001,Flensburg,14,1,13,89504,1577
DE-SH,04-04-2020,RKI,0,0,0,1585958400000,01001,Flensburg,14,1,13,89504,1577
DE-SH,06-04-2020,RKI,0,0,0,1586131200000,01001,Flensburg,14,1,13,89504,1577
DE-SH,07-04-2020,RKI,0,0,0,1586217600000,01001,Flensburg,14,1,13,89504,1577
DE-SH,09-04-2020,RKI,0,0,0,1586390400000,01001,Flensburg,14,1,13,89504,1577
DE-SH,10-04-2020,RKI,0,0,0,1586476800000,01001,Flensburg,14,1,13,89504,1577
DE-SH,05-05-2020,RKI,0,0,0,1588636800000,01001,Flensburg,14,1,13,89504,1577
DE-SH,17-05-2020,RKI,0,0,0,1589673600000,01001,Flensburg,14,1,13,89504,1577
DE-SH,21-05-2020,RKI,3,3,0,1590019200000,01001,Flensburg,17,1,16,89504,1577
DE-SH,22-05-2020,RKI,0,0,0,1590105600000,01001,Flensburg,17,1,16,89504,1577
DE-SH,26-05-2020,RKI,0,0,0,1590451200000,01001,Flensburg,17,1,16,89504,1577
DE-SH,29-05-2020,RKI,0,0,0,1590710400000,01001,Flensburg,17,1,16,89504,1577
DE-SH,30-05-2020,RKI,0,0,0,1590796800000,01001,Flensburg,17,1,16,89504,1577
DE-SH,06-06-2020,RKI,0,0,0,1591401600000,01001,Flensburg,17,1,16,89504,1577
DE-SH,10-06-2020,RKI,0,0,0,1591747200000,01001,Flensburg,17,1,16,89504,1577
DE-SH,18-06-2020,RKI,1,1,0,1592438400000,01001,Flensburg,18,1,17,89504,1577
DE-SH,25-06-2020,RKI,1,1,0,1593043200000,01001,Flensburg,19,1,18,89504,1577
DE-SH,11-03-2020,RKI,3,3,0,1583884800000,01002,Kiel,5,0,5,247548,2086
DE-SH,12-03-2020,RKI,3,3,0,1583971200000,01002,Kiel,8,0,8,247548,2086
DE-SH,13-03-2020,RKI,0,0,0,1584057600000,01002,Kiel,8,0,8,247548,2086
DE-SH,14-03-2020,RKI,0,0,0,1584144000000,01002,Kiel,8,0,8,247548,2086
DE-SH,16-03-2020,RKI,4,4,0,1584316800000,01002,Kiel,12,0,12,247548,2086
DE-SH,17-03-2020,RKI,1,1,0,1584403200000,01002,Kiel,13,0,13,247548,2086
DE-SH,18-03-2020,RKI,4,4,0,1584489600000,01002,Kiel,17,0,17,247548,2086
DE-SH,19-03-2020,RKI,7,7,0,1584576000000,01002,Kiel,24,0,24,247548,2086
DE-SH,20-03-2020,RKI,2,2,0,1584662400000,01002,Kiel,26,0,26,247548,2086
DE-SH,21-03-2020,RKI,1,1,0,1584748800000,01002,Kiel,27,0,27,247548,2086
DE-SH,22-03-2020,RKI,1,0,1,1584835200000,01002,Kiel,28,1,27,247548,2086
DE-SH,23-03-2020,RKI,10,9,1,1584921600000,01002,Kiel,38,2,36,247548,2086
DE-SH,24-03-2020,RKI,10,9,1,1585008000000,01002,Kiel,48,3,45,247548,2086
DE-SH,25-03-2020,RKI,5,5,0,1585094400000,01002,Kiel,53,3,50,247548,2086
DE-SH,26-03-2020,RKI,5,5,0,1585180800000,01002,Kiel,58,3,55,247548,2086
DE-SH,27-03-2020,RKI,11,11,0,1585267200000,01002,Kiel,69,3,66,247548,2086
DE-SH,28-03-2020,RKI,10,10,0,1585353600000,01002,Kiel,79,3,76,247548,2086
DE-SH,29-03-2020,RKI,13,12,1,1585440000000,01002,Kiel,92,4,88,247548,2086
DE-SH,30-03-2020,RKI,8,7,1,1585526400000,01002,Kiel,100,5,95,247548,2086
DE-SH,31-03-2020,RKI,2,2,0,1585612800000,01002,Kiel,102,5,97,247548,2086
DE-SH,01-04-2020,RKI,11,9,2,1585699200000,01002,Kiel,113,7,106,247548,2086
DE-SH,02-04-2020,RKI,9,9,0,1585785600000,01002,Kiel,122,7,115,247548,2086
DE-SH,03-04-2020,RKI,9,9,0,1585872000000,01002,Kiel,131,7,124,247548,2086
DE-SH,04-04-2020,RKI,2,2,0,1585958400000,01002,Kiel,133,7,126,247548,2086
DE-SH,05-04-2020,RKI,3,3,0,1586044800000,01002,Kiel,136,7,129,247548,2086
DE-SH,06-04-2020,RKI,3,2,1,1586131200000,01002,Kiel,139,8,131,247548,2086
DE-SH,07-04-2020,RKI,2,2,0,1586217600000,01002,Kiel,141,8,133,247548,2086
DE-SH,08-04-2020,RKI,4,4,0,1586304000000,01002,Kiel,145,8,137,247548,2086
DE-SH,09-04-2020,RKI,10,9,1,1586390400000,01002,Kiel,155,9,146,247548,2086
DE-SH,10-04-2020,RKI,5,5,0,1586476800000,01002,Kiel,160,9,151,247548,2086
DE-SH,11-04-2020,RKI,1,1,0,1586563200000,01002,Kiel,161,9,152,247548,2086
DE-SH,13-04-2020,RKI,2,2,0,1586736000000,01002,Kiel,163,9,154,247548,2086
DE-SH,14-04-2020,RKI,0,0,0,1586822400000,01002,Kiel,163,9,154,247548,2086
DE-SH,15-04-2020,RKI,8,8,0,1586908800000,01002,Kiel,171,9,162,247548,2086
DE-SH,16-04-2020,RKI,8,8,0,1586995200000,01002,Kiel,179,9,170,247548,2086
DE-SH,17-04-2020,RKI,1,1,0,1587081600000,01002,Kiel,180,9,171,247548,2086
DE-SH,18-04-2020,RKI,2,2,0,1587168000000,01002,Kiel,182,9,173,247548,2086
DE-SH,20-04-2020,RKI,13,12,1,1587340800000,01002,Kiel,195,10,185,247548,2086
DE-SH,21-04-2020,RKI,4,4,0,1587427200000,01002,Kiel,199,10,189,247548,2086
DE-SH,22-04-2020,RKI,3,3,0,1587513600000,01002,Kiel,202,10,192,247548,2086
DE-SH,23-04-2020,RKI,0,0,0,1587600000000,01002,Kiel,202,10,192,247548,2086
DE-SH,24-04-2020,RKI,4,4,0,1587686400000,01002,Kiel,206,10,196,247548,2086
DE-SH,25-04-2020,RKI,1,1,0,1587772800000,01002,Kiel,207,10,197,247548,2086
DE-SH,26-04-2020,RKI,0,0,0,1587859200000,01002,Kiel,207,10,197,247548,2086
DE-SH,27-04-2020,RKI,2,2,0,1587945600000,01002,Kiel,209,10,199,247548,2086
DE-SH,28-04-2020,RKI,4,4,0,1588032000000,01002,Kiel,213,10,203,247548,2086
DE-SH,29-04-2020,RKI,2,2,0,1588118400000,01002,Kiel,215,10,205,247548,2086
DE-SH,30-04-2020,RKI,0,0,0,1588204800000,01002,Kiel,215,10,205,247548,2086
DE-SH,02-05-2020,RKI,0,0,0,1588377600000,01002,Kiel,215,10,205,247548,2086
DE-SH,04-05-2020,RKI,4,4,0,1588550400000,01002,Kiel,219,10,209,247548,2086
DE-SH,05-05-2020,RKI,0,0,0,1588636800000,01002,Kiel,219,10,209,247548,2086
DE-SH,06-05-2020,RKI,1,1,0,1588723200000,01002,Kiel,220,10,210,247548,2086
DE-SH,08-05-2020,RKI,1,1,0,1588896000000,01002,Kiel,221,10,211,247548,2086
DE-SH,09-05-2020,RKI,0,0,0,1588982400000,01002,Kiel,221,10,211,247548,2086
DE-SH,11-05-2020,RKI,0,0,0,1589155200000,01002,Kiel,221,10,211,247548,2086
DE-SH,30-05-2020,RKI,0,0,0,1590796800000,01002,Kiel,221,10,211,247548,2086
DE-SH,11-06-2020,RKI,1,1,0,1591833600000,01002,Kiel,222,10,212,247548,2086
DE-SH,25-06-2020,RKI,0,0,0,1593043200000,01002,Kiel,222,10,212,247548,2086
DE-SH,26-06-2020,RKI,0,0,0,1593129600000,01002,Kiel,222,10,212,247548,2086
DE-SH,27-06-2020,RKI,0,0,0,1593216000000,01002,Kiel,222,10,212,247548,2086
DE-SH,29-06-2020,RKI,0,0,0,1593388800000,01002,Kiel,222,10,212,247548,2086
DE-SH,30-06-2020,RKI,1,1,0,1593475200000,01002,Kiel,223,10,213,247548,2086
DE-SH,01-07-2020,RKI,6,6,0,1593561600000,01002,Kiel,229,10,219,247548,2086
DE-SH,08-07-2020,RKI,1,1,0,1594166400000,01002,Kiel,230,10,220,247548,2086
DE-SH,14-07-2020,RKI,1,0,0,1594684800000,01002,Kiel,231,10,220,247548,2086
DE-SH,15-07-2020,RKI,2,0,0,1594771200000,01002,Kiel,233,10,220,247548,2086
DE-SH,16-07-2020,RKI,0,0,0,1594857600000,01002,Kiel,233,10,220,247548,2086
DE-SH,08-03-2020,RKI,0,0,0,1583625600000,01003,Lübeck,0,0,0,217198,1014
DE-SH,11-03-2020,RKI,4,4,0,1583884800000,01003,Lübeck,4,0,4,217198,1014
DE-SH,12-03-2020,RKI,0,0,0,1583971200000,01003,Lübeck,4,0,4,217198,1014
DE-SH,13-03-2020,RKI,0,0,0,1584057600000,01003,Lübeck,4,0,4,217198,1014
DE-SH,15-03-2020,RKI,0,0,0,1584230400000,01003,Lübeck,4,0,4,217198,1014
DE-SH,17-03-2020,RKI,1,1,0,1584403200000,01003,Lübeck,5,0,5,217198,1014
DE-SH,18-03-2020,RKI,3,2,1,1584489600000,01003,Lübeck,8,1,7,217198,1014
DE-SH,19-03-2020,RKI,3,3,0,1584576000000,01003,Lübeck,11,1,10,217198,1014
DE-SH,20-03-2020,RKI,17,17,0,1584662400000,01003,Lübeck,28,1,27,217198,1014
DE-SH,23-03-2020,RKI,22,22,0,1584921600000,01003,Lübeck,50,1,49,217198,1014
DE-SH,24-03-2020,RKI,1,1,0,1585008000000,01003,Lübeck,51,1,50,217198,1014
DE-SH,25-03-2020,RKI,7,7,0,1585094400000,01003,Lübeck,58,1,57,217198,1014
DE-SH,26-03-2020,RKI,0,0,0,1585180800000,01003,Lübeck,58,1,57,217198,1014
DE-SH,27-03-2020,RKI,2,2,0,1585267200000,01003,Lübeck,60,1,59,217198,1014
DE-SH,28-03-2020,RKI,7,7,0,1585353600000,01003,Lübeck,67,1,66,217198,1014
DE-SH,30-03-2020,RKI,4,4,0,1585526400000,01003,Lübeck,71,1,70,217198,1014
DE-SH,31-03-2020,RKI,3,3,0,1585612800000,01003,Lübeck,74,1,73,217198,1014
DE-SH,01-04-2020,RKI,3,3,0,1585699200000,01003,Lübeck,77,1,76,217198,1014
DE-SH,03-04-2020,RKI,2,2,0,1585872000000,01003,Lübeck,79,1,78,217198,1014
DE-SH,05-04-2020,RKI,8,8,0,1586044800000,01003,Lübeck,87,1,86,217198,1014
DE-SH,07-04-2020,RKI,5,5,0,1586217600000,01003,Lübeck,92,1,91,217198,1014
DE-SH,09-04-2020,RKI,12,12,0,1586390400000,01003,Lübeck,104,1,103,217198,1014
DE-SH,10-04-2020,RKI,0,0,0,1586476800000,01003,Lübeck,104,1,103,217198,1014
DE-SH,11-04-2020,RKI,5,5,0,1586563200000,01003,Lübeck,109,1,108,217198,1014
DE-SH,12-04-2020,RKI,0,0,0,1586649600000,01003,Lübeck,109,1,108,217198,1014
DE-SH,13-04-2020,RKI,9,9,0,1586736000000,01003,Lübeck,118,1,117,217198,1014
DE-SH,14-04-2020,RKI,2,2,0,1586822400000,01003,Lübeck,120,1,119,217198,1014
DE-SH,15-04-2020,RKI,0,0,0,1586908800000,01003,Lübeck,120,1,119,217198,1014
DE-SH,16-04-2020,RKI,0,0,0,1586995200000,01003,Lübeck,120,1,119,217198,1014
DE-SH,17-04-2020,RKI,1,1,0,1587081600000,01003,Lübeck,121,1,120,217198,1014
DE-SH,18-04-2020,RKI,0,0,0,1587168000000,01003,Lübeck,121,1,120,217198,1014
DE-SH,21-04-2020,RKI,0,0,0,1587427200000,01003,Lübeck,121,1,120,217198,1014
DE-SH,24-04-2020,RKI,2,2,0,1587686400000,01003,Lübeck,123,1,122,217198,1014
DE-SH,27-04-2020,RKI,0,0,0,1587945600000,01003,Lübeck,123,1,122,217198,1014
DE-SH,28-04-2020,RKI,0,0,0,1588032000000,01003,Lübeck,123,1,122,217198,1014
DE-SH,29-04-2020,RKI,2,2,0,1588118400000,01003,Lübeck,125,1,124,217198,1014
DE-SH,30-04-2020,RKI,0,0,0,1588204800000,01003,Lübeck,125,1,124,217198,1014
DE-SH,04-05-2020,RKI,0,0,0,1588550400000,01003,Lübeck,125,1,124,217198,1014
DE-SH,19-05-2020,RKI,0,0,0,1589846400000,01003,Lübeck,125,1,124,217198,1014
DE-SH,29-05-2020,RKI,0,0,0,1590710400000,01003,Lübeck,125,1,124,217198,1014
DE-SH,21-06-2020,RKI,1,1,0,1592697600000,01003,Lübeck,126,1,125,217198,1014
DE-SH,23-06-2020,RKI,0,0,0,1592870400000,01003,Lübeck,126,1,125,217198,1014
DE-SH,24-06-2020,RKI,0,0,0,1592956800000,01003,Lübeck,126,1,125,217198,1014
DE-SH,28-06-2020,RKI,0,0,0,1593302400000,01003,Lübeck,126,1,125,217198,1014
DE-SH,02-07-2020,RKI,1,1,0,1593648000000,01003,Lübeck,127,1,126,217198,1014
DE-SH,03-07-2020,RKI,2,2,0,1593734400000,01003,Lübeck,129,1,128,217198,1014
DE-SH,08-07-2020,RKI,0,0,0,1594166400000,01003,Lübeck,129,1,128,217198,1014
DE-SH,15-07-2020,RKI,1,0,0,1594771200000,01003,Lübeck,130,1,128,217198,1014
DE-SH,18-03-2020,RKI,3,3,0,1584489600000,01004,Neumünster,3,0,3,79487,1110
DE-SH,20-03-2020,RKI,1,1,0,1584662400000,01004,Neumünster,4,0,4,79487,1110
DE-SH,23-03-2020,RKI,2,2,0,1584921600000,01004,Neumünster,6,0,6,79487,1110
DE-SH,24-03-2020,RKI,1,1,0,1585008000000,01004,Neumünster,7,0,7,79487,1110
DE-SH,25-03-2020,RKI,0,0,0,1585094400000,01004,Neumünster,7,0,7,79487,1110
DE-SH,27-03-2020,RKI,1,1,0,1585267200000,01004,Neumünster,8,0,8,79487,1110
DE-SH,30-03-2020,RKI,4,4,0,1585526400000,01004,Neumünster,12,0,12,79487,1110
DE-SH,31-03-2020,RKI,4,4,0,1585612800000,01004,Neumünster,16,0,16,79487,1110
DE-SH,02-04-2020,RKI,3,2,1,1585785600000,01004,Neumünster,19,1,18,79487,1110
DE-SH,03-04-2020,RKI,0,0,0,1585872000000,01004,Neumünster,19,1,18,79487,1110
DE-SH,05-04-2020,RKI,1,1,0,1586044800000,01004,Neumünster,20,1,19,79487,1110
DE-SH,06-04-2020,RKI,1,1,0,1586131200000,01004,Neumünster,21,1,20,79487,1110
DE-SH,08-04-2020,RKI,1,1,0,1586304000000,01004,Neumünster,22,1,21,79487,1110
DE-SH,09-04-2020,RKI,4,4,0,1586390400000,01004,Neumünster,26,1,25,79487,1110
DE-SH,10-04-2020,RKI,0,0,0,1586476800000,01004,Neumünster,26,1,25,79487,1110
DE-SH,15-04-2020,RKI,0,0,0,1586908800000,01004,Neumünster,26,1,25,79487,1110
DE-SH,16-04-2020,RKI,2,2,0,1586995200000,01004,Neumünster,28,1,27,79487,1110
DE-SH,17-04-2020,RKI,2,2,0,1587081600000,01004,Neumünster,30,1,29,79487,1110
DE-SH,18-04-2020,RKI,0,0,0,1587168000000,01004,Neumünster,30,1,29,79487,1110
DE-SH,21-04-2020,RKI,9,9,0,1587427200000,01004,Neumünster,39,1,38,79487,1110
DE-SH,23-04-2020,RKI,1,1,0,1587600000000,01004,Neumünster,40,1,39,79487,1110
DE-SH,27-04-2020,RKI,0,0,0,1587945600000,01004,Neumünster,40,1,39,79487,1110
DE-SH,28-04-2020,RKI,0,0,0,1588032000000,01004,Neumünster,40,1,39,79487,1110
DE-SH,29-04-2020,RKI,0,0,0,1588118400000,01004,Neumünster,40,1,39,79487,1110
DE-SH,02-05-2020,RKI,0,0,0,1588377600000,01004,Neumünster,40,1,39,79487,1110
DE-SH,04-05-2020,RKI,0,0,0,1588550400000,01004,Neumünster,40,1,39,79487,1110
DE-SH,05-05-2020,RKI,1,1,0,1588636800000,01004,Neumünster,41,1,40,79487,1110
DE-SH,07-05-2020,RKI,1,1,0,1588809600000,01004,Neumünster,42,1,41,79487,1110
DE-SH,08-05-2020,RKI,2,2,0,1588896000000,01004,Neumünster,44,1,43,79487,1110
DE-SH,09-05-2020,RKI,0,0,0,1588982400000,01004,Neumünster,44,1,43,79487,1110
DE-SH,10-05-2020,RKI,1,1,0,1589068800000,01004,Neumünster,45,1,44,79487,1110
DE-SH,12-05-2020,RKI,0,0,0,1589241600000,01004,Neumünster,45,1,44,79487,1110
DE-SH,15-03-2020,RKI,4,4,0,1584230400000,01051,Dithmarschen,4,0,4,133210,93
DE-SH,18-03-2020,RKI,4,4,0,1584489600000,01051,Dithmarschen,8,0,8,133210,93
DE-SH,19-03-2020,RKI,0,0,0,1584576000000,01051,Dithmarschen,8,0,8,133210,93
DE-SH,20-03-2020,RKI,2,2,0,1584662400000,01051,Dithmarschen,10,0,10,133210,93
DE-SH,23-03-2020,RKI,0,0,0,1584921600000,01051,Dithmarschen,10,0,10,133210,93
DE-SH,24-03-2020,RKI,0,0,0,1585008000000,01051,Dithmarschen,10,0,10,133210,93
DE-SH,25-03-2020,RKI,1,1,0,1585094400000,01051,Dithmarschen,11,0,11,133210,93
DE-SH,26-03-2020,RKI,1,1,0,1585180800000,01051,Dithmarschen,12,0,12,133210,93
DE-SH,27-03-2020,RKI,2,2,0,1585267200000,01051,Dithmarschen,14,0,14,133210,93
DE-SH,30-03-2020,RKI,2,2,0,1585526400000,01051,Dithmarschen,16,0,16,133210,93
DE-SH,31-03-2020,RKI,0,0,0,1585612800000,01051,Dithmarschen,16,0,16,133210,93
DE-SH,01-04-2020,RKI,1,0,1,1585699200000,01051,Dithmarschen,17,1,16,133210,93
DE-SH,02-04-2020,RKI,3,3,0,1585785600000,01051,Dithmarschen,20,1,19,133210,93
DE-SH,03-04-2020,RKI,3,3,0,1585872000000,01051,Dithmarschen,23,1,22,133210,93
DE-SH,04-04-2020,RKI,1,1,0,1585958400000,01051,Dithmarschen,24,1,23,133210,93
DE-SH,05-04-2020,RKI,0,0,0,1586044800000,01051,Dithmarschen,24,1,23,133210,93
DE-SH,07-04-2020,RKI,1,1,0,1586217600000,01051,Dithmarschen,25,1,24,133210,93
DE-SH,08-04-2020,RKI,5,5,0,1586304000000,01051,Dithmarschen,30,1,29,133210,93
DE-SH,09-04-2020,RKI,1,0,1,1586390400000,01051,Dithmarschen,31,2,29,133210,93
DE-SH,11-04-2020,RKI,0,0,0,1586563200000,01051,Dithmarschen,31,2,29,133210,93
DE-SH,12-04-2020,RKI,0,0,0,1586649600000,01051,Dithmarschen,31,2,29,133210,93
DE-SH,14-04-2020,RKI,0,0,0,1586822400000,01051,Dithmarschen,31,2,29,133210,93
DE-SH,04-05-2020,RKI,0,0,0,1588550400000,01051,Dithmarschen,31,2,29,133210,93
DE-SH,05-05-2020,RKI,2,2,0,1588636800000,01051,Dithmarschen,33,2,31,133210,93
DE-SH,05-06-2020,RKI,0,0,0,1591315200000,01051,Dithmarschen,33,2,31,133210,93
DE-SH,07-06-2020,RKI,0,0,0,1591488000000,01051,Dithmarschen,33,2,31,133210,93
DE-SH,10-06-2020,RKI,0,0,0,1591747200000,01051,Dithmarschen,33,2,31,133210,93
DE-SH,12-06-2020,RKI,0,0,0,1591920000000,01051,Dithmarschen,33,2,31,133210,93
DE-SH,16-06-2020,RKI,0,0,0,1592265600000,01051,Dithmarschen,33,2,31,133210,93
DE-SH,18-06-2020,RKI,5,5,0,1592438400000,01051,Dithmarschen,38,2,36,133210,93
DE-SH,20-06-2020,RKI,0,0,0,1592611200000,01051,Dithmarschen,38,2,36,133210,93
DE-SH,24-06-2020,RKI,0,0,0,1592956800000,01051,Dithmarschen,38,2,36,133210,93
DE-SH,29-06-2020,RKI,0,0,0,1593388800000,01051,Dithmarschen,38,2,36,133210,93
DE-SH,30-06-2020,RKI,0,0,0,1593475200000,01051,Dithmarschen,38,2,36,133210,93
DE-SH,01-07-2020,RKI,0,0,0,1593561600000,01051,Dithmarschen,38,2,36,133210,93
DE-SH,03-07-2020,RKI,0,0,0,1593734400000,01051,Dithmarschen,38,2,36,133210,93
DE-SH,08-07-2020,RKI,0,0,0,1594166400000,01051,Dithmarschen,38,2,36,133210,93
DE-SH,10-03-2020,RKI,1,1,0,1583798400000,01053,Herzogtum Lauenburg,1,0,1,197264,156
DE-SH,11-03-2020,RKI,1,1,0,1583884800000,01053,Herzogtum Lauenburg,2,0,2,197264,156
DE-SH,12-03-2020,RKI,0,0,0,1583971200000,01053,Herzogtum Lauenburg,2,0,2,197264,156
DE-SH,13-03-2020,RKI,1,1,0,1584057600000,01053,Herzogtum Lauenburg,3,0,3,197264,156
DE-SH,16-03-2020,RKI,2,2,0,1584316800000,01053,Herzogtum Lauenburg,5,0,5,197264,156
DE-SH,17-03-2020,RKI,3,3,0,1584403200000,01053,Herzogtum Lauenburg,8,0,8,197264,156
DE-SH,18-03-2020,RKI,3,2,1,1584489600000,01053,Herzogtum Lauenburg,11,1,10,197264,156
DE-SH,19-03-2020,RKI,2,2,0,1584576000000,01053,Herzogtum Lauenburg,13,1,12,197264,156
DE-SH,21-03-2020,RKI,11,11,0,1584748800000,01053,Herzogtum Lauenburg,24,1,23,197264,156
DE-SH,22-03-2020,RKI,3,3,0,1584835200000,01053,Herzogtum Lauenburg,27,1,26,197264,156
DE-SH,23-03-2020,RKI,6,6,0,1584921600000,01053,Herzogtum Lauenburg,33,1,32,197264,156
DE-SH,24-03-2020,RKI,4,4,0,1585008000000,01053,Herzogtum Lauenburg,37,1,36,197264,156
DE-SH,25-03-2020,RKI,6,6,0,1585094400000,01053,Herzogtum Lauenburg,43,1,42,197264,156
DE-SH,26-03-2020,RKI,10,10,0,1585180800000,01053,Herzogtum Lauenburg,53,1,52,197264,156
DE-SH,27-03-2020,RKI,9,9,0,1585267200000,01053,Herzogtum Lauenburg,62,1,61,197264,156
DE-SH,30-03-2020,RKI,10,9,1,1585526400000,01053,Herzogtum Lauenburg,72,2,70,197264,156
DE-SH,31-03-2020,RKI,19,18,1,1585612800000,01053,Herzogtum Lauenburg,91,3,88,197264,156
DE-SH,01-04-2020,RKI,2,2,0,1585699200000,01053,Herzogtum Lauenburg,93,3,90,197264,156
DE-SH,02-04-2020,RKI,20,19,1,1585785600000,01053,Herzogtum Lauenburg,113,4,109,197264,156
DE-SH,03-04-2020,RKI,10,10,0,1585872000000,01053,Herzogtum Lauenburg,123,4,119,197264,156
DE-SH,04-04-2020,RKI,7,7,0,1585958400000,01053,Herzogtum Lauenburg,130,4,126,197264,156
DE-SH,06-04-2020,RKI,6,6,0,1586131200000,01053,Herzogtum Lauenburg,136,4,132,197264,156
DE-SH,07-04-2020,RKI,9,9,0,1586217600000,01053,Herzogtum Lauenburg,145,4,141,197264,156
DE-SH,08-04-2020,RKI,3,3,0,1586304000000,01053,Herzogtum Lauenburg,148,4,144,197264,156
DE-SH,09-04-2020,RKI,6,6,0,1586390400000,01053,Herzogtum Lauenburg,154,4,150,197264,156
DE-SH,11-04-2020,RKI,13,11,2,1586563200000,01053,Herzogtum Lauenburg,167,6,161,197264,156
DE-SH,13-04-2020,RKI,5,5,0,1586736000000,01053,Herzogtum Lauenburg,172,6,166,197264,156
DE-SH,14-04-2020,RKI,0,0,0,1586822400000,01053,Herzogtum Lauenburg,172,6,166,197264,156
DE-SH,15-04-2020,RKI,7,7,0,1586908800000,01053,Herzogtum Lauenburg,179,6,173,197264,156
DE-SH,16-04-2020,RKI,9,9,0,1586995200000,01053,Herzogtum Lauenburg,188,6,182,197264,156
DE-SH,17-04-2020,RKI,2,1,1,1587081600000,01053,Herzogtum Lauenburg,190,7,183,197264,156
DE-SH,18-04-2020,RKI,2,2,0,1587168000000,01053,Herzogtum Lauenburg,192,7,185,197264,156
DE-SH,20-04-2020,RKI,4,1,3,1587340800000,01053,Herzogtum Lauenburg,196,10,186,197264,156
DE-SH,21-04-2020,RKI,0,0,0,1587427200000,01053,Herzogtum Lauenburg,196,10,186,197264,156
DE-SH,22-04-2020,RKI,10,7,3,1587513600000,01053,Herzogtum Lauenburg,206,13,193,197264,156
DE-SH,23-04-2020,RKI,4,4,0,1587600000000,01053,Herzogtum Lauenburg,210,13,197,197264,156
DE-SH,24-04-2020,RKI,0,0,0,1587686400000,01053,Herzogtum Lauenburg,210,13,197,197264,156
DE-SH,25-04-2020,RKI,2,2,0,1587772800000,01053,Herzogtum Lauenburg,212,13,199,197264,156
DE-SH,27-04-2020,RKI,1,0,1,1587945600000,01053,Herzogtum Lauenburg,213,14,199,197264,156
DE-SH,28-04-2020,RKI,0,0,0,1588032000000,01053,Herzogtum Lauenburg,213,14,199,197264,156
DE-SH,30-04-2020,RKI,0,0,0,1588204800000,01053,Herzogtum Lauenburg,213,14,199,197264,156
DE-SH,06-05-2020,RKI,0,0,0,1588723200000,01053,Herzogtum Lauenburg,213,14,199,197264,156
DE-SH,07-05-2020,RKI,0,0,0,1588809600000,01053,Herzogtum Lauenburg,213,14,199,197264,156
DE-SH,11-05-2020,RKI,0,0,0,1589155200000,01053,Herzogtum Lauenburg,213,14,199,197264,156
DE-SH,13-05-2020,RKI,0,0,0,1589328000000,01053,Herzogtum Lauenburg,213,14,199,197264,156
DE-SH,02-06-2020,RKI,0,0,0,1591056000000,01053,Herzogtum Lauenburg,213,14,199,197264,156
DE-SH,18-06-2020,RKI,0,0,0,1592438400000,01053,Herzogtum Lauenburg,213,14,199,197264,156
DE-SH,24-06-2020,RKI,0,0,0,1592956800000,01053,Herzogtum Lauenburg,213,14,199,197264,156
DE-SH,25-06-2020,RKI,0,0,0,1593043200000,01053,Herzogtum Lauenburg,213,14,199,197264,156
DE-SH,30-06-2020,RKI,0,0,0,1593475200000,01053,Herzogtum Lauenburg,213,14,199,197264,156
DE-SH,15-07-2020,RKI,1,0,0,1594771200000,01053,Herzogtum Lauenburg,214,14,199,197264,156
DE-SH,17-03-2020,RKI,7,7,0,1584403200000,01054,Nordfriesland,7,0,7,165507,79
DE-SH,18-03-2020,RKI,0,0,0,1584489600000,01054,Nordfriesland,7,0,7,165507,79
DE-SH,19-03-2020,RKI,1,1,0,1584576000000,01054,Nordfriesland,8,0,8,165507,79
DE-SH,20-03-2020,RKI,2,1,1,1584662400000,01054,Nordfriesland,10,1,9,165507,79
DE-SH,21-03-2020,RKI,1,1,0,1584748800000,01054,Nordfriesland,11,1,10,165507,79
DE-SH,22-03-2020,RKI,0,0,0,1584835200000,01054,Nordfriesland,11,1,10,165507,79
DE-SH,23-03-2020,RKI,1,1,0,1584921600000,01054,Nordfriesland,12,1,11,165507,79
DE-SH,24-03-2020,RKI,1,1,0,1585008000000,01054,Nordfriesland,13,1,12,165507,79
DE-SH,25-03-2020,RKI,1,1,0,1585094400000,01054,Nordfriesland,14,1,13,165507,79
DE-SH,26-03-2020,RKI,2,2,0,1585180800000,01054,Nordfriesland,16,1,15,165507,79
DE-SH,27-03-2020,RKI,4,4,0,1585267200000,01054,Nordfriesland,20,1,19,165507,79
DE-SH,28-03-2020,RKI,3,3,0,1585353600000,01054,Nordfriesland,23,1,22,165507,79
DE-SH,29-03-2020,RKI,2,2,0,1585440000000,01054,Nordfriesland,25,1,24,165507,79
DE-SH,30-03-2020,RKI,0,0,0,1585526400000,01054,Nordfriesland,25,1,24,165507,79
DE-SH,31-03-2020,RKI,0,0,0,1585612800000,01054,Nordfriesland,25,1,24,165507,79
DE-SH,01-04-2020,RKI,1,1,0,1585699200000,01054,Nordfriesland,26,1,25,165507,79
DE-SH,02-04-2020,RKI,2,2,0,1585785600000,01054,Nordfriesland,28,1,27,165507,79
DE-SH,04-04-2020,RKI,0,0,0,1585958400000,01054,Nordfriesland,28,1,27,165507,79
DE-SH,06-04-2020,RKI,2,2,0,1586131200000,01054,Nordfriesland,30,1,29,165507,79
DE-SH,08-04-2020,RKI,5,5,0,1586304000000,01054,Nordfriesland,35,1,34,165507,79
DE-SH,09-04-2020,RKI,5,5,0,1586390400000,01054,Nordfriesland,40,1,39,165507,79
DE-SH,10-04-2020,RKI,1,1,0,1586476800000,01054,Nordfriesland,41,1,40,165507,79
DE-SH,12-04-2020,RKI,0,0,0,1586649600000,01054,Nordfriesland,41,1,40,165507,79
DE-SH,13-04-2020,RKI,1,1,0,1586736000000,01054,Nordfriesland,42,1,41,165507,79
DE-SH,15-04-2020,RKI,0,0,0,1586908800000,01054,Nordfriesland,42,1,41,165507,79
DE-SH,17-04-2020,RKI,1,1,0,1587081600000,01054,Nordfriesland,43,1,42,165507,79
DE-SH,21-04-2020,RKI,0,0,0,1587427200000,01054,Nordfriesland,43,1,42,165507,79
DE-SH,23-04-2020,RKI,3,3,0,1587600000000,01054,Nordfriesland,46,1,45,165507,79
DE-SH,24-04-2020,RKI,0,0,0,1587686400000,01054,Nordfriesland,46,1,45,165507,79
DE-SH,25-04-2020,RKI,0,0,0,1587772800000,01054,Nordfriesland,46,1,45,165507,79
DE-SH,30-04-2020,RKI,0,0,0,1588204800000,01054,Nordfriesland,46,1,45,165507,79
DE-SH,01-05-2020,RKI,1,1,0,1588291200000,01054,Nordfriesland,47,1,46,165507,79
DE-SH,05-05-2020,RKI,0,0,0,1588636800000,01054,Nordfriesland,47,1,46,165507,79
DE-SH,13-05-2020,RKI,1,1,0,1589328000000,01054,Nordfriesland,48,1,47,165507,79
DE-SH,21-05-2020,RKI,0,0,0,1590019200000,01054,Nordfriesland,48,1,47,165507,79
DE-SH,31-05-2020,RKI,2,2,0,1590883200000,01054,Nordfriesland,50,1,49,165507,79
DE-SH,01-06-2020,RKI,0,0,0,1590969600000,01054,Nordfriesland,50,1,49,165507,79
DE-SH,13-07-2020,RKI,0,0,0,1594598400000,01054,Nordfriesland,50,1,49,165507,79
DE-SH,15-03-2020,RKI,1,1,0,1584230400000,01055,Ostholstein,1,0,1,200581,144
DE-SH,16-03-2020,RKI,0,0,0,1584316800000,01055,Ostholstein,1,0,1,200581,144
DE-SH,18-03-2020,RKI,1,1,0,1584489600000,01055,Ostholstein,2,0,2,200581,144
DE-SH,19-03-2020,RKI,4,4,0,1584576000000,01055,Ostholstein,6,0,6,200581,144
DE-SH,21-03-2020,RKI,0,0,0,1584748800000,01055,Ostholstein,6,0,6,200581,144
DE-SH,23-03-2020,RKI,2,2,0,1584921600000,01055,Ostholstein,8,0,8,200581,144
DE-SH,24-03-2020,RKI,2,2,0,1585008000000,01055,Ostholstein,10,0,10,200581,144
DE-SH,25-03-2020,RKI,3,3,0,1585094400000,01055,Ostholstein,13,0,13,200581,144
DE-SH,26-03-2020,RKI,0,0,0,1585180800000,01055,Ostholstein,13,0,13,200581,144
DE-SH,28-03-2020,RKI,0,0,0,1585353600000,01055,Ostholstein,13,0,13,200581,144
DE-SH,29-03-2020,RKI,2,2,0,1585440000000,01055,Ostholstein,15,0,15,200581,144
DE-SH,30-03-2020,RKI,4,4,0,1585526400000,01055,Ostholstein,19,0,19,200581,144
DE-SH,31-03-2020,RKI,5,5,0,1585612800000,01055,Ostholstein,24,0,24,200581,144
DE-SH,01-04-2020,RKI,3,3,0,1585699200000,01055,Ostholstein,27,0,27,200581,144
DE-SH,02-04-2020,RKI,3,3,0,1585785600000,01055,Ostholstein,30,0,30,200581,144
DE-SH,03-04-2020,RKI,3,3,0,1585872000000,01055,Ostholstein,33,0,33,200581,144
DE-SH,05-04-2020,RKI,0,0,0,1586044800000,01055,Ostholstein,33,0,33,200581,144
DE-SH,08-04-2020,RKI,1,1,0,1586304000000,01055,Ostholstein,34,0,34,200581,144
DE-SH,09-04-2020,RKI,0,0,0,1586390400000,01055,Ostholstein,34,0,34,200581,144
DE-SH,10-04-2020,RKI,1,1,0,1586476800000,01055,Ostholstein,35,0,35,200581,144
DE-SH,11-04-2020,RKI,0,0,0,1586563200000,01055,Ostholstein,35,0,35,200581,144
DE-SH,16-04-2020,RKI,0,0,0,1586995200000,01055,Ostholstein,35,0,35,200581,144
DE-SH,22-04-2020,RKI,0,0,0,1587513600000,01055,Ostholstein,35,0,35,200581,144
DE-SH,23-04-2020,RKI,0,0,0,1587600000000,01055,Ostholstein,35,0,35,200581,144
DE-SH,24-04-2020,RKI,2,2,0,1587686400000,01055,Ostholstein,37,0,37,200581,144
DE-SH,25-04-2020,RKI,0,0,0,1587772800000,01055,Ostholstein,37,0,37,200581,144
DE-SH,28-04-2020,RKI,0,0,0,1588032000000,01055,Ostholstein,37,0,37,200581,144
DE-SH,29-04-2020,RKI,0,0,0,1588118400000,01055,Ostholstein,37,0,37,200581,144
DE-SH,30-04-2020,RKI,0,0,0,1588204800000,01055,Ostholstein,37,0,37,200581,144
DE-SH,21-05-2020,RKI,0,0,0,1590019200000,01055,Ostholstein,37,0,37,200581,144
DE-SH,12-07-2020,RKI,0,0,0,1594512000000,01055,Ostholstein,37,0,37,200581,144
DE-SH,13-07-2020,RKI,3,0,0,1594598400000,01055,Ostholstein,40,0,37,200581,144
DE-SH,06-03-2020,RKI,0,0,0,1583452800000,01056,Pinneberg,0,0,0,314391,473
DE-SH,09-03-2020,RKI,0,0,0,1583712000000,01056,Pinneberg,0,0,0,314391,473
DE-SH,10-03-2020,RKI,0,0,0,1583798400000,01056,Pinneberg,0,0,0,314391,473
DE-SH,11-03-2020,RKI,4,4,0,1583884800000,01056,Pinneberg,4,0,4,314391,473
DE-SH,12-03-2020,RKI,1,1,0,1583971200000,01056,Pinneberg,5,0,5,314391,473
DE-SH,13-03-2020,RKI,8,8,0,1584057600000,01056,Pinneberg,13,0,13,314391,473
DE-SH,14-03-2020,RKI,6,6,0,1584144000000,01056,Pinneberg,19,0,19,314391,473
DE-SH,15-03-2020,RKI,2,2,0,1584230400000,01056,Pinneberg,21,0,21,314391,473
DE-SH,16-03-2020,RKI,5,5,0,1584316800000,01056,Pinneberg,26,0,26,314391,473
DE-SH,17-03-2020,RKI,14,14,0,1584403200000,01056,Pinneberg,40,0,40,314391,473
DE-SH,18-03-2020,RKI,6,6,0,1584489600000,01056,Pinneberg,46,0,46,314391,473
DE-SH,19-03-2020,RKI,6,6,0,1584576000000,01056,Pinneberg,52,0,52,314391,473
DE-SH,20-03-2020,RKI,13,13,0,1584662400000,01056,Pinneberg,65,0,65,314391,473
DE-SH,21-03-2020,RKI,7,6,1,1584748800000,01056,Pinneberg,72,1,71,314391,473
DE-SH,22-03-2020,RKI,9,9,0,1584835200000,01056,Pinneberg,81,1,80,314391,473
DE-SH,23-03-2020,RKI,9,9,0,1584921600000,01056,Pinneberg,90,1,89,314391,473
DE-SH,24-03-2020,RKI,24,24,0,1585008000000,01056,Pinneberg,114,1,113,314391,473
DE-SH,25-03-2020,RKI,16,14,2,1585094400000,01056,Pinneberg,130,3,127,314391,473
DE-SH,26-03-2020,RKI,13,12,1,1585180800000,01056,Pinneberg,143,4,139,314391,473
DE-SH,27-03-2020,RKI,25,24,1,1585267200000,01056,Pinneberg,168,5,163,314391,473
DE-SH,28-03-2020,RKI,13,13,0,1585353600000,01056,Pinneberg,181,5,176,314391,473
DE-SH,29-03-2020,RKI,7,6,1,1585440000000,01056,Pinneberg,188,6,182,314391,473
DE-SH,30-03-2020,RKI,9,8,1,1585526400000,01056,Pinneberg,197,7,190,314391,473
DE-SH,31-03-2020,RKI,14,14,0,1585612800000,01056,Pinneberg,211,7,204,314391,473
DE-SH,01-04-2020,RKI,25,24,1,1585699200000,01056,Pinneberg,236,8,228,314391,473
DE-SH,02-04-2020,RKI,17,15,2,1585785600000,01056,Pinneberg,253,10,243,314391,473
DE-SH,03-04-2020,RKI,40,33,7,1585872000000,01056,Pinneberg,293,17,276,314391,473
DE-SH,04-04-2020,RKI,20,18,2,1585958400000,01056,Pinneberg,313,19,294,314391,473
DE-SH,05-04-2020,RKI,11,11,0,1586044800000,01056,Pinneberg,324,19,305,314391,473
DE-SH,06-04-2020,RKI,14,13,1,1586131200000,01056,Pinneberg,338,20,318,314391,473
DE-SH,07-04-2020,RKI,45,38,7,1586217600000,01056,Pinneberg,383,27,356,314391,473
DE-SH,08-04-2020,RKI,25,23,2,1586304000000,01056,Pinneberg,408,29,379,314391,473
DE-SH,09-04-2020,RKI,13,13,0,1586390400000,01056,Pinneberg,421,29,392,314391,473
DE-SH,10-04-2020,RKI,7,7,0,1586476800000,01056,Pinneberg,428,29,399,314391,473
DE-SH,11-04-2020,RKI,1,1,0,1586563200000,01056,Pinneberg,429,29,400,314391,473
DE-SH,12-04-2020,RKI,4,4,0,1586649600000,01056,Pinneberg,433,29,404,314391,473
DE-SH,13-04-2020,RKI,0,0,0,1586736000000,01056,Pinneberg,433,29,404,314391,473
DE-SH,14-04-2020,RKI,4,4,0,1586822400000,01056,Pinneberg,437,29,408,314391,473
DE-SH,15-04-2020,RKI,3,1,2,1586908800000,01056,Pinneberg,440,31,409,314391,473
DE-SH,16-04-2020,RKI,1,1,0,1586995200000,01056,Pinneberg,441,31,410,314391,473
DE-SH,17-04-2020,RKI,7,7,0,1587081600000,01056,Pinneberg,448,31,417,314391,473
DE-SH,18-04-2020,RKI,1,1,0,1587168000000,01056,Pinneberg,449,31,418,314391,473
DE-SH,21-04-2020,RKI,5,4,1,1587427200000,01056,Pinneberg,454,32,422,314391,473
DE-SH,22-04-2020,RKI,5,3,2,1587513600000,01056,Pinneberg,459,34,425,314391,473
DE-SH,23-04-2020,RKI,12,10,2,1587600000000,01056,Pinneberg,471,36,435,314391,473
DE-SH,24-04-2020,RKI,6,5,1,1587686400000,01056,Pinneberg,477,37,440,314391,473
DE-SH,25-04-2020,RKI,3,1,2,1587772800000,01056,Pinneberg,480,39,441,314391,473
DE-SH,26-04-2020,RKI,0,0,0,1587859200000,01056,Pinneberg,480,39,441,314391,473
DE-SH,27-04-2020,RKI,0,0,0,1587945600000,01056,Pinneberg,480,39,441,314391,473
DE-SH,28-04-2020,RKI,3,3,0,1588032000000,01056,Pinneberg,483,39,444,314391,473
DE-SH,29-04-2020,RKI,2,2,0,1588118400000,01056,Pinneberg,485,39,446,314391,473
DE-SH,30-04-2020,RKI,6,6,0,1588204800000,01056,Pinneberg,491,39,452,314391,473
DE-SH,01-05-2020,RKI,6,5,1,1588291200000,01056,Pinneberg,497,40,457,314391,473
DE-SH,02-05-2020,RKI,6,4,2,1588377600000,01056,Pinneberg,503,42,461,314391,473
DE-SH,04-05-2020,RKI,2,2,0,1588550400000,01056,Pinneberg,505,42,463,314391,473
DE-SH,05-05-2020,RKI,2,2,0,1588636800000,01056,Pinneberg,507,42,465,314391,473
DE-SH,07-05-2020,RKI,8,7,1,1588809600000,01056,Pinneberg,515,43,472,314391,473
DE-SH,08-05-2020,RKI,7,7,0,1588896000000,01056,Pinneberg,522,43,479,314391,473
DE-SH,09-05-2020,RKI,2,2,0,1588982400000,01056,Pinneberg,524,43,481,314391,473
DE-SH,10-05-2020,RKI,2,1,1,1589068800000,01056,Pinneberg,526,44,482,314391,473
DE-SH,12-05-2020,RKI,3,3,0,1589241600000,01056,Pinneberg,529,44,485,314391,473
DE-SH,13-05-2020,RKI,0,0,0,1589328000000,01056,Pinneberg,529,44,485,314391,473
DE-SH,14-05-2020,RKI,0,0,0,1589414400000,01056,Pinneberg,529,44,485,314391,473
DE-SH,15-05-2020,RKI,2,2,0,1589500800000,01056,Pinneberg,531,44,487,314391,473
DE-SH,16-05-2020,RKI,1,1,0,1589587200000,01056,Pinneberg,532,44,488,314391,473
DE-SH,19-05-2020,RKI,0,0,0,1589846400000,01056,Pinneberg,532,44,488,314391,473
DE-SH,04-07-2020,RKI,0,0,0,1593820800000,01056,Pinneberg,532,44,488,314391,473
DE-SH,07-07-2020,RKI,0,0,0,1594080000000,01056,Pinneberg,532,44,488,314391,473
DE-SH,09-07-2020,RKI,2,0,0,1594252800000,01056,Pinneberg,534,44,488,314391,473
DE-SH,14-07-2020,RKI,1,0,0,1594684800000,01056,Pinneberg,535,44,488,314391,473
DE-SH,15-07-2020,RKI,0,0,0,1594771200000,01056,Pinneberg,535,44,488,314391,473
DE-SH,14-03-2020,RKI,2,2,0,1584144000000,01057,Plön,3,0,3,128647,119
DE-SH,16-03-2020,RKI,1,1,0,1584316800000,01057,Plön,4,0,4,128647,119
DE-SH,17-03-2020,RKI,0,0,0,1584403200000,01057,Plön,4,0,4,128647,119
DE-SH,18-03-2020,RKI,1,1,0,1584489600000,01057,Plön,5,0,5,128647,119
DE-SH,19-03-2020,RKI,0,0,0,1584576000000,01057,Plön,5,0,5,128647,119
DE-SH,20-03-2020,RKI,0,0,0,1584662400000,01057,Plön,5,0,5,128647,119
DE-SH,21-03-2020,RKI,2,2,0,1584748800000,01057,Plön,7,0,7,128647,119
DE-SH,22-03-2020,RKI,3,3,0,1584835200000,01057,Plön,10,0,10,128647,119
DE-SH,23-03-2020,RKI,4,3,1,1584921600000,01057,Plön,14,1,13,128647,119
DE-SH,24-03-2020,RKI,6,6,0,1585008000000,01057,Plön,20,1,19,128647,119
DE-SH,25-03-2020,RKI,6,6,0,1585094400000,01057,Plön,26,1,25,128647,119
DE-SH,26-03-2020,RKI,6,5,1,1585180800000,01057,Plön,32,2,30,128647,119
DE-SH,27-03-2020,RKI,3,3,0,1585267200000,01057,Plön,35,2,33,128647,119
DE-SH,28-03-2020,RKI,3,2,1,1585353600000,01057,Plön,38,3,35,128647,119
DE-SH,30-03-2020,RKI,2,2,0,1585526400000,01057,Plön,40,3,37,128647,119
DE-SH,31-03-2020,RKI,1,1,0,1585612800000,01057,Plön,41,3,38,128647,119
DE-SH,01-04-2020,RKI,5,5,0,1585699200000,01057,Plön,46,3,43,128647,119
DE-SH,02-04-2020,RKI,4,4,0,1585785600000,01057,Plön,50,3,47,128647,119
DE-SH,03-04-2020,RKI,2,2,0,1585872000000,01057,Plön,52,3,49,128647,119
DE-SH,04-04-2020,RKI,0,0,0,1585958400000,01057,Plön,52,3,49,128647,119
DE-SH,05-04-2020,RKI,1,1,0,1586044800000,01057,Plön,53,3,50,128647,119
DE-SH,06-04-2020,RKI,4,2,2,1586131200000,01057,Plön,57,5,52,128647,119
DE-SH,07-04-2020,RKI,2,2,0,1586217600000,01057,Plön,59,5,54,128647,119
DE-SH,08-04-2020,RKI,5,4,1,1586304000000,01057,Plön,64,6,58,128647,119
DE-SH,09-04-2020,RKI,3,2,1,1586390400000,01057,Plön,67,7,60,128647,119
DE-SH,10-04-2020,RKI,0,0,0,1586476800000,01057,Plön,67,7,60,128647,119
DE-SH,11-04-2020,RKI,4,4,0,1586563200000,01057,Plön,71,7,64,128647,119
DE-SH,12-04-2020,RKI,0,0,0,1586649600000,01057,Plön,71,7,64,128647,119
DE-SH,16-04-2020,RKI,2,2,0,1586995200000,01057,Plön,73,7,66,128647,119
DE-SH,21-04-2020,RKI,2,2,0,1587427200000,01057,Plön,75,7,68,128647,119
DE-SH,22-04-2020,RKI,2,2,0,1587513600000,01057,Plön,77,7,70,128647,119
DE-SH,23-04-2020,RKI,1,1,0,1587600000000,01057,Plön,78,7,71,128647,119
DE-SH,24-04-2020,RKI,2,2,0,1587686400000,01057,Plön,80,7,73,128647,119
DE-SH,27-04-2020,RKI,0,0,0,1587945600000,01057,Plön,80,7,73,128647,119
DE-SH,28-04-2020,RKI,0,0,0,1588032000000,01057,Plön,80,7,73,128647,119
DE-SH,29-04-2020,RKI,0,0,0,1588118400000,01057,Plön,80,7,73,128647,119
DE-SH,30-04-2020,RKI,0,0,0,1588204800000,01057,Plön,80,7,73,128647,119
DE-SH,09-05-2020,RKI,0,0,0,1588982400000,01057,Plön,80,7,73,128647,119
DE-SH,02-07-2020,RKI,0,0,0,1593648000000,01057,Plön,80,7,73,128647,119
DE-SH,12-03-2020,RKI,2,2,0,1583971200000,01058,Rendsburg-Eckernförde,3,0,3,272775,125
DE-SH,13-03-2020,RKI,3,3,0,1584057600000,01058,Rendsburg-Eckernförde,6,0,6,272775,125
DE-SH,14-03-2020,RKI,0,0,0,1584144000000,01058,Rendsburg-Eckernförde,6,0,6,272775,125
DE-SH,15-03-2020,RKI,3,3,0,1584230400000,01058,Rendsburg-Eckernförde,9,0,9,272775,125
DE-SH,16-03-2020,RKI,1,1,0,1584316800000,01058,Rendsburg-Eckernförde,10,0,10,272775,125
DE-SH,17-03-2020,RKI,3,2,1,1584403200000,01058,Rendsburg-Eckernförde,13,1,12,272775,125
DE-SH,18-03-2020,RKI,4,4,0,1584489600000,01058,Rendsburg-Eckernförde,17,1,16,272775,125
DE-SH,19-03-2020,RKI,1,1,0,1584576000000,01058,Rendsburg-Eckernförde,18,1,17,272775,125
DE-SH,20-03-2020,RKI,6,6,0,1584662400000,01058,Rendsburg-Eckernförde,24,1,23,272775,125
DE-SH,21-03-2020,RKI,2,0,2,1584748800000,01058,Rendsburg-Eckernförde,26,3,23,272775,125
DE-SH,22-03-2020,RKI,3,2,1,1584835200000,01058,Rendsburg-Eckernförde,29,4,25,272775,125
DE-SH,23-03-2020,RKI,8,8,0,1584921600000,01058,Rendsburg-Eckernförde,37,4,33,272775,125
DE-SH,24-03-2020,RKI,13,13,0,1585008000000,01058,Rendsburg-Eckernförde,50,4,46,272775,125
DE-SH,25-03-2020,RKI,13,11,2,1585094400000,01058,Rendsburg-Eckernförde,63,6,57,272775,125
DE-SH,26-03-2020,RKI,15,13,2,1585180800000,01058,Rendsburg-Eckernförde,78,8,70,272775,125
DE-SH,27-03-2020,RKI,9,8,1,1585267200000,01058,Rendsburg-Eckernförde,87,9,78,272775,125
DE-SH,28-03-2020,RKI,10,10,0,1585353600000,01058,Rendsburg-Eckernförde,97,9,88,272775,125
DE-SH,29-03-2020,RKI,0,0,0,1585440000000,01058,Rendsburg-Eckernförde,97,9,88,272775,125
DE-SH,30-03-2020,RKI,10,9,1,1585526400000,01058,Rendsburg-Eckernförde,107,10,97,272775,125
DE-SH,31-03-2020,RKI,1,1,0,1585612800000,01058,Rendsburg-Eckernförde,108,10,98,272775,125
DE-SH,01-04-2020,RKI,6,6,0,1585699200000,01058,Rendsburg-Eckernförde,114,10,104,272775,125
DE-SH,02-04-2020,RKI,9,9,0,1585785600000,01058,Rendsburg-Eckernförde,123,10,113,272775,125
DE-SH,03-04-2020,RKI,6,6,0,1585872000000,01058,Rendsburg-Eckernförde,129,10,119,272775,125
DE-SH,04-04-2020,RKI,8,8,0,1585958400000,01058,Rendsburg-Eckernförde,137,10,127,272775,125
DE-SH,06-04-2020,RKI,5,5,0,1586131200000,01058,Rendsburg-Eckernförde,142,10,132,272775,125
DE-SH,07-04-2020,RKI,5,4,1,1586217600000,01058,Rendsburg-Eckernförde,147,11,136,272775,125
DE-SH,08-04-2020,RKI,6,6,0,1586304000000,01058,Rendsburg-Eckernförde,153,11,142,272775,125
DE-SH,09-04-2020,RKI,4,4,0,1586390400000,01058,Rendsburg-Eckernförde,157,11,146,272775,125
DE-SH,10-04-2020,RKI,3,3,0,1586476800000,01058,Rendsburg-Eckernförde,160,11,149,272775,125
DE-SH,11-04-2020,RKI,2,2,0,1586563200000,01058,Rendsburg-Eckernförde,162,11,151,272775,125
DE-SH,12-04-2020,RKI,0,0,0,1586649600000,01058,Rendsburg-Eckernförde,162,11,151,272775,125
DE-SH,15-04-2020,RKI,2,2,0,1586908800000,01058,Rendsburg-Eckernförde,164,11,153,272775,125
DE-SH,16-04-2020,RKI,6,5,1,1586995200000,01058,Rendsburg-Eckernförde,170,12,158,272775,125
DE-SH,17-04-2020,RKI,3,3,0,1587081600000,01058,Rendsburg-Eckernförde,173,12,161,272775,125
DE-SH,18-04-2020,RKI,1,1,0,1587168000000,01058,Rendsburg-Eckernförde,174,12,162,272775,125
DE-SH,19-04-2020,RKI,1,1,0,1587254400000,01058,Rendsburg-Eckernförde,175,12,163,272775,125
DE-SH,20-04-2020,RKI,2,2,0,1587340800000,01058,Rendsburg-Eckernförde,177,12,165,272775,125
DE-SH,21-04-2020,RKI,0,0,0,1587427200000,01058,Rendsburg-Eckernförde,177,12,165,272775,125
DE-SH,22-04-2020,RKI,0,0,0,1587513600000,01058,Rendsburg-Eckernförde,177,12,165,272775,125
DE-SH,23-04-2020,RKI,2,2,0,1587600000000,01058,Rendsburg-Eckernförde,179,12,167,272775,125
DE-SH,24-04-2020,RKI,3,3,0,1587686400000,01058,Rendsburg-Eckernförde,182,12,170,272775,125
DE-SH,25-04-2020,RKI,0,0,0,1587772800000,01058,Rendsburg-Eckernförde,182,12,170,272775,125
DE-SH,26-04-2020,RKI,0,0,0,1587859200000,01058,Rendsburg-Eckernförde,182,12,170,272775,125
DE-SH,28-04-2020,RKI,1,1,0,1588032000000,01058,Rendsburg-Eckernförde,183,12,171,272775,125
DE-SH,29-04-2020,RKI,1,1,0,1588118400000,01058,Rendsburg-Eckernförde,184,12,172,272775,125
DE-SH,30-04-2020,RKI,0,0,0,1588204800000,01058,Rendsburg-Eckernförde,184,12,172,272775,125
DE-SH,05-05-2020,RKI,0,0,0,1588636800000,01058,Rendsburg-Eckernförde,184,12,172,272775,125
DE-SH,06-05-2020,RKI,2,2,0,1588723200000,01058,Rendsburg-Eckernförde,186,12,174,272775,125
DE-SH,07-05-2020,RKI,2,2,0,1588809600000,01058,Rendsburg-Eckernförde,188,12,176,272775,125
DE-SH,08-05-2020,RKI,1,1,0,1588896000000,01058,Rendsburg-Eckernförde,189,12,177,272775,125
DE-SH,09-05-2020,RKI,0,0,0,1588982400000,01058,Rendsburg-Eckernförde,189,12,177,272775,125
DE-SH,10-05-2020,RKI,2,2,0,1589068800000,01058,Rendsburg-Eckernförde,191,12,179,272775,125
DE-SH,12-05-2020,RKI,1,1,0,1589241600000,01058,Rendsburg-Eckernförde,192,12,180,272775,125
DE-SH,13-05-2020,RKI,0,0,0,1589328000000,01058,Rendsburg-Eckernförde,192,12,180,272775,125
DE-SH,14-05-2020,RKI,0,0,0,1589414400000,01058,Rendsburg-Eckernförde,192,12,180,272775,125
DE-SH,26-05-2020,RKI,0,0,0,1590451200000,01058,Rendsburg-Eckernförde,192,12,180,272775,125
DE-SH,28-05-2020,RKI,0,0,0,1590624000000,01058,Rendsburg-Eckernförde,192,12,180,272775,125
DE-SH,30-05-2020,RKI,0,0,0,1590796800000,01058,Rendsburg-Eckernförde,192,12,180,272775,125
DE-SH,30-06-2020,RKI,0,0,0,1593475200000,01058,Rendsburg-Eckernförde,192,12,180,272775,125
DE-SH,02-07-2020,RKI,0,0,0,1593648000000,01058,Rendsburg-Eckernförde,192,12,180,272775,125
DE-SH,12-07-2020,RKI,0,0,0,1594512000000,01058,Rendsburg-Eckernförde,192,12,180,272775,125
DE-SH,12-03-2020,RKI,1,1,0,1583971200000,01059,Schleswig-Flensburg,1,0,1,200025,97
DE-SH,13-03-2020,RKI,2,2,0,1584057600000,01059,Schleswig-Flensburg,3,0,3,200025,97
DE-SH,14-03-2020,RKI,1,1,0,1584144000000,01059,Schleswig-Flensburg,4,0,4,200025,97
DE-SH,15-03-2020,RKI,4,4,0,1584230400000,01059,Schleswig-Flensburg,8,0,8,200025,97
DE-SH,16-03-2020,RKI,0,0,0,1584316800000,01059,Schleswig-Flensburg,8,0,8,200025,97
DE-SH,18-03-2020,RKI,2,2,0,1584489600000,01059,Schleswig-Flensburg,10,0,10,200025,97
DE-SH,19-03-2020,RKI,1,1,0,1584576000000,01059,Schleswig-Flensburg,11,0,11,200025,97
DE-SH,20-03-2020,RKI,0,0,0,1584662400000,01059,Schleswig-Flensburg,11,0,11,200025,97
DE-SH,22-03-2020,RKI,2,2,0,1584835200000,01059,Schleswig-Flensburg,13,0,13,200025,97
DE-SH,23-03-2020,RKI,0,0,0,1584921600000,01059,Schleswig-Flensburg,13,0,13,200025,97
DE-SH,24-03-2020,RKI,5,4,1,1585008000000,01059,Schleswig-Flensburg,18,1,17,200025,97
DE-SH,25-03-2020,RKI,1,1,0,1585094400000,01059,Schleswig-Flensburg,19,1,18,200025,97
DE-SH,26-03-2020,RKI,8,8,0,1585180800000,01059,Schleswig-Flensburg,27,1,26,200025,97
DE-SH,27-03-2020,RKI,9,9,0,1585267200000,01059,Schleswig-Flensburg,36,1,35,200025,97
DE-SH,28-03-2020,RKI,8,8,0,1585353600000,01059,Schleswig-Flensburg,44,1,43,200025,97
DE-SH,29-03-2020,RKI,0,0,0,1585440000000,01059,Schleswig-Flensburg,44,1,43,200025,97
DE-SH,30-03-2020,RKI,1,1,0,1585526400000,01059,Schleswig-Flensburg,45,1,44,200025,97
DE-SH,31-03-2020,RKI,10,9,1,1585612800000,01059,Schleswig-Flensburg,55,2,53,200025,97
DE-SH,01-04-2020,RKI,2,2,0,1585699200000,01059,Schleswig-Flensburg,57,2,55,200025,97
DE-SH,02-04-2020,RKI,7,7,0,1585785600000,01059,Schleswig-Flensburg,64,2,62,200025,97
DE-SH,03-04-2020,RKI,2,2,0,1585872000000,01059,Schleswig-Flensburg,66,2,64,200025,97
DE-SH,04-04-2020,RKI,1,1,0,1585958400000,01059,Schleswig-Flensburg,67,2,65,200025,97
DE-SH,07-04-2020,RKI,5,5,0,1586217600000,01059,Schleswig-Flensburg,72,2,70,200025,97
DE-SH,08-04-2020,RKI,2,2,0,1586304000000,01059,Schleswig-Flensburg,74,2,72,200025,97
DE-SH,09-04-2020,RKI,2,1,1,1586390400000,01059,Schleswig-Flensburg,76,3,73,200025,97
DE-SH,10-04-2020,RKI,0,0,0,1586476800000,01059,Schleswig-Flensburg,76,3,73,200025,97
DE-SH,11-04-2020,RKI,1,1,0,1586563200000,01059,Schleswig-Flensburg,77,3,74,200025,97
DE-SH,12-04-2020,RKI,1,1,0,1586649600000,01059,Schleswig-Flensburg,78,3,75,200025,97
DE-SH,15-04-2020,RKI,0,0,0,1586908800000,01059,Schleswig-Flensburg,78,3,75,200025,97
DE-SH,16-04-2020,RKI,1,1,0,1586995200000,01059,Schleswig-Flensburg,79,3,76,200025,97
DE-SH,17-04-2020,RKI,0,0,0,1587081600000,01059,Schleswig-Flensburg,79,3,76,200025,97
DE-SH,18-04-2020,RKI,0,0,0,1587168000000,01059,Schleswig-Flensburg,79,3,76,200025,97
DE-SH,21-04-2020,RKI,4,4,0,1587427200000,01059,Schleswig-Flensburg,83,3,80,200025,97
DE-SH,25-04-2020,RKI,0,0,0,1587772800000,01059,Schleswig-Flensburg,83,3,80,200025,97
DE-SH,26-04-2020,RKI,0,0,0,1587859200000,01059,Schleswig-Flensburg,83,3,80,200025,97
DE-SH,28-04-2020,RKI,1,1,0,1588032000000,01059,Schleswig-Flensburg,84,3,81,200025,97
DE-SH,05-05-2020,RKI,0,0,0,1588636800000,01059,Schleswig-Flensburg,84,3,81,200025,97
DE-SH,06-05-2020,RKI,0,0,0,1588723200000,01059,Schleswig-Flensburg,84,3,81,200025,97
DE-SH,07-05-2020,RKI,0,0,0,1588809600000,01059,Schleswig-Flensburg,84,3,81,200025,97
DE-SH,13-05-2020,RKI,0,0,0,1589328000000,01059,Schleswig-Flensburg,84,3,81,200025,97
DE-SH,19-05-2020,RKI,2,1,1,1589846400000,01059,Schleswig-Flensburg,86,4,82,200025,97
DE-SH,20-05-2020,RKI,1,1,0,1589932800000,01059,Schleswig-Flensburg,87,4,83,200025,97
DE-SH,21-05-2020,RKI,14,14,0,1590019200000,01059,Schleswig-Flensburg,101,4,97,200025,97
DE-SH,22-05-2020,RKI,4,4,0,1590105600000,01059,Schleswig-Flensburg,105,4,101,200025,97
DE-SH,26-05-2020,RKI,1,1,0,1590451200000,01059,Schleswig-Flensburg,106,4,102,200025,97
DE-SH,29-05-2020,RKI,0,0,0,1590710400000,01059,Schleswig-Flensburg,106,4,102,200025,97
DE-SH,08-06-2020,RKI,0,0,0,1591574400000,01059,Schleswig-Flensburg,106,4,102,200025,97
DE-SH,09-06-2020,RKI,0,0,0,1591660800000,01059,Schleswig-Flensburg,106,4,102,200025,97
DE-SH,14-07-2020,RKI,0,0,0,1594684800000,01059,Schleswig-Flensburg,106,4,102,200025,97
DE-SH,06-03-2020,RKI,0,0,0,1583452800000,01060,Segeberg,0,0,0,276032,205
DE-SH,12-03-2020,RKI,1,1,0,1583971200000,01060,Segeberg,1,0,1,276032,205
DE-SH,14-03-2020,RKI,1,1,0,1584144000000,01060,Segeberg,2,0,2,276032,205
DE-SH,16-03-2020,RKI,3,3,0,1584316800000,01060,Segeberg,5,0,5,276032,205
DE-SH,17-03-2020,RKI,3,3,0,1584403200000,01060,Segeberg,8,0,8,276032,205
DE-SH,18-03-2020,RKI,3,3,0,1584489600000,01060,Segeberg,11,0,11,276032,205
DE-SH,19-03-2020,RKI,3,3,0,1584576000000,01060,Segeberg,14,0,14,276032,205
DE-SH,20-03-2020,RKI,4,4,0,1584662400000,01060,Segeberg,18,0,18,276032,205
DE-SH,21-03-2020,RKI,1,1,0,1584748800000,01060,Segeberg,19,0,19,276032,205
DE-SH,22-03-2020,RKI,0,0,0,1584835200000,01060,Segeberg,19,0,19,276032,205
DE-SH,23-03-2020,RKI,3,3,0,1584921600000,01060,Segeberg,22,0,22,276032,205
DE-SH,24-03-2020,RKI,8,8,0,1585008000000,01060,Segeberg,30,0,30,276032,205
DE-SH,25-03-2020,RKI,4,4,0,1585094400000,01060,Segeberg,34,0,34,276032,205
DE-SH,26-03-2020,RKI,5,5,0,1585180800000,01060,Segeberg,39,0,39,276032,205
DE-SH,27-03-2020,RKI,7,7,0,1585267200000,01060,Segeberg,46,0,46,276032,205
DE-SH,28-03-2020,RKI,8,8,0,1585353600000,01060,Segeberg,54,0,54,276032,205
DE-SH,29-03-2020,RKI,6,6,0,1585440000000,01060,Segeberg,60,0,60,276032,205
DE-SH,30-03-2020,RKI,0,0,0,1585526400000,01060,Segeberg,60,0,60,276032,205
DE-SH,31-03-2020,RKI,12,12,0,1585612800000,01060,Segeberg,72,0,72,276032,205
DE-SH,01-04-2020,RKI,15,14,1,1585699200000,01060,Segeberg,87,1,86,276032,205
DE-SH,02-04-2020,RKI,8,8,0,1585785600000,01060,Segeberg,95,1,94,276032,205
DE-SH,03-04-2020,RKI,13,13,0,1585872000000,01060,Segeberg,108,1,107,276032,205
DE-SH,04-04-2020,RKI,7,6,1,1585958400000,01060,Segeberg,115,2,113,276032,205
DE-SH,05-04-2020,RKI,1,0,1,1586044800000,01060,Segeberg,116,3,113,276032,205
DE-SH,06-04-2020,RKI,8,8,0,1586131200000,01060,Segeberg,124,3,121,276032,205
DE-SH,07-04-2020,RKI,11,11,0,1586217600000,01060,Segeberg,135,3,132,276032,205
DE-SH,08-04-2020,RKI,6,6,0,1586304000000,01060,Segeberg,141,3,138,276032,205
DE-SH,09-04-2020,RKI,7,7,0,1586390400000,01060,Segeberg,148,3,145,276032,205
DE-SH,10-04-2020,RKI,3,3,0,1586476800000,01060,Segeberg,151,3,148,276032,205
DE-SH,11-04-2020,RKI,0,0,0,1586563200000,01060,Segeberg,151,3,148,276032,205
DE-SH,12-04-2020,RKI,1,1,0,1586649600000,01060,Segeberg,152,3,149,276032,205
DE-SH,13-04-2020,RKI,5,5,0,1586736000000,01060,Segeberg,157,3,154,276032,205
DE-SH,14-04-2020,RKI,2,2,0,1586822400000,01060,Segeberg,159,3,156,276032,205
DE-SH,15-04-2020,RKI,3,2,1,1586908800000,01060,Segeberg,162,4,158,276032,205
DE-SH,16-04-2020,RKI,2,2,0,1586995200000,01060,Segeberg,164,4,160,276032,205
DE-SH,17-04-2020,RKI,1,1,0,1587081600000,01060,Segeberg,165,4,161,276032,205
DE-SH,18-04-2020,RKI,2,2,0,1587168000000,01060,Segeberg,167,4,163,276032,205
DE-SH,20-04-2020,RKI,0,0,0,1587340800000,01060,Segeberg,167,4,163,276032,205
DE-SH,24-04-2020,RKI,4,4,0,1587686400000,01060,Segeberg,171,4,167,276032,205
DE-SH,25-04-2020,RKI,0,0,0,1587772800000,01060,Segeberg,171,4,167,276032,205
DE-SH,26-04-2020,RKI,0,0,0,1587859200000,01060,Segeberg,171,4,167,276032,205
DE-SH,27-04-2020,RKI,0,0,0,1587945600000,01060,Segeberg,171,4,167,276032,205
DE-SH,28-04-2020,RKI,1,1,0,1588032000000,01060,Segeberg,172,4,168,276032,205
DE-SH,29-04-2020,RKI,1,1,0,1588118400000,01060,Segeberg,173,4,169,276032,205
DE-SH,30-04-2020,RKI,2,2,0,1588204800000,01060,Segeberg,175,4,171,276032,205
DE-SH,01-05-2020,RKI,1,1,0,1588291200000,01060,Segeberg,176,4,172,276032,205
DE-SH,02-05-2020,RKI,0,0,0,1588377600000,01060,Segeberg,176,4,172,276032,205
DE-SH,03-05-2020,RKI,0,0,0,1588464000000,01060,Segeberg,176,4,172,276032,205
DE-SH,04-05-2020,RKI,2,2,0,1588550400000,01060,Segeberg,178,4,174,276032,205
DE-SH,05-05-2020,RKI,4,4,0,1588636800000,01060,Segeberg,182,4,178,276032,205
DE-SH,06-05-2020,RKI,4,4,0,1588723200000,01060,Segeberg,186,4,182,276032,205
DE-SH,07-05-2020,RKI,17,17,0,1588809600000,01060,Segeberg,203,4,199,276032,205
DE-SH,08-05-2020,RKI,3,3,0,1588896000000,01060,Segeberg,206,4,202,276032,205
DE-SH,09-05-2020,RKI,10,10,0,1588982400000,01060,Segeberg,216,4,212,276032,205
DE-SH,10-05-2020,RKI,7,7,0,1589068800000,01060,Segeberg,223,4,219,276032,205
DE-SH,11-05-2020,RKI,1,1,0,1589155200000,01060,Segeberg,224,4,220,276032,205
DE-SH,12-05-2020,RKI,6,6,0,1589241600000,01060,Segeberg,230,4,226,276032,205
DE-SH,13-05-2020,RKI,0,0,0,1589328000000,01060,Segeberg,230,4,226,276032,205
DE-SH,14-05-2020,RKI,1,1,0,1589414400000,01060,Segeberg,231,4,227,276032,205
DE-SH,15-05-2020,RKI,3,3,0,1589500800000,01060,Segeberg,234,4,230,276032,205
DE-SH,19-05-2020,RKI,3,3,0,1589846400000,01060,Segeberg,237,4,233,276032,205
DE-SH,20-05-2020,RKI,3,3,0,1589932800000,01060,Segeberg,240,4,236,276032,205
DE-SH,21-05-2020,RKI,0,0,0,1590019200000,01060,Segeberg,240,4,236,276032,205
DE-SH,22-05-2020,RKI,8,7,1,1590105600000,01060,Segeberg,248,5,243,276032,205
DE-SH,28-05-2020,RKI,0,0,0,1590624000000,01060,Segeberg,248,5,243,276032,205
DE-SH,29-05-2020,RKI,7,5,2,1590710400000,01060,Segeberg,255,7,248,276032,205
DE-SH,30-05-2020,RKI,0,0,0,1590796800000,01060,Segeberg,255,7,248,276032,205
DE-SH,01-06-2020,RKI,3,3,0,1590969600000,01060,Segeberg,258,7,251,276032,205
DE-SH,05-06-2020,RKI,0,0,0,1591315200000,01060,Segeberg,258,7,251,276032,205
DE-SH,19-06-2020,RKI,0,0,0,1592524800000,01060,Segeberg,258,7,251,276032,205
DE-SH,24-06-2020,RKI,0,0,0,1592956800000,01060,Segeberg,258,7,251,276032,205
DE-SH,01-07-2020,RKI,1,1,0,1593561600000,01060,Segeberg,259,7,252,276032,205
DE-SH,02-07-2020,RKI,0,0,0,1593648000000,01060,Segeberg,259,7,252,276032,205
DE-SH,04-07-2020,RKI,0,0,0,1593820800000,01060,Segeberg,259,7,252,276032,205
DE-SH,07-07-2020,RKI,0,0,0,1594080000000,01060,Segeberg,259,7,252,276032,205
DE-SH,12-07-2020,RKI,5,0,0,1594512000000,01060,Segeberg,264,7,252,276032,205
DE-SH,13-07-2020,RKI,1,0,0,1594598400000,01060,Segeberg,265,7,252,276032,205
DE-SH,14-07-2020,RKI,2,0,0,1594684800000,01060,Segeberg,267,7,252,276032,205
DE-SH,16-07-2020,RKI,0,0,0,1594857600000,01060,Segeberg,267,7,252,276032,205
DE-SH,14-03-2020,RKI,0,0,0,1584144000000,01061,Steinburg,0,0,0,131347,124
DE-SH,19-03-2020,RKI,3,3,0,1584576000000,01061,Steinburg,3,0,3,131347,124
DE-SH,20-03-2020,RKI,4,4,0,1584662400000,01061,Steinburg,7,0,7,131347,124
DE-SH,23-03-2020,RKI,6,6,0,1584921600000,01061,Steinburg,13,0,13,131347,124
DE-SH,24-03-2020,RKI,0,0,0,1585008000000,01061,Steinburg,13,0,13,131347,124
DE-SH,25-03-2020,RKI,2,2,0,1585094400000,01061,Steinburg,15,0,15,131347,124
DE-SH,26-03-2020,RKI,4,4,0,1585180800000,01061,Steinburg,19,0,19,131347,124
DE-SH,27-03-2020,RKI,7,7,0,1585267200000,01061,Steinburg,26,0,26,131347,124
DE-SH,30-03-2020,RKI,3,2,1,1585526400000,01061,Steinburg,29,1,28,131347,124
DE-SH,31-03-2020,RKI,2,2,0,1585612800000,01061,Steinburg,31,1,30,131347,124
DE-SH,01-04-2020,RKI,6,5,1,1585699200000,01061,Steinburg,37,2,35,131347,124
DE-SH,02-04-2020,RKI,1,1,0,1585785600000,01061,Steinburg,38,2,36,131347,124
DE-SH,03-04-2020,RKI,0,0,0,1585872000000,01061,Steinburg,38,2,36,131347,124
DE-SH,04-04-2020,RKI,0,0,0,1585958400000,01061,Steinburg,38,2,36,131347,124
DE-SH,06-04-2020,RKI,5,5,0,1586131200000,01061,Steinburg,43,2,41,131347,124
DE-SH,07-04-2020,RKI,4,3,1,1586217600000,01061,Steinburg,47,3,44,131347,124
DE-SH,08-04-2020,RKI,3,3,0,1586304000000,01061,Steinburg,50,3,47,131347,124
DE-SH,09-04-2020,RKI,1,1,0,1586390400000,01061,Steinburg,51,3,48,131347,124
DE-SH,10-04-2020,RKI,1,1,0,1586476800000,01061,Steinburg,52,3,49,131347,124
DE-SH,15-04-2020,RKI,1,1,0,1586908800000,01061,Steinburg,53,3,50,131347,124
DE-SH,16-04-2020,RKI,0,0,0,1586995200000,01061,Steinburg,53,3,50,131347,124
DE-SH,17-04-2020,RKI,0,0,0,1587081600000,01061,Steinburg,53,3,50,131347,124
DE-SH,19-04-2020,RKI,1,1,0,1587254400000,01061,Steinburg,54,3,51,131347,124
DE-SH,22-04-2020,RKI,1,1,0,1587513600000,01061,Steinburg,55,3,52,131347,124
DE-SH,24-04-2020,RKI,0,0,0,1587686400000,01061,Steinburg,55,3,52,131347,124
DE-SH,30-04-2020,RKI,1,1,0,1588204800000,01061,Steinburg,56,3,53,131347,124
DE-SH,03-05-2020,RKI,47,47,0,1588464000000,01061,Steinburg,103,3,100,131347,124
DE-SH,05-05-2020,RKI,28,28,0,1588636800000,01061,Steinburg,131,3,128,131347,124
DE-SH,06-05-2020,RKI,0,0,0,1588723200000,01061,Steinburg,131,3,128,131347,124
DE-SH,10-05-2020,RKI,1,1,0,1589068800000,01061,Steinburg,132,3,129,131347,124
DE-SH,12-05-2020,RKI,0,0,0,1589241600000,01061,Steinburg,132,3,129,131347,124
DE-SH,13-05-2020,RKI,3,3,0,1589328000000,01061,Steinburg,135,3,132,131347,124
DE-SH,14-05-2020,RKI,0,0,0,1589414400000,01061,Steinburg,135,3,132,131347,124
DE-SH,20-05-2020,RKI,2,2,0,1589932800000,01061,Steinburg,137,3,134,131347,124
DE-SH,26-05-2020,RKI,0,0,0,1590451200000,01061,Steinburg,137,3,134,131347,124
DE-SH,28-05-2020,RKI,2,2,0,1590624000000,01061,Steinburg,139,3,136,131347,124
DE-SH,08-06-2020,RKI,0,0,0,1591574400000,01061,Steinburg,139,3,136,131347,124
DE-SH,11-06-2020,RKI,0,0,0,1591833600000,01061,Steinburg,139,3,136,131347,124
DE-SH,15-06-2020,RKI,0,0,0,1592179200000,01061,Steinburg,139,3,136,131347,124
DE-SH,19-06-2020,RKI,0,0,0,1592524800000,01061,Steinburg,139,3,136,131347,124
DE-SH,29-06-2020,RKI,0,0,0,1593388800000,01061,Steinburg,139,3,136,131347,124
DE-SH,05-07-2020,RKI,4,0,0,1593907200000,01061,Steinburg,143,3,136,131347,124
DE-SH,13-07-2020,RKI,0,0,0,1594598400000,01061,Steinburg,143,3,136,131347,124
DE-SH,12-03-2020,RKI,1,1,0,1583971200000,01062,Stormarn,1,0,1,243196,317
DE-SH,13-03-2020,RKI,2,2,0,1584057600000,01062,Stormarn,3,0,3,243196,317
DE-SH,14-03-2020,RKI,0,0,0,1584144000000,01062,Stormarn,3,0,3,243196,317
DE-SH,15-03-2020,RKI,0,0,0,1584230400000,01062,Stormarn,3,0,3,243196,317
DE-SH,16-03-2020,RKI,3,3,0,1584316800000,01062,Stormarn,6,0,6,243196,317
DE-SH,17-03-2020,RKI,5,4,1,1584403200000,01062,Stormarn,11,1,10,243196,317
DE-SH,18-03-2020,RKI,4,3,1,1584489600000,01062,Stormarn,15,2,13,243196,317
DE-SH,19-03-2020,RKI,9,9,0,1584576000000,01062,Stormarn,24,2,22,243196,317
DE-SH,20-03-2020,RKI,12,12,0,1584662400000,01062,Stormarn,36,2,34,243196,317
DE-SH,21-03-2020,RKI,10,10,0,1584748800000,01062,Stormarn,46,2,44,243196,317
DE-SH,22-03-2020,RKI,4,3,1,1584835200000,01062,Stormarn,50,3,47,243196,317
DE-SH,23-03-2020,RKI,7,6,1,1584921600000,01062,Stormarn,57,4,53,243196,317
DE-SH,24-03-2020,RKI,10,10,0,1585008000000,01062,Stormarn,67,4,63,243196,317
DE-SH,25-03-2020,RKI,8,8,0,1585094400000,01062,Stormarn,75,4,71,243196,317
DE-SH,26-03-2020,RKI,8,8,0,1585180800000,01062,Stormarn,83,4,79,243196,317
DE-SH,27-03-2020,RKI,13,13,0,1585267200000,01062,Stormarn,96,4,92,243196,317
DE-SH,28-03-2020,RKI,8,8,0,1585353600000,01062,Stormarn,104,4,100,243196,317
DE-SH,29-03-2020,RKI,4,4,0,1585440000000,01062,Stormarn,108,4,104,243196,317
DE-SH,30-03-2020,RKI,5,5,0,1585526400000,01062,Stormarn,113,4,109,243196,317
DE-SH,31-03-2020,RKI,14,12,2,1585612800000,01062,Stormarn,127,6,121,243196,317
DE-SH,01-04-2020,RKI,9,8,1,1585699200000,01062,Stormarn,136,7,129,243196,317
DE-SH,02-04-2020,RKI,13,13,0,1585785600000,01062,Stormarn,149,7,142,243196,317
DE-SH,03-04-2020,RKI,7,7,0,1585872000000,01062,Stormarn,156,7,149,243196,317
DE-SH,04-04-2020,RKI,11,11,0,1585958400000,01062,Stormarn,167,7,160,243196,317
DE-SH,05-04-2020,RKI,2,2,0,1586044800000,01062,Stormarn,169,7,162,243196,317
DE-SH,06-04-2020,RKI,2,2,0,1586131200000,01062,Stormarn,171,7,164,243196,317
DE-SH,07-04-2020,RKI,11,9,2,1586217600000,01062,Stormarn,182,9,173,243196,317
DE-SH,08-04-2020,RKI,11,9,2,1586304000000,01062,Stormarn,193,11,182,243196,317
DE-SH,09-04-2020,RKI,9,8,1,1586390400000,01062,Stormarn,202,12,190,243196,317
DE-SH,10-04-2020,RKI,0,0,0,1586476800000,01062,Stormarn,202,12,190,243196,317
DE-SH,11-04-2020,RKI,3,3,0,1586563200000,01062,Stormarn,205,12,193,243196,317
DE-SH,12-04-2020,RKI,0,0,0,1586649600000,01062,Stormarn,205,12,193,243196,317
DE-SH,13-04-2020,RKI,69,57,12,1586736000000,01062,Stormarn,274,24,250,243196,317
DE-SH,14-04-2020,RKI,2,1,1,1586822400000,01062,Stormarn,276,25,251,243196,317
DE-SH,15-04-2020,RKI,6,6,0,1586908800000,01062,Stormarn,282,25,257,243196,317
DE-SH,16-04-2020,RKI,8,6,2,1586995200000,01062,Stormarn,290,27,263,243196,317
DE-SH,17-04-2020,RKI,11,9,2,1587081600000,01062,Stormarn,301,29,272,243196,317
DE-SH,18-04-2020,RKI,8,7,1,1587168000000,01062,Stormarn,309,30,279,243196,317
DE-SH,19-04-2020,RKI,4,3,1,1587254400000,01062,Stormarn,313,31,282,243196,317
DE-SH,20-04-2020,RKI,4,4,0,1587340800000,01062,Stormarn,317,31,286,243196,317
DE-SH,21-04-2020,RKI,4,3,1,1587427200000,01062,Stormarn,321,32,289,243196,317
DE-SH,22-04-2020,RKI,5,5,0,1587513600000,01062,Stormarn,326,32,294,243196,317
DE-SH,23-04-2020,RKI,8,8,0,1587600000000,01062,Stormarn,334,32,302,243196,317
DE-SH,24-04-2020,RKI,4,4,0,1587686400000,01062,Stormarn,338,32,306,243196,317
DE-SH,25-04-2020,RKI,2,2,0,1587772800000,01062,Stormarn,340,32,308,243196,317
DE-SH,26-04-2020,RKI,0,0,0,1587859200000,01062,Stormarn,340,32,308,243196,317
DE-SH,27-04-2020,RKI,2,2,0,1587945600000,01062,Stormarn,342,32,310,243196,317
DE-SH,28-04-2020,RKI,0,0,0,1588032000000,01062,Stormarn,342,32,310,243196,317
DE-SH,29-04-2020,RKI,1,1,0,1588118400000,01062,Stormarn,343,32,311,243196,317
DE-SH,01-05-2020,RKI,1,1,0,1588291200000,01062,Stormarn,344,32,312,243196,317
DE-SH,02-05-2020,RKI,0,0,0,1588377600000,01062,Stormarn,344,32,312,243196,317
DE-SH,05-05-2020,RKI,0,0,0,1588636800000,01062,Stormarn,344,32,312,243196,317
DE-SH,06-05-2020,RKI,1,1,0,1588723200000,01062,Stormarn,345,32,313,243196,317
DE-SH,08-05-2020,RKI,1,1,0,1588896000000,01062,Stormarn,346,32,314,243196,317
DE-SH,09-05-2020,RKI,0,0,0,1588982400000,01062,Stormarn,346,32,314,243196,317
DE-SH,10-05-2020,RKI,1,1,0,1589068800000,01062,Stormarn,347,32,315,243196,317
DE-SH,11-05-2020,RKI,0,0,0,1589155200000,01062,Stormarn,347,32,315,243196,317
DE-SH,12-05-2020,RKI,0,0,0,1589241600000,01062,Stormarn,347,32,315,243196,317
DE-SH,19-05-2020,RKI,4,4,0,1589846400000,01062,Stormarn,351,32,319,243196,317
DE-SH,22-05-2020,RKI,1,1,0,1590105600000,01062,Stormarn,352,32,320,243196,317
DE-SH,26-05-2020,RKI,1,1,0,1590451200000,01062,Stormarn,353,32,321,243196,317
DE-SH,28-05-2020,RKI,0,0,0,1590624000000,01062,Stormarn,353,32,321,243196,317
DE-SH,29-05-2020,RKI,1,1,0,1590710400000,01062,Stormarn,354,32,322,243196,317
DE-SH,06-06-2020,RKI,0,0,0,1591401600000,01062,Stormarn,354,32,322,243196,317
DE-SH,15-06-2020,RKI,0,0,0,1592179200000,01062,Stormarn,354,32,322,243196,317
DE-SH,25-06-2020,RKI,1,1,0,1593043200000,01062,Stormarn,355,32,323,243196,317
DE-SH,27-06-2020,RKI,1,1,0,1593216000000,01062,Stormarn,356,32,324,243196,317
DE-SH,01-07-2020,RKI,1,1,0,1593561600000,01062,Stormarn,357,32,325,243196,317
DE-SH,04-07-2020,RKI,0,0,0,1593820800000,01062,Stormarn,357,32,325,243196,317
DE-SH,07-07-2020,RKI,1,0,0,1594080000000,01062,Stormarn,358,32,325,243196,317
DE-SH,08-07-2020,RKI,2,1,1,1594166400000,01062,Stormarn,360,33,326,243196,317
DE-SH,10-07-2020,RKI,0,0,0,1594339200000,01062,Stormarn,360,33,326,243196,317
DE-TH,10-03-2020,RKI,0,0,0,1583798400000,16051,Erfurt,0,0,0,213699,792
DE-TH,13-03-2020,RKI,1,1,0,1584057600000,16051,Erfurt,1,0,1,213699,792
DE-TH,14-03-2020,RKI,5,5,0,1584144000000,16051,Erfurt,6,0,6,213699,792
DE-TH,16-03-2020,RKI,5,5,0,1584316800000,16051,Erfurt,11,0,11,213699,792
DE-TH,18-03-2020,RKI,0,0,0,1584489600000,16051,Erfurt,11,0,11,213699,792
DE-TH,19-03-2020,RKI,8,8,0,1584576000000,16051,Erfurt,19,0,19,213699,792
DE-TH,20-03-2020,RKI,1,1,0,1584662400000,16051,Erfurt,20,0,20,213699,792
DE-TH,21-03-2020,RKI,0,0,0,1584748800000,16051,Erfurt,20,0,20,213699,792
DE-TH,22-03-2020,RKI,0,0,0,1584835200000,16051,Erfurt,20,0,20,213699,792
DE-TH,23-03-2020,RKI,12,12,0,1584921600000,16051,Erfurt,32,0,32,213699,792
DE-TH,24-03-2020,RKI,9,9,0,1585008000000,16051,Erfurt,41,0,41,213699,792
DE-TH,25-03-2020,RKI,7,7,0,1585094400000,16051,Erfurt,48,0,48,213699,792
DE-TH,26-03-2020,RKI,5,5,0,1585180800000,16051,Erfurt,53,0,53,213699,792
DE-TH,27-03-2020,RKI,4,4,0,1585267200000,16051,Erfurt,57,0,57,213699,792
DE-TH,28-03-2020,RKI,2,2,0,1585353600000,16051,Erfurt,59,0,59,213699,792
DE-TH,29-03-2020,RKI,1,1,0,1585440000000,16051,Erfurt,60,0,60,213699,792
DE-TH,31-03-2020,RKI,4,4,0,1585612800000,16051,Erfurt,64,0,64,213699,792
DE-TH,01-04-2020,RKI,4,4,0,1585699200000,16051,Erfurt,68,0,68,213699,792
DE-TH,02-04-2020,RKI,1,1,0,1585785600000,16051,Erfurt,69,0,69,213699,792
DE-TH,03-04-2020,RKI,2,2,0,1585872000000,16051,Erfurt,71,0,71,213699,792
DE-TH,04-04-2020,RKI,1,0,1,1585958400000,16051,Erfurt,72,1,71,213699,792
DE-TH,05-04-2020,RKI,0,0,0,1586044800000,16051,Erfurt,72,1,71,213699,792
DE-TH,06-04-2020,RKI,1,1,0,1586131200000,16051,Erfurt,73,1,72,213699,792
DE-TH,07-04-2020,RKI,5,4,1,1586217600000,16051,Erfurt,78,2,76,213699,792
DE-TH,08-04-2020,RKI,3,3,0,1586304000000,16051,Erfurt,81,2,79,213699,792
DE-TH,09-04-2020,RKI,0,0,0,1586390400000,16051,Erfurt,81,2,79,213699,792
DE-TH,10-04-2020,RKI,1,1,0,1586476800000,16051,Erfurt,82,2,80,213699,792
DE-TH,12-04-2020,RKI,1,1,0,1586649600000,16051,Erfurt,83,2,81,213699,792
DE-TH,13-04-2020,RKI,0,0,0,1586736000000,16051,Erfurt,83,2,81,213699,792
DE-TH,14-04-2020,RKI,1,1,0,1586822400000,16051,Erfurt,84,2,82,213699,792
DE-TH,15-04-2020,RKI,1,1,0,1586908800000,16051,Erfurt,85,2,83,213699,792
DE-TH,16-04-2020,RKI,2,2,0,1586995200000,16051,Erfurt,87,2,85,213699,792
DE-TH,17-04-2020,RKI,0,0,0,1587081600000,16051,Erfurt,87,2,85,213699,792
DE-TH,19-04-2020,RKI,0,0,0,1587254400000,16051,Erfurt,87,2,85,213699,792
DE-TH,21-04-2020,RKI,2,2,0,1587427200000,16051,Erfurt,89,2,87,213699,792
DE-TH,22-04-2020,RKI,3,3,0,1587513600000,16051,Erfurt,92,2,90,213699,792
DE-TH,23-04-2020,RKI,0,0,0,1587600000000,16051,Erfurt,92,2,90,213699,792
DE-TH,25-04-2020,RKI,0,0,0,1587772800000,16051,Erfurt,92,2,90,213699,792
DE-TH,27-04-2020,RKI,0,0,0,1587945600000,16051,Erfurt,92,2,90,213699,792
DE-TH,02-05-2020,RKI,0,0,0,1588377600000,16051,Erfurt,92,2,90,213699,792
DE-TH,06-05-2020,RKI,0,0,0,1588723200000,16051,Erfurt,92,2,90,213699,792
DE-TH,15-05-2020,RKI,0,0,0,1589500800000,16051,Erfurt,92,2,90,213699,792
DE-TH,27-05-2020,RKI,0,0,0,1590537600000,16051,Erfurt,92,2,90,213699,792
DE-TH,02-06-2020,RKI,0,0,0,1591056000000,16051,Erfurt,92,2,90,213699,792
DE-TH,15-06-2020,RKI,0,0,0,1592179200000,16051,Erfurt,92,2,90,213699,792
DE-TH,02-07-2020,RKI,0,0,0,1593648000000,16051,Erfurt,92,2,90,213699,792
DE-TH,17-03-2020,RKI,0,0,0,1584403200000,16052,Gera,0,0,0,94152,619
DE-TH,18-03-2020,RKI,1,1,0,1584489600000,16052,Gera,1,0,1,94152,619
DE-TH,23-03-2020,RKI,1,1,0,1584921600000,16052,Gera,2,0,2,94152,619
DE-TH,24-03-2020,RKI,0,0,0,1585008000000,16052,Gera,2,0,2,94152,619
DE-TH,26-03-2020,RKI,0,0,0,1585180800000,16052,Gera,2,0,2,94152,619
DE-TH,27-03-2020,RKI,5,5,0,1585267200000,16052,Gera,7,0,7,94152,619
DE-TH,28-03-2020,RKI,4,4,0,1585353600000,16052,Gera,11,0,11,94152,619
DE-TH,01-04-2020,RKI,3,3,0,1585699200000,16052,Gera,14,0,14,94152,619
DE-TH,02-04-2020,RKI,7,7,0,1585785600000,16052,Gera,21,0,21,94152,619
DE-TH,03-04-2020,RKI,1,1,0,1585872000000,16052,Gera,22,0,22,94152,619
DE-TH,06-04-2020,RKI,0,0,0,1586131200000,16052,Gera,22,0,22,94152,619
DE-TH,07-04-2020,RKI,2,2,0,1586217600000,16052,Gera,24,0,24,94152,619
DE-TH,08-04-2020,RKI,1,1,0,1586304000000,16052,Gera,25,0,25,94152,619
DE-TH,09-04-2020,RKI,8,7,1,1586390400000,16052,Gera,33,1,32,94152,619
DE-TH,11-04-2020,RKI,1,1,0,1586563200000,16052,Gera,34,1,33,94152,619
DE-TH,12-04-2020,RKI,4,1,3,1586649600000,16052,Gera,38,4,34,94152,619
DE-TH,14-04-2020,RKI,10,6,4,1586822400000,16052,Gera,48,8,40,94152,619
DE-TH,15-04-2020,RKI,6,5,1,1586908800000,16052,Gera,54,9,45,94152,619
DE-TH,16-04-2020,RKI,4,4,0,1586995200000,16052,Gera,58,9,49,94152,619
DE-TH,17-04-2020,RKI,0,0,0,1587081600000,16052,Gera,58,9,49,94152,619
DE-TH,18-04-2020,RKI,7,7,0,1587168000000,16052,Gera,65,9,56,94152,619
DE-TH,19-04-2020,RKI,1,1,0,1587254400000,16052,Gera,66,9,57,94152,619
DE-TH,20-04-2020,RKI,2,1,1,1587340800000,16052,Gera,68,10,58,94152,619
DE-TH,21-04-2020,RKI,14,13,1,1587427200000,16052,Gera,82,11,71,94152,619
DE-TH,22-04-2020,RKI,5,5,0,1587513600000,16052,Gera,87,11,76,94152,619
DE-TH,23-04-2020,RKI,8,8,0,1587600000000,16052,Gera,95,11,84,94152,619
DE-TH,24-04-2020,RKI,8,8,0,1587686400000,16052,Gera,103,11,92,94152,619
DE-TH,25-04-2020,RKI,0,0,0,1587772800000,16052,Gera,103,11,92,94152,619
DE-TH,26-04-2020,RKI,2,2,0,1587859200000,16052,Gera,105,11,94,94152,619
DE-TH,27-04-2020,RKI,2,2,0,1587945600000,16052,Gera,107,11,96,94152,619
DE-TH,28-04-2020,RKI,7,7,0,1588032000000,16052,Gera,114,11,103,94152,619
DE-TH,29-04-2020,RKI,2,2,0,1588118400000,16052,Gera,116,11,105,94152,619
DE-TH,30-04-2020,RKI,6,5,1,1588204800000,16052,Gera,122,12,110,94152,619
DE-TH,01-05-2020,RKI,0,0,0,1588291200000,16052,Gera,122,12,110,94152,619
DE-TH,02-05-2020,RKI,3,3,0,1588377600000,16052,Gera,125,12,113,94152,619
DE-TH,04-05-2020,RKI,0,0,0,1588550400000,16052,Gera,125,12,113,94152,619
DE-TH,06-05-2020,RKI,5,5,0,1588723200000,16052,Gera,130,12,118,94152,619
DE-TH,07-05-2020,RKI,5,4,1,1588809600000,16052,Gera,135,13,122,94152,619
DE-TH,08-05-2020,RKI,2,2,0,1588896000000,16052,Gera,137,13,124,94152,619
DE-TH,09-05-2020,RKI,1,1,0,1588982400000,16052,Gera,138,13,125,94152,619
DE-TH,11-05-2020,RKI,1,1,0,1589155200000,16052,Gera,139,13,126,94152,619
DE-TH,12-05-2020,RKI,2,2,0,1589241600000,16052,Gera,141,13,128,94152,619
DE-TH,14-05-2020,RKI,3,2,1,1589414400000,16052,Gera,144,14,130,94152,619
DE-TH,15-05-2020,RKI,4,4,0,1589500800000,16052,Gera,148,14,134,94152,619
DE-TH,16-05-2020,RKI,0,0,0,1589587200000,16052,Gera,148,14,134,94152,619
DE-TH,18-05-2020,RKI,6,5,1,1589760000000,16052,Gera,154,15,139,94152,619
DE-TH,19-05-2020,RKI,0,0,0,1589846400000,16052,Gera,154,15,139,94152,619
DE-TH,20-05-2020,RKI,2,1,1,1589932800000,16052,Gera,156,16,140,94152,619
DE-TH,22-05-2020,RKI,6,5,1,1590105600000,16052,Gera,162,17,145,94152,619
DE-TH,23-05-2020,RKI,2,1,1,1590192000000,16052,Gera,164,18,146,94152,619
DE-TH,25-05-2020,RKI,8,7,1,1590364800000,16052,Gera,172,19,153,94152,619
DE-TH,26-05-2020,RKI,1,1,0,1590451200000,16052,Gera,173,19,154,94152,619
DE-TH,27-05-2020,RKI,0,0,0,1590537600000,16052,Gera,173,19,154,94152,619
DE-TH,28-05-2020,RKI,2,2,0,1590624000000,16052,Gera,175,19,156,94152,619
DE-TH,29-05-2020,RKI,2,2,0,1590710400000,16052,Gera,177,19,158,94152,619
DE-TH,30-05-2020,RKI,4,2,2,1590796800000,16052,Gera,181,21,160,94152,619
DE-TH,03-06-2020,RKI,4,4,0,1591142400000,16052,Gera,185,21,164,94152,619
DE-TH,04-06-2020,RKI,1,1,0,1591228800000,16052,Gera,186,21,165,94152,619
DE-TH,05-06-2020,RKI,3,3,0,1591315200000,16052,Gera,189,21,168,94152,619
DE-TH,07-06-2020,RKI,0,0,0,1591488000000,16052,Gera,189,21,168,94152,619
DE-TH,08-06-2020,RKI,0,0,0,1591574400000,16052,Gera,189,21,168,94152,619
DE-TH,16-06-2020,RKI,0,0,0,1592265600000,16052,Gera,189,21,168,94152,619
DE-TH,26-06-2020,RKI,0,0,0,1593129600000,16052,Gera,189,21,168,94152,619
DE-TH,30-06-2020,RKI,0,0,0,1593475200000,16052,Gera,189,21,168,94152,619
DE-TH,01-07-2020,RKI,0,0,0,1593561600000,16052,Gera,189,21,168,94152,619
DE-TH,06-07-2020,RKI,1,1,0,1593993600000,16052,Gera,190,21,169,94152,619
DE-TH,16-03-2020,RKI,2,2,0,1584316800000,16053,Jena,9,0,9,111407,971
DE-TH,17-03-2020,RKI,10,10,0,1584403200000,16053,Jena,19,0,19,111407,971
DE-TH,18-03-2020,RKI,6,6,0,1584489600000,16053,Jena,25,0,25,111407,971
DE-TH,19-03-2020,RKI,8,8,0,1584576000000,16053,Jena,33,0,33,111407,971
DE-TH,20-03-2020,RKI,20,20,0,1584662400000,16053,Jena,53,0,53,111407,971
DE-TH,21-03-2020,RKI,10,9,1,1584748800000,16053,Jena,63,1,62,111407,971
DE-TH,22-03-2020,RKI,8,8,0,1584835200000,16053,Jena,71,1,70,111407,971
DE-TH,23-03-2020,RKI,4,4,0,1584921600000,16053,Jena,75,1,74,111407,971
DE-TH,24-03-2020,RKI,1,1,0,1585008000000,16053,Jena,76,1,75,111407,971
DE-TH,25-03-2020,RKI,3,3,0,1585094400000,16053,Jena,79,1,78,111407,971
DE-TH,26-03-2020,RKI,3,3,0,1585180800000,16053,Jena,82,1,81,111407,971
DE-TH,27-03-2020,RKI,2,2,0,1585267200000,16053,Jena,84,1,83,111407,971
DE-TH,28-03-2020,RKI,14,14,0,1585353600000,16053,Jena,98,1,97,111407,971
DE-TH,29-03-2020,RKI,1,1,0,1585440000000,16053,Jena,99,1,98,111407,971
DE-TH,30-03-2020,RKI,2,2,0,1585526400000,16053,Jena,101,1,100,111407,971
DE-TH,31-03-2020,RKI,2,2,0,1585612800000,16053,Jena,103,1,102,111407,971
DE-TH,01-04-2020,RKI,3,2,1,1585699200000,16053,Jena,106,2,104,111407,971
DE-TH,02-04-2020,RKI,4,3,1,1585785600000,16053,Jena,110,3,107,111407,971
DE-TH,03-04-2020,RKI,3,3,0,1585872000000,16053,Jena,113,3,110,111407,971
DE-TH,04-04-2020,RKI,3,3,0,1585958400000,16053,Jena,116,3,113,111407,971
DE-TH,05-04-2020,RKI,2,2,0,1586044800000,16053,Jena,118,3,115,111407,971
DE-TH,06-04-2020,RKI,0,0,0,1586131200000,16053,Jena,118,3,115,111407,971
DE-TH,07-04-2020,RKI,4,4,0,1586217600000,16053,Jena,122,3,119,111407,971
DE-TH,08-04-2020,RKI,3,3,0,1586304000000,16053,Jena,125,3,122,111407,971
DE-TH,09-04-2020,RKI,2,2,0,1586390400000,16053,Jena,127,3,124,111407,971
DE-TH,12-04-2020,RKI,0,0,0,1586649600000,16053,Jena,127,3,124,111407,971
DE-TH,23-04-2020,RKI,1,1,0,1587600000000,16053,Jena,128,3,125,111407,971
DE-TH,25-04-2020,RKI,0,0,0,1587772800000,16053,Jena,128,3,125,111407,971
DE-TH,12-05-2020,RKI,0,0,0,1589241600000,16053,Jena,128,3,125,111407,971
DE-TH,30-05-2020,RKI,0,0,0,1590796800000,16053,Jena,128,3,125,111407,971
DE-TH,12-06-2020,RKI,0,0,0,1591920000000,16053,Jena,128,3,125,111407,971
DE-TH,11-07-2020,RKI,0,0,0,1594425600000,16053,Jena,128,3,125,111407,971
DE-TH,12-07-2020,RKI,0,0,0,1594512000000,16053,Jena,128,3,125,111407,971
DE-TH,20-03-2020,RKI,0,0,0,1584662400000,16054,Suhl,0,0,0,36955,261
DE-TH,21-03-2020,RKI,1,1,0,1584748800000,16054,Suhl,1,0,1,36955,261
DE-TH,24-03-2020,RKI,0,0,0,1585008000000,16054,Suhl,1,0,1,36955,261
DE-TH,28-03-2020,RKI,0,0,0,1585353600000,16054,Suhl,1,0,1,36955,261
DE-TH,30-03-2020,RKI,0,0,0,1585526400000,16054,Suhl,1,0,1,36955,261
DE-TH,02-04-2020,RKI,0,0,0,1585785600000,16054,Suhl,1,0,1,36955,261
DE-TH,03-04-2020,RKI,0,0,0,1585872000000,16054,Suhl,1,0,1,36955,261
DE-TH,04-04-2020,RKI,0,0,0,1585958400000,16054,Suhl,1,0,1,36955,261
DE-TH,06-04-2020,RKI,0,0,0,1586131200000,16054,Suhl,1,0,1,36955,261
DE-TH,15-04-2020,RKI,0,0,0,1586908800000,16054,Suhl,1,0,1,36955,261
DE-TH,17-04-2020,RKI,0,0,0,1587081600000,16054,Suhl,1,0,1,36955,261
DE-TH,14-05-2020,RKI,0,0,0,1589414400000,16054,Suhl,1,0,1,36955,261
DE-TH,15-05-2020,RKI,0,0,0,1589500800000,16054,Suhl,1,0,1,36955,261
DE-TH,19-05-2020,RKI,0,0,0,1589846400000,16054,Suhl,1,0,1,36955,261
DE-TH,23-05-2020,RKI,0,0,0,1590192000000,16054,Suhl,1,0,1,36955,261
DE-TH,25-05-2020,RKI,0,0,0,1590364800000,16054,Suhl,1,0,1,36955,261
DE-TH,27-05-2020,RKI,0,0,0,1590537600000,16054,Suhl,1,0,1,36955,261
DE-TH,10-06-2020,RKI,0,0,0,1591747200000,16054,Suhl,1,0,1,36955,261
DE-TH,02-07-2020,RKI,0,0,0,1593648000000,16054,Suhl,1,0,1,36955,261
DE-TH,16-03-2020,RKI,0,0,0,1584316800000,16055,Weimar,0,0,0,65090,770
DE-TH,17-03-2020,RKI,3,3,0,1584403200000,16055,Weimar,3,0,3,65090,770
DE-TH,18-03-2020,RKI,0,0,0,1584489600000,16055,Weimar,3,0,3,65090,770
DE-TH,20-03-2020,RKI,2,2,0,1584662400000,16055,Weimar,5,0,5,65090,770
DE-TH,23-03-2020,RKI,2,2,0,1584921600000,16055,Weimar,7,0,7,65090,770
DE-TH,24-03-2020,RKI,2,2,0,1585008000000,16055,Weimar,9,0,9,65090,770
DE-TH,25-03-2020,RKI,3,3,0,1585094400000,16055,Weimar,12,0,12,65090,770
DE-TH,26-03-2020,RKI,2,2,0,1585180800000,16055,Weimar,14,0,14,65090,770
DE-TH,27-03-2020,RKI,0,0,0,1585267200000,16055,Weimar,14,0,14,65090,770
DE-TH,28-03-2020,RKI,4,4,0,1585353600000,16055,Weimar,18,0,18,65090,770
DE-TH,01-04-2020,RKI,4,4,0,1585699200000,16055,Weimar,22,0,22,65090,770
DE-TH,02-04-2020,RKI,3,3,0,1585785600000,16055,Weimar,25,0,25,65090,770
DE-TH,03-04-2020,RKI,4,4,0,1585872000000,16055,Weimar,29,0,29,65090,770
DE-TH,05-04-2020,RKI,2,2,0,1586044800000,16055,Weimar,31,0,31,65090,770
DE-TH,06-04-2020,RKI,1,1,0,1586131200000,16055,Weimar,32,0,32,65090,770
DE-TH,07-04-2020,RKI,2,2,0,1586217600000,16055,Weimar,34,0,34,65090,770
DE-TH,08-04-2020,RKI,0,0,0,1586304000000,16055,Weimar,34,0,34,65090,770
DE-TH,09-04-2020,RKI,2,2,0,1586390400000,16055,Weimar,36,0,36,65090,770
DE-TH,12-04-2020,RKI,2,2,0,1586649600000,16055,Weimar,38,0,38,65090,770
DE-TH,21-04-2020,RKI,0,0,0,1587427200000,16055,Weimar,38,0,38,65090,770
DE-TH,23-04-2020,RKI,0,0,0,1587600000000,16055,Weimar,38,0,38,65090,770
DE-TH,25-04-2020,RKI,0,0,0,1587772800000,16055,Weimar,38,0,38,65090,770
DE-TH,30-04-2020,RKI,1,1,0,1588204800000,16055,Weimar,39,0,39,65090,770
DE-TH,06-05-2020,RKI,0,0,0,1588723200000,16055,Weimar,39,0,39,65090,770
DE-TH,07-05-2020,RKI,0,0,0,1588809600000,16055,Weimar,39,0,39,65090,770
DE-TH,19-05-2020,RKI,2,2,0,1589846400000,16055,Weimar,41,0,41,65090,770
DE-TH,10-06-2020,RKI,0,0,0,1591747200000,16055,Weimar,41,0,41,65090,770
DE-TH,14-07-2020,RKI,2,0,0,1594684800000,16055,Weimar,43,0,41,65090,770
DE-TH,24-03-2020,RKI,0,0,0,1585008000000,16056,Eisenach,0,0,0,42370,407
DE-TH,25-03-2020,RKI,0,0,0,1585094400000,16056,Eisenach,0,0,0,42370,407
DE-TH,26-03-2020,RKI,0,0,0,1585180800000,16056,Eisenach,0,0,0,42370,407
DE-TH,31-03-2020,RKI,1,1,0,1585612800000,16056,Eisenach,1,0,1,42370,407
DE-TH,02-04-2020,RKI,0,0,0,1585785600000,16056,Eisenach,1,0,1,42370,407
DE-TH,03-04-2020,RKI,0,0,0,1585872000000,16056,Eisenach,1,0,1,42370,407
DE-TH,06-04-2020,RKI,0,0,0,1586131200000,16056,Eisenach,1,0,1,42370,407
DE-TH,08-04-2020,RKI,0,0,0,1586304000000,16056,Eisenach,1,0,1,42370,407
DE-TH,09-04-2020,RKI,1,1,0,1586390400000,16056,Eisenach,2,0,2,42370,407
DE-TH,14-04-2020,RKI,0,0,0,1586822400000,16056,Eisenach,2,0,2,42370,407
DE-TH,19-04-2020,RKI,0,0,0,1587254400000,16056,Eisenach,2,0,2,42370,407
DE-TH,22-04-2020,RKI,0,0,0,1587513600000,16056,Eisenach,2,0,2,42370,407
DE-TH,23-04-2020,RKI,0,0,0,1587600000000,16056,Eisenach,2,0,2,42370,407
DE-TH,28-04-2020,RKI,3,2,1,1588032000000,16056,Eisenach,5,1,4,42370,407
DE-TH,29-04-2020,RKI,0,0,0,1588118400000,16056,Eisenach,5,1,4,42370,407
DE-TH,02-05-2020,RKI,0,0,0,1588377600000,16056,Eisenach,5,1,4,42370,407
DE-TH,06-05-2020,RKI,1,1,0,1588723200000,16056,Eisenach,6,1,5,42370,407
DE-TH,07-05-2020,RKI,0,0,0,1588809600000,16056,Eisenach,6,1,5,42370,407
DE-TH,14-05-2020,RKI,0,0,0,1589414400000,16056,Eisenach,6,1,5,42370,407
DE-TH,16-05-2020,RKI,0,0,0,1589587200000,16056,Eisenach,6,1,5,42370,407
DE-TH,29-05-2020,RKI,0,0,0,1590710400000,16056,Eisenach,6,1,5,42370,407
DE-TH,07-06-2020,RKI,0,0,0,1591488000000,16056,Eisenach,6,1,5,42370,407
DE-TH,19-06-2020,RKI,0,0,0,1592524800000,16056,Eisenach,6,1,5,42370,407
DE-TH,13-07-2020,RKI,0,0,0,1594598400000,16056,Eisenach,6,1,5,42370,407
DE-TH,14-03-2020,RKI,0,0,0,1584144000000,16061,Eichsfeld,0,0,0,100380,106
DE-TH,15-03-2020,RKI,0,0,0,1584230400000,16061,Eichsfeld,0,0,0,100380,106
DE-TH,19-03-2020,RKI,0,0,0,1584576000000,16061,Eichsfeld,0,0,0,100380,106
DE-TH,20-03-2020,RKI,3,3,0,1584662400000,16061,Eichsfeld,3,0,3,100380,106
DE-TH,21-03-2020,RKI,9,8,1,1584748800000,16061,Eichsfeld,12,1,11,100380,106
DE-TH,22-03-2020,RKI,0,0,0,1584835200000,16061,Eichsfeld,12,1,11,100380,106
DE-TH,23-03-2020,RKI,0,0,0,1584921600000,16061,Eichsfeld,12,1,11,100380,106
DE-TH,24-03-2020,RKI,9,9,0,1585008000000,16061,Eichsfeld,21,1,20,100380,106
DE-TH,25-03-2020,RKI,6,6,0,1585094400000,16061,Eichsfeld,27,1,26,100380,106
DE-TH,26-03-2020,RKI,2,2,0,1585180800000,16061,Eichsfeld,29,1,28,100380,106
DE-TH,27-03-2020,RKI,3,3,0,1585267200000,16061,Eichsfeld,32,1,31,100380,106
DE-TH,28-03-2020,RKI,4,4,0,1585353600000,16061,Eichsfeld,36,1,35,100380,106
DE-TH,29-03-2020,RKI,1,1,0,1585440000000,16061,Eichsfeld,37,1,36,100380,106
DE-TH,30-03-2020,RKI,0,0,0,1585526400000,16061,Eichsfeld,37,1,36,100380,106
DE-TH,31-03-2020,RKI,4,4,0,1585612800000,16061,Eichsfeld,41,1,40,100380,106
DE-TH,01-04-2020,RKI,3,3,0,1585699200000,16061,Eichsfeld,44,1,43,100380,106
DE-TH,02-04-2020,RKI,2,2,0,1585785600000,16061,Eichsfeld,46,1,45,100380,106
DE-TH,03-04-2020,RKI,1,1,0,1585872000000,16061,Eichsfeld,47,1,46,100380,106
DE-TH,04-04-2020,RKI,3,3,0,1585958400000,16061,Eichsfeld,50,1,49,100380,106
DE-TH,06-04-2020,RKI,0,0,0,1586131200000,16061,Eichsfeld,50,1,49,100380,106
DE-TH,07-04-2020,RKI,3,0,3,1586217600000,16061,Eichsfeld,53,4,49,100380,106
DE-TH,08-04-2020,RKI,3,3,0,1586304000000,16061,Eichsfeld,56,4,52,100380,106
DE-TH,09-04-2020,RKI,5,5,0,1586390400000,16061,Eichsfeld,61,4,57,100380,106
DE-TH,10-04-2020,RKI,3,2,1,1586476800000,16061,Eichsfeld,64,5,59,100380,106
DE-TH,13-04-2020,RKI,2,2,0,1586736000000,16061,Eichsfeld,66,5,61,100380,106
DE-TH,14-04-2020,RKI,2,2,0,1586822400000,16061,Eichsfeld,68,5,63,100380,106
DE-TH,15-04-2020,RKI,2,2,0,1586908800000,16061,Eichsfeld,70,5,65,100380,106
DE-TH,16-04-2020,RKI,4,4,0,1586995200000,16061,Eichsfeld,74,5,69,100380,106
DE-TH,17-04-2020,RKI,1,1,0,1587081600000,16061,Eichsfeld,75,5,70,100380,106
DE-TH,18-04-2020,RKI,1,1,0,1587168000000,16061,Eichsfeld,76,5,71,100380,106
DE-TH,22-04-2020,RKI,3,3,0,1587513600000,16061,Eichsfeld,79,5,74,100380,106
DE-TH,23-04-2020,RKI,1,1,0,1587600000000,16061,Eichsfeld,80,5,75,100380,106
DE-TH,25-04-2020,RKI,0,0,0,1587772800000,16061,Eichsfeld,80,5,75,100380,106
DE-TH,26-04-2020,RKI,0,0,0,1587859200000,16061,Eichsfeld,80,5,75,100380,106
DE-TH,28-04-2020,RKI,9,5,4,1588032000000,16061,Eichsfeld,89,9,80,100380,106
DE-TH,29-04-2020,RKI,2,2,0,1588118400000,16061,Eichsfeld,91,9,82,100380,106
DE-TH,01-05-2020,RKI,1,1,0,1588291200000,16061,Eichsfeld,92,9,83,100380,106
DE-TH,02-05-2020,RKI,2,2,0,1588377600000,16061,Eichsfeld,94,9,85,100380,106
DE-TH,04-05-2020,RKI,0,0,0,1588550400000,16061,Eichsfeld,94,9,85,100380,106
DE-TH,07-05-2020,RKI,0,0,0,1588809600000,16061,Eichsfeld,94,9,85,100380,106
DE-TH,08-05-2020,RKI,0,0,0,1588896000000,16061,Eichsfeld,94,9,85,100380,106
DE-TH,12-05-2020,RKI,1,1,0,1589241600000,16061,Eichsfeld,95,9,86,100380,106
DE-TH,16-05-2020,RKI,0,0,0,1589587200000,16061,Eichsfeld,95,9,86,100380,106
DE-TH,19-05-2020,RKI,3,3,0,1589846400000,16061,Eichsfeld,98,9,89,100380,106
DE-TH,20-05-2020,RKI,0,0,0,1589932800000,16061,Eichsfeld,98,9,89,100380,106
DE-TH,21-05-2020,RKI,5,5,0,1590019200000,16061,Eichsfeld,103,9,94,100380,106
DE-TH,26-05-2020,RKI,0,0,0,1590451200000,16061,Eichsfeld,103,9,94,100380,106
DE-TH,27-05-2020,RKI,0,0,0,1590537600000,16061,Eichsfeld,103,9,94,100380,106
DE-TH,29-05-2020,RKI,0,0,0,1590710400000,16061,Eichsfeld,103,9,94,100380,106
DE-TH,30-05-2020,RKI,1,1,0,1590796800000,16061,Eichsfeld,104,9,95,100380,106
DE-TH,05-06-2020,RKI,0,0,0,1591315200000,16061,Eichsfeld,104,9,95,100380,106
DE-TH,09-06-2020,RKI,0,0,0,1591660800000,16061,Eichsfeld,104,9,95,100380,106
DE-TH,11-06-2020,RKI,0,0,0,1591833600000,16061,Eichsfeld,104,9,95,100380,106
DE-TH,02-07-2020,RKI,1,1,0,1593648000000,16061,Eichsfeld,105,9,96,100380,106
DE-TH,07-07-2020,RKI,0,0,0,1594080000000,16061,Eichsfeld,105,9,96,100380,106
DE-TH,20-03-2020,RKI,0,0,0,1584662400000,16062,Nordhausen,1,0,1,83822,117
DE-TH,23-03-2020,RKI,2,2,0,1584921600000,16062,Nordhausen,3,0,3,83822,117
DE-TH,25-03-2020,RKI,0,0,0,1585094400000,16062,Nordhausen,3,0,3,83822,117
DE-TH,26-03-2020,RKI,1,1,0,1585180800000,16062,Nordhausen,4,0,4,83822,117
DE-TH,27-03-2020,RKI,1,0,1,1585267200000,16062,Nordhausen,5,1,4,83822,117
DE-TH,28-03-2020,RKI,0,0,0,1585353600000,16062,Nordhausen,5,1,4,83822,117
DE-TH,29-03-2020,RKI,0,0,0,1585440000000,16062,Nordhausen,5,1,4,83822,117
DE-TH,30-03-2020,RKI,1,1,0,1585526400000,16062,Nordhausen,6,1,5,83822,117
DE-TH,01-04-2020,RKI,0,0,0,1585699200000,16062,Nordhausen,6,1,5,83822,117
DE-TH,02-04-2020,RKI,3,3,0,1585785600000,16062,Nordhausen,9,1,8,83822,117
DE-TH,04-04-2020,RKI,0,0,0,1585958400000,16062,Nordhausen,9,1,8,83822,117
DE-TH,07-04-2020,RKI,4,4,0,1586217600000,16062,Nordhausen,13,1,12,83822,117
DE-TH,08-04-2020,RKI,0,0,0,1586304000000,16062,Nordhausen,13,1,12,83822,117
DE-TH,09-04-2020,RKI,1,1,0,1586390400000,16062,Nordhausen,14,1,13,83822,117
DE-TH,10-04-2020,RKI,0,0,0,1586476800000,16062,Nordhausen,14,1,13,83822,117
DE-TH,11-04-2020,RKI,2,2,0,1586563200000,16062,Nordhausen,16,1,15,83822,117
DE-TH,12-04-2020,RKI,3,3,0,1586649600000,16062,Nordhausen,19,1,18,83822,117
DE-TH,14-04-2020,RKI,0,0,0,1586822400000,16062,Nordhausen,19,1,18,83822,117
DE-TH,15-04-2020,RKI,3,3,0,1586908800000,16062,Nordhausen,22,1,21,83822,117
DE-TH,16-04-2020,RKI,0,0,0,1586995200000,16062,Nordhausen,22,1,21,83822,117
DE-TH,17-04-2020,RKI,1,1,0,1587081600000,16062,Nordhausen,23,1,22,83822,117
DE-TH,18-04-2020,RKI,4,4,0,1587168000000,16062,Nordhausen,27,1,26,83822,117
DE-TH,19-04-2020,RKI,0,0,0,1587254400000,16062,Nordhausen,27,1,26,83822,117
DE-TH,20-04-2020,RKI,0,0,0,1587340800000,16062,Nordhausen,27,1,26,83822,117
DE-TH,23-04-2020,RKI,2,2,0,1587600000000,16062,Nordhausen,29,1,28,83822,117
DE-TH,25-04-2020,RKI,0,0,0,1587772800000,16062,Nordhausen,29,1,28,83822,117
DE-TH,27-04-2020,RKI,0,0,0,1587945600000,16062,Nordhausen,29,1,28,83822,117
DE-TH,29-04-2020,RKI,0,0,0,1588118400000,16062,Nordhausen,29,1,28,83822,117
DE-TH,07-05-2020,RKI,1,1,0,1588809600000,16062,Nordhausen,30,1,29,83822,117
DE-TH,14-05-2020,RKI,0,0,0,1589414400000,16062,Nordhausen,30,1,29,83822,117
DE-TH,03-06-2020,RKI,0,0,0,1591142400000,16062,Nordhausen,30,1,29,83822,117
DE-TH,04-06-2020,RKI,0,0,0,1591228800000,16062,Nordhausen,30,1,29,83822,117
DE-TH,05-06-2020,RKI,0,0,0,1591315200000,16062,Nordhausen,30,1,29,83822,117
DE-TH,09-06-2020,RKI,0,0,0,1591660800000,16062,Nordhausen,30,1,29,83822,117
DE-TH,19-06-2020,RKI,0,0,0,1592524800000,16062,Nordhausen,30,1,29,83822,117
DE-TH,16-03-2020,RKI,1,1,0,1584316800000,16063,Wartburgkreis,1,0,1,119726,94
DE-TH,17-03-2020,RKI,1,1,0,1584403200000,16063,Wartburgkreis,2,0,2,119726,94
DE-TH,19-03-2020,RKI,2,2,0,1584576000000,16063,Wartburgkreis,4,0,4,119726,94
DE-TH,20-03-2020,RKI,2,2,0,1584662400000,16063,Wartburgkreis,6,0,6,119726,94
DE-TH,22-03-2020,RKI,0,0,0,1584835200000,16063,Wartburgkreis,6,0,6,119726,94
DE-TH,23-03-2020,RKI,0,0,0,1584921600000,16063,Wartburgkreis,6,0,6,119726,94
DE-TH,24-03-2020,RKI,0,0,0,1585008000000,16063,Wartburgkreis,6,0,6,119726,94
DE-TH,28-03-2020,RKI,1,1,0,1585353600000,16063,Wartburgkreis,7,0,7,119726,94
DE-TH,30-03-2020,RKI,0,0,0,1585526400000,16063,Wartburgkreis,7,0,7,119726,94
DE-TH,31-03-2020,RKI,6,6,0,1585612800000,16063,Wartburgkreis,13,0,13,119726,94
DE-TH,02-04-2020,RKI,1,1,0,1585785600000,16063,Wartburgkreis,14,0,14,119726,94
DE-TH,07-04-2020,RKI,2,2,0,1586217600000,16063,Wartburgkreis,16,0,16,119726,94
DE-TH,09-04-2020,RKI,0,0,0,1586390400000,16063,Wartburgkreis,16,0,16,119726,94
DE-TH,10-04-2020,RKI,0,0,0,1586476800000,16063,Wartburgkreis,16,0,16,119726,94
DE-TH,14-04-2020,RKI,0,0,0,1586822400000,16063,Wartburgkreis,16,0,16,119726,94
DE-TH,17-04-2020,RKI,1,1,0,1587081600000,16063,Wartburgkreis,17,0,17,119726,94
DE-TH,20-04-2020,RKI,0,0,0,1587340800000,16063,Wartburgkreis,17,0,17,119726,94
DE-TH,24-04-2020,RKI,0,0,0,1587686400000,16063,Wartburgkreis,17,0,17,119726,94
DE-TH,25-04-2020,RKI,0,0,0,1587772800000,16063,Wartburgkreis,17,0,17,119726,94
DE-TH,27-04-2020,RKI,0,0,0,1587945600000,16063,Wartburgkreis,17,0,17,119726,94
DE-TH,29-04-2020,RKI,1,1,0,1588118400000,16063,Wartburgkreis,18,0,18,119726,94
DE-TH,01-05-2020,RKI,0,0,0,1588291200000,16063,Wartburgkreis,18,0,18,119726,94
DE-TH,02-05-2020,RKI,1,1,0,1588377600000,16063,Wartburgkreis,19,0,19,119726,94
DE-TH,06-05-2020,RKI,0,0,0,1588723200000,16063,Wartburgkreis,19,0,19,119726,94
DE-TH,08-05-2020,RKI,1,1,0,1588896000000,16063,Wartburgkreis,20,0,20,119726,94
DE-TH,09-05-2020,RKI,1,1,0,1588982400000,16063,Wartburgkreis,21,0,21,119726,94
DE-TH,11-05-2020,RKI,2,2,0,1589155200000,16063,Wartburgkreis,23,0,23,119726,94
DE-TH,13-05-2020,RKI,0,0,0,1589328000000,16063,Wartburgkreis,23,0,23,119726,94
DE-TH,14-05-2020,RKI,3,3,0,1589414400000,16063,Wartburgkreis,26,0,26,119726,94
DE-TH,16-05-2020,RKI,1,1,0,1589587200000,16063,Wartburgkreis,27,0,27,119726,94
DE-TH,20-05-2020,RKI,4,4,0,1589932800000,16063,Wartburgkreis,31,0,31,119726,94
DE-TH,22-05-2020,RKI,1,1,0,1590105600000,16063,Wartburgkreis,32,0,32,119726,94
DE-TH,23-05-2020,RKI,0,0,0,1590192000000,16063,Wartburgkreis,32,0,32,119726,94
DE-TH,26-05-2020,RKI,3,3,0,1590451200000,16063,Wartburgkreis,35,0,35,119726,94
DE-TH,27-05-2020,RKI,0,0,0,1590537600000,16063,Wartburgkreis,35,0,35,119726,94
DE-TH,30-05-2020,RKI,0,0,0,1590796800000,16063,Wartburgkreis,35,0,35,119726,94
DE-TH,03-06-2020,RKI,2,2,0,1591142400000,16063,Wartburgkreis,37,0,37,119726,94
DE-TH,04-06-2020,RKI,0,0,0,1591228800000,16063,Wartburgkreis,37,0,37,119726,94
DE-TH,05-06-2020,RKI,0,0,0,1591315200000,16063,Wartburgkreis,37,0,37,119726,94
DE-TH,09-06-2020,RKI,0,0,0,1591660800000,16063,Wartburgkreis,37,0,37,119726,94
DE-TH,10-06-2020,RKI,1,1,0,1591747200000,16063,Wartburgkreis,38,0,38,119726,94
DE-TH,11-06-2020,RKI,1,1,0,1591833600000,16063,Wartburgkreis,39,0,39,119726,94
DE-TH,13-06-2020,RKI,0,0,0,1592006400000,16063,Wartburgkreis,39,0,39,119726,94
DE-TH,16-06-2020,RKI,0,0,0,1592265600000,16063,Wartburgkreis,39,0,39,119726,94
DE-TH,18-06-2020,RKI,0,0,0,1592438400000,16063,Wartburgkreis,39,0,39,119726,94
DE-TH,07-07-2020,RKI,0,0,0,1594080000000,16063,Wartburgkreis,39,0,39,119726,94
DE-TH,13-07-2020,RKI,0,0,0,1594598400000,16063,Wartburgkreis,39,0,39,119726,94
DE-TH,16-07-2020,RKI,0,0,0,1594857600000,16063,Wartburgkreis,39,0,39,119726,94
DE-TH,17-03-2020,RKI,0,0,0,1584403200000,16064,Unstrut-Hainich-Kreis,0,0,0,102912,105
DE-TH,19-03-2020,RKI,2,2,0,1584576000000,16064,Unstrut-Hainich-Kreis,2,0,2,102912,105
DE-TH,23-03-2020,RKI,0,0,0,1584921600000,16064,Unstrut-Hainich-Kreis,2,0,2,102912,105
DE-TH,24-03-2020,RKI,0,0,0,1585008000000,16064,Unstrut-Hainich-Kreis,2,0,2,102912,105
DE-TH,25-03-2020,RKI,0,0,0,1585094400000,16064,Unstrut-Hainich-Kreis,2,0,2,102912,105
DE-TH,26-03-2020,RKI,1,1,0,1585180800000,16064,Unstrut-Hainich-Kreis,3,0,3,102912,105
DE-TH,29-03-2020,RKI,0,0,0,1585440000000,16064,Unstrut-Hainich-Kreis,3,0,3,102912,105
DE-TH,30-03-2020,RKI,4,4,0,1585526400000,16064,Unstrut-Hainich-Kreis,7,0,7,102912,105
DE-TH,31-03-2020,RKI,2,2,0,1585612800000,16064,Unstrut-Hainich-Kreis,9,0,9,102912,105
DE-TH,01-04-2020,RKI,1,1,0,1585699200000,16064,Unstrut-Hainich-Kreis,10,0,10,102912,105
DE-TH,02-04-2020,RKI,4,3,1,1585785600000,16064,Unstrut-Hainich-Kreis,14,1,13,102912,105
DE-TH,03-04-2020,RKI,4,4,0,1585872000000,16064,Unstrut-Hainich-Kreis,18,1,17,102912,105
DE-TH,04-04-2020,RKI,3,3,0,1585958400000,16064,Unstrut-Hainich-Kreis,21,1,20,102912,105
DE-TH,07-04-2020,RKI,5,5,0,1586217600000,16064,Unstrut-Hainich-Kreis,26,1,25,102912,105
DE-TH,08-04-2020,RKI,1,1,0,1586304000000,16064,Unstrut-Hainich-Kreis,27,1,26,102912,105
DE-TH,09-04-2020,RKI,3,2,1,1586390400000,16064,Unstrut-Hainich-Kreis,30,2,28,102912,105
DE-TH,11-04-2020,RKI,4,4,0,1586563200000,16064,Unstrut-Hainich-Kreis,34,2,32,102912,105
DE-TH,14-04-2020,RKI,2,2,0,1586822400000,16064,Unstrut-Hainich-Kreis,36,2,34,102912,105
DE-TH,15-04-2020,RKI,1,1,0,1586908800000,16064,Unstrut-Hainich-Kreis,37,2,35,102912,105
DE-TH,16-04-2020,RKI,3,3,0,1586995200000,16064,Unstrut-Hainich-Kreis,40,2,38,102912,105
DE-TH,18-04-2020,RKI,0,0,0,1587168000000,16064,Unstrut-Hainich-Kreis,40,2,38,102912,105
DE-TH,20-04-2020,RKI,1,1,0,1587340800000,16064,Unstrut-Hainich-Kreis,41,2,39,102912,105
DE-TH,21-04-2020,RKI,0,0,0,1587427200000,16064,Unstrut-Hainich-Kreis,41,2,39,102912,105
DE-TH,22-04-2020,RKI,2,1,1,1587513600000,16064,Unstrut-Hainich-Kreis,43,3,40,102912,105
DE-TH,24-04-2020,RKI,1,1,0,1587686400000,16064,Unstrut-Hainich-Kreis,44,3,41,102912,105
DE-TH,28-04-2020,RKI,3,3,0,1588032000000,16064,Unstrut-Hainich-Kreis,47,3,44,102912,105
DE-TH,29-04-2020,RKI,0,0,0,1588118400000,16064,Unstrut-Hainich-Kreis,47,3,44,102912,105
DE-TH,30-04-2020,RKI,0,0,0,1588204800000,16064,Unstrut-Hainich-Kreis,47,3,44,102912,105
DE-TH,02-05-2020,RKI,0,0,0,1588377600000,16064,Unstrut-Hainich-Kreis,47,3,44,102912,105
DE-TH,26-05-2020,RKI,0,0,0,1590451200000,16064,Unstrut-Hainich-Kreis,47,3,44,102912,105
DE-TH,28-05-2020,RKI,0,0,0,1590624000000,16064,Unstrut-Hainich-Kreis,47,3,44,102912,105
DE-TH,30-05-2020,RKI,1,1,0,1590796800000,16064,Unstrut-Hainich-Kreis,48,3,45,102912,105
DE-TH,03-06-2020,RKI,0,0,0,1591142400000,16064,Unstrut-Hainich-Kreis,48,3,45,102912,105
DE-TH,05-06-2020,RKI,0,0,0,1591315200000,16064,Unstrut-Hainich-Kreis,48,3,45,102912,105
DE-TH,06-06-2020,RKI,1,1,0,1591401600000,16064,Unstrut-Hainich-Kreis,49,3,46,102912,105
DE-TH,09-06-2020,RKI,1,1,0,1591660800000,16064,Unstrut-Hainich-Kreis,50,3,47,102912,105
DE-TH,10-06-2020,RKI,0,0,0,1591747200000,16064,Unstrut-Hainich-Kreis,50,3,47,102912,105
DE-TH,11-06-2020,RKI,0,0,0,1591833600000,16064,Unstrut-Hainich-Kreis,50,3,47,102912,105
DE-TH,16-06-2020,RKI,0,0,0,1592265600000,16064,Unstrut-Hainich-Kreis,50,3,47,102912,105
DE-TH,17-06-2020,RKI,0,0,0,1592352000000,16064,Unstrut-Hainich-Kreis,50,3,47,102912,105
DE-TH,02-07-2020,RKI,0,0,0,1593648000000,16064,Unstrut-Hainich-Kreis,50,3,47,102912,105
DE-TH,12-03-2020,RKI,2,2,0,1583971200000,16065,Kyffhäuserkreis,3,0,3,75009,72
DE-TH,13-03-2020,RKI,0,0,0,1584057600000,16065,Kyffhäuserkreis,3,0,3,75009,72
DE-TH,16-03-2020,RKI,0,0,0,1584316800000,16065,Kyffhäuserkreis,3,0,3,75009,72
DE-TH,18-03-2020,RKI,0,0,0,1584489600000,16065,Kyffhäuserkreis,3,0,3,75009,72
DE-TH,19-03-2020,RKI,1,1,0,1584576000000,16065,Kyffhäuserkreis,4,0,4,75009,72
DE-TH,20-03-2020,RKI,1,1,0,1584662400000,16065,Kyffhäuserkreis,5,0,5,75009,72
DE-TH,24-03-2020,RKI,2,2,0,1585008000000,16065,Kyffhäuserkreis,7,0,7,75009,72
DE-TH,25-03-2020,RKI,1,1,0,1585094400000,16065,Kyffhäuserkreis,8,0,8,75009,72
DE-TH,27-03-2020,RKI,1,1,0,1585267200000,16065,Kyffhäuserkreis,9,0,9,75009,72
DE-TH,31-03-2020,RKI,3,3,0,1585612800000,16065,Kyffhäuserkreis,12,0,12,75009,72
DE-TH,02-04-2020,RKI,1,1,0,1585785600000,16065,Kyffhäuserkreis,13,0,13,75009,72
DE-TH,03-04-2020,RKI,1,1,0,1585872000000,16065,Kyffhäuserkreis,14,0,14,75009,72
DE-TH,07-04-2020,RKI,0,0,0,1586217600000,16065,Kyffhäuserkreis,14,0,14,75009,72
DE-TH,08-04-2020,RKI,5,5,0,1586304000000,16065,Kyffhäuserkreis,19,0,19,75009,72
DE-TH,09-04-2020,RKI,0,0,0,1586390400000,16065,Kyffhäuserkreis,19,0,19,75009,72
DE-TH,20-04-2020,RKI,0,0,0,1587340800000,16065,Kyffhäuserkreis,19,0,19,75009,72
DE-TH,22-04-2020,RKI,0,0,0,1587513600000,16065,Kyffhäuserkreis,19,0,19,75009,72
DE-TH,28-04-2020,RKI,0,0,0,1588032000000,16065,Kyffhäuserkreis,19,0,19,75009,72
DE-TH,29-04-2020,RKI,0,0,0,1588118400000,16065,Kyffhäuserkreis,19,0,19,75009,72
DE-TH,01-05-2020,RKI,1,1,0,1588291200000,16065,Kyffhäuserkreis,20,0,20,75009,72
DE-TH,11-05-2020,RKI,1,1,0,1589155200000,16065,Kyffhäuserkreis,21,0,21,75009,72
DE-TH,13-05-2020,RKI,0,0,0,1589328000000,16065,Kyffhäuserkreis,21,0,21,75009,72
DE-TH,16-05-2020,RKI,0,0,0,1589587200000,16065,Kyffhäuserkreis,21,0,21,75009,72
DE-TH,11-06-2020,RKI,0,0,0,1591833600000,16065,Kyffhäuserkreis,21,0,21,75009,72
DE-TH,13-06-2020,RKI,0,0,0,1592006400000,16065,Kyffhäuserkreis,21,0,21,75009,72
DE-TH,16-06-2020,RKI,1,1,0,1592265600000,16065,Kyffhäuserkreis,22,0,22,75009,72
DE-TH,22-06-2020,RKI,0,0,0,1592784000000,16065,Kyffhäuserkreis,22,0,22,75009,72
DE-TH,13-03-2020,RKI,0,0,0,1584057600000,16066,Schmalkalden-Meiningen,0,0,0,125646,100
DE-TH,17-03-2020,RKI,2,2,0,1584403200000,16066,Schmalkalden-Meiningen,2,0,2,125646,100
DE-TH,18-03-2020,RKI,2,2,0,1584489600000,16066,Schmalkalden-Meiningen,4,0,4,125646,100
DE-TH,19-03-2020,RKI,2,2,0,1584576000000,16066,Schmalkalden-Meiningen,6,0,6,125646,100
DE-TH,20-03-2020,RKI,3,3,0,1584662400000,16066,Schmalkalden-Meiningen,9,0,9,125646,100
DE-TH,23-03-2020,RKI,1,1,0,1584921600000,16066,Schmalkalden-Meiningen,10,0,10,125646,100
DE-TH,24-03-2020,RKI,3,3,0,1585008000000,16066,Schmalkalden-Meiningen,13,0,13,125646,100
DE-TH,25-03-2020,RKI,1,1,0,1585094400000,16066,Schmalkalden-Meiningen,14,0,14,125646,100
DE-TH,26-03-2020,RKI,3,3,0,1585180800000,16066,Schmalkalden-Meiningen,17,0,17,125646,100
DE-TH,27-03-2020,RKI,2,2,0,1585267200000,16066,Schmalkalden-Meiningen,19,0,19,125646,100
DE-TH,28-03-2020,RKI,0,0,0,1585353600000,16066,Schmalkalden-Meiningen,19,0,19,125646,100
DE-TH,31-03-2020,RKI,1,1,0,1585612800000,16066,Schmalkalden-Meiningen,20,0,20,125646,100
DE-TH,02-04-2020,RKI,0,0,0,1585785600000,16066,Schmalkalden-Meiningen,20,0,20,125646,100
DE-TH,03-04-2020,RKI,0,0,0,1585872000000,16066,Schmalkalden-Meiningen,20,0,20,125646,100
DE-TH,04-04-2020,RKI,1,1,0,1585958400000,16066,Schmalkalden-Meiningen,21,0,21,125646,100
DE-TH,07-04-2020,RKI,5,5,0,1586217600000,16066,Schmalkalden-Meiningen,26,0,26,125646,100
DE-TH,08-04-2020,RKI,5,5,0,1586304000000,16066,Schmalkalden-Meiningen,31,0,31,125646,100
DE-TH,09-04-2020,RKI,3,3,0,1586390400000,16066,Schmalkalden-Meiningen,34,0,34,125646,100
DE-TH,10-04-2020,RKI,1,0,1,1586476800000,16066,Schmalkalden-Meiningen,35,1,34,125646,100
DE-TH,13-04-2020,RKI,1,1,0,1586736000000,16066,Schmalkalden-Meiningen,36,1,35,125646,100
DE-TH,14-04-2020,RKI,3,3,0,1586822400000,16066,Schmalkalden-Meiningen,39,1,38,125646,100
DE-TH,15-04-2020,RKI,3,3,0,1586908800000,16066,Schmalkalden-Meiningen,42,1,41,125646,100
DE-TH,16-04-2020,RKI,3,3,0,1586995200000,16066,Schmalkalden-Meiningen,45,1,44,125646,100
DE-TH,17-04-2020,RKI,0,0,0,1587081600000,16066,Schmalkalden-Meiningen,45,1,44,125646,100
DE-TH,18-04-2020,RKI,1,1,0,1587168000000,16066,Schmalkalden-Meiningen,46,1,45,125646,100
DE-TH,20-04-2020,RKI,1,1,0,1587340800000,16066,Schmalkalden-Meiningen,47,1,46,125646,100
DE-TH,21-04-2020,RKI,0,0,0,1587427200000,16066,Schmalkalden-Meiningen,47,1,46,125646,100
DE-TH,22-04-2020,RKI,5,5,0,1587513600000,16066,Schmalkalden-Meiningen,52,1,51,125646,100
DE-TH,23-04-2020,RKI,5,5,0,1587600000000,16066,Schmalkalden-Meiningen,57,1,56,125646,100
DE-TH,24-04-2020,RKI,1,1,0,1587686400000,16066,Schmalkalden-Meiningen,58,1,57,125646,100
DE-TH,27-04-2020,RKI,1,1,0,1587945600000,16066,Schmalkalden-Meiningen,59,1,58,125646,100
DE-TH,28-04-2020,RKI,1,1,0,1588032000000,16066,Schmalkalden-Meiningen,60,1,59,125646,100
DE-TH,29-04-2020,RKI,1,1,0,1588118400000,16066,Schmalkalden-Meiningen,61,1,60,125646,100
DE-TH,30-04-2020,RKI,2,2,0,1588204800000,16066,Schmalkalden-Meiningen,63,1,62,125646,100
DE-TH,05-05-2020,RKI,3,3,0,1588636800000,16066,Schmalkalden-Meiningen,66,1,65,125646,100
DE-TH,06-05-2020,RKI,1,1,0,1588723200000,16066,Schmalkalden-Meiningen,67,1,66,125646,100
DE-TH,07-05-2020,RKI,1,1,0,1588809600000,16066,Schmalkalden-Meiningen,68,1,67,125646,100
DE-TH,08-05-2020,RKI,2,2,0,1588896000000,16066,Schmalkalden-Meiningen,70,1,69,125646,100
DE-TH,09-05-2020,RKI,1,1,0,1588982400000,16066,Schmalkalden-Meiningen,71,1,70,125646,100
DE-TH,11-05-2020,RKI,0,0,0,1589155200000,16066,Schmalkalden-Meiningen,71,1,70,125646,100
DE-TH,12-05-2020,RKI,0,0,0,1589241600000,16066,Schmalkalden-Meiningen,71,1,70,125646,100
DE-TH,14-05-2020,RKI,2,2,0,1589414400000,16066,Schmalkalden-Meiningen,73,1,72,125646,100
DE-TH,15-05-2020,RKI,0,0,0,1589500800000,16066,Schmalkalden-Meiningen,73,1,72,125646,100
DE-TH,17-05-2020,RKI,0,0,0,1589673600000,16066,Schmalkalden-Meiningen,73,1,72,125646,100
DE-TH,19-05-2020,RKI,0,0,0,1589846400000,16066,Schmalkalden-Meiningen,73,1,72,125646,100
DE-TH,20-05-2020,RKI,0,0,0,1589932800000,16066,Schmalkalden-Meiningen,73,1,72,125646,100
DE-TH,23-05-2020,RKI,1,1,0,1590192000000,16066,Schmalkalden-Meiningen,74,1,73,125646,100
DE-TH,25-05-2020,RKI,0,0,0,1590364800000,16066,Schmalkalden-Meiningen,74,1,73,125646,100
DE-TH,26-05-2020,RKI,3,3,0,1590451200000,16066,Schmalkalden-Meiningen,77,1,76,125646,100
DE-TH,27-05-2020,RKI,0,0,0,1590537600000,16066,Schmalkalden-Meiningen,77,1,76,125646,100
DE-TH,28-05-2020,RKI,0,0,0,1590624000000,16066,Schmalkalden-Meiningen,77,1,76,125646,100
DE-TH,29-05-2020,RKI,0,0,0,1590710400000,16066,Schmalkalden-Meiningen,77,1,76,125646,100
DE-TH,30-05-2020,RKI,0,0,0,1590796800000,16066,Schmalkalden-Meiningen,77,1,76,125646,100
DE-TH,31-05-2020,RKI,0,0,0,1590883200000,16066,Schmalkalden-Meiningen,77,1,76,125646,100
DE-TH,02-06-2020,RKI,0,0,0,1591056000000,16066,Schmalkalden-Meiningen,77,1,76,125646,100
DE-TH,04-06-2020,RKI,1,1,0,1591228800000,16066,Schmalkalden-Meiningen,78,1,77,125646,100
DE-TH,05-06-2020,RKI,0,0,0,1591315200000,16066,Schmalkalden-Meiningen,78,1,77,125646,100
DE-TH,06-06-2020,RKI,0,0,0,1591401600000,16066,Schmalkalden-Meiningen,78,1,77,125646,100
DE-TH,07-06-2020,RKI,0,0,0,1591488000000,16066,Schmalkalden-Meiningen,78,1,77,125646,100
DE-TH,08-06-2020,RKI,0,0,0,1591574400000,16066,Schmalkalden-Meiningen,78,1,77,125646,100
DE-TH,09-06-2020,RKI,0,0,0,1591660800000,16066,Schmalkalden-Meiningen,78,1,77,125646,100
DE-TH,10-06-2020,RKI,0,0,0,1591747200000,16066,Schmalkalden-Meiningen,78,1,77,125646,100
DE-TH,11-06-2020,RKI,0,0,0,1591833600000,16066,Schmalkalden-Meiningen,78,1,77,125646,100
DE-TH,16-06-2020,RKI,0,0,0,1592265600000,16066,Schmalkalden-Meiningen,78,1,77,125646,100
DE-TH,19-06-2020,RKI,0,0,0,1592524800000,16066,Schmalkalden-Meiningen,78,1,77,125646,100
DE-TH,22-06-2020,RKI,0,0,0,1592784000000,16066,Schmalkalden-Meiningen,78,1,77,125646,100
DE-TH,24-06-2020,RKI,1,1,0,1592956800000,16066,Schmalkalden-Meiningen,79,1,78,125646,100
DE-TH,26-06-2020,RKI,0,0,0,1593129600000,16066,Schmalkalden-Meiningen,79,1,78,125646,100
DE-TH,30-06-2020,RKI,0,0,0,1593475200000,16066,Schmalkalden-Meiningen,79,1,78,125646,100
DE-TH,02-07-2020,RKI,0,0,0,1593648000000,16066,Schmalkalden-Meiningen,79,1,78,125646,100
DE-TH,06-07-2020,RKI,2,0,0,1593993600000,16066,Schmalkalden-Meiningen,81,1,78,125646,100
DE-TH,07-07-2020,RKI,2,0,0,1594080000000,16066,Schmalkalden-Meiningen,83,1,78,125646,100
DE-TH,13-07-2020,RKI,0,0,0,1594598400000,16066,Schmalkalden-Meiningen,83,1,78,125646,100
DE-TH,14-07-2020,RKI,0,0,0,1594684800000,16066,Schmalkalden-Meiningen,83,1,78,125646,100
DE-TH,19-03-2020,RKI,2,2,0,1584576000000,16067,Gotha,2,0,2,135452,145
DE-TH,20-03-2020,RKI,4,4,0,1584662400000,16067,Gotha,6,0,6,135452,145
DE-TH,23-03-2020,RKI,5,5,0,1584921600000,16067,Gotha,11,0,11,135452,145
DE-TH,24-03-2020,RKI,1,1,0,1585008000000,16067,Gotha,12,0,12,135452,145
DE-TH,26-03-2020,RKI,2,2,0,1585180800000,16067,Gotha,14,0,14,135452,145
DE-TH,27-03-2020,RKI,0,0,0,1585267200000,16067,Gotha,14,0,14,135452,145
DE-TH,29-03-2020,RKI,0,0,0,1585440000000,16067,Gotha,14,0,14,135452,145
DE-TH,30-03-2020,RKI,0,0,0,1585526400000,16067,Gotha,14,0,14,135452,145
DE-TH,31-03-2020,RKI,3,3,0,1585612800000,16067,Gotha,17,0,17,135452,145
DE-TH,01-04-2020,RKI,0,0,0,1585699200000,16067,Gotha,17,0,17,135452,145
DE-TH,02-04-2020,RKI,5,4,1,1585785600000,16067,Gotha,22,1,21,135452,145
DE-TH,03-04-2020,RKI,0,0,0,1585872000000,16067,Gotha,22,1,21,135452,145
DE-TH,04-04-2020,RKI,0,0,0,1585958400000,16067,Gotha,22,1,21,135452,145
DE-TH,06-04-2020,RKI,3,3,0,1586131200000,16067,Gotha,25,1,24,135452,145
DE-TH,07-04-2020,RKI,6,5,1,1586217600000,16067,Gotha,31,2,29,135452,145
DE-TH,08-04-2020,RKI,7,7,0,1586304000000,16067,Gotha,38,2,36,135452,145
DE-TH,09-04-2020,RKI,2,2,0,1586390400000,16067,Gotha,40,2,38,135452,145
DE-TH,10-04-2020,RKI,4,2,2,1586476800000,16067,Gotha,44,4,40,135452,145
DE-TH,11-04-2020,RKI,7,6,1,1586563200000,16067,Gotha,51,5,46,135452,145
DE-TH,12-04-2020,RKI,2,2,0,1586649600000,16067,Gotha,53,5,48,135452,145
DE-TH,13-04-2020,RKI,9,8,1,1586736000000,16067,Gotha,62,6,56,135452,145
DE-TH,14-04-2020,RKI,4,3,1,1586822400000,16067,Gotha,66,7,59,135452,145
DE-TH,15-04-2020,RKI,8,7,1,1586908800000,16067,Gotha,74,8,66,135452,145
DE-TH,16-04-2020,RKI,9,9,0,1586995200000,16067,Gotha,83,8,75,135452,145
DE-TH,17-04-2020,RKI,7,6,1,1587081600000,16067,Gotha,90,9,81,135452,145
DE-TH,18-04-2020,RKI,10,9,1,1587168000000,16067,Gotha,100,10,90,135452,145
DE-TH,19-04-2020,RKI,0,0,0,1587254400000,16067,Gotha,100,10,90,135452,145
DE-TH,20-04-2020,RKI,3,1,2,1587340800000,16067,Gotha,103,12,91,135452,145
DE-TH,21-04-2020,RKI,15,14,1,1587427200000,16067,Gotha,118,13,105,135452,145
DE-TH,22-04-2020,RKI,13,12,1,1587513600000,16067,Gotha,131,14,117,135452,145
DE-TH,23-04-2020,RKI,6,6,0,1587600000000,16067,Gotha,137,14,123,135452,145
DE-TH,24-04-2020,RKI,11,11,0,1587686400000,16067,Gotha,148,14,134,135452,145
DE-TH,25-04-2020,RKI,1,1,0,1587772800000,16067,Gotha,149,14,135,135452,145
DE-TH,26-04-2020,RKI,6,5,1,1587859200000,16067,Gotha,155,15,140,135452,145
DE-TH,27-04-2020,RKI,5,3,2,1587945600000,16067,Gotha,160,17,143,135452,145
DE-TH,28-04-2020,RKI,18,16,2,1588032000000,16067,Gotha,178,19,159,135452,145
DE-TH,29-04-2020,RKI,10,9,1,1588118400000,16067,Gotha,188,20,168,135452,145
DE-TH,30-04-2020,RKI,13,10,3,1588204800000,16067,Gotha,201,23,178,135452,145
DE-TH,01-05-2020,RKI,0,0,0,1588291200000,16067,Gotha,201,23,178,135452,145
DE-TH,05-05-2020,RKI,2,1,1,1588636800000,16067,Gotha,203,24,179,135452,145
DE-TH,06-05-2020,RKI,4,3,1,1588723200000,16067,Gotha,207,25,182,135452,145
DE-TH,07-05-2020,RKI,7,7,0,1588809600000,16067,Gotha,214,25,189,135452,145
DE-TH,08-05-2020,RKI,3,3,0,1588896000000,16067,Gotha,217,25,192,135452,145
DE-TH,09-05-2020,RKI,3,2,1,1588982400000,16067,Gotha,220,26,194,135452,145
DE-TH,10-05-2020,RKI,3,2,1,1589068800000,16067,Gotha,223,27,196,135452,145
DE-TH,11-05-2020,RKI,0,0,0,1589155200000,16067,Gotha,223,27,196,135452,145
DE-TH,12-05-2020,RKI,0,0,0,1589241600000,16067,Gotha,223,27,196,135452,145
DE-TH,13-05-2020,RKI,0,0,0,1589328000000,16067,Gotha,223,27,196,135452,145
DE-TH,14-05-2020,RKI,0,0,0,1589414400000,16067,Gotha,223,27,196,135452,145
DE-TH,15-05-2020,RKI,2,1,1,1589500800000,16067,Gotha,225,28,197,135452,145
DE-TH,18-05-2020,RKI,0,0,0,1589760000000,16067,Gotha,225,28,197,135452,145
DE-TH,20-05-2020,RKI,1,1,0,1589932800000,16067,Gotha,226,28,198,135452,145
DE-TH,22-05-2020,RKI,1,1,0,1590105600000,16067,Gotha,227,28,199,135452,145
DE-TH,23-05-2020,RKI,0,0,0,1590192000000,16067,Gotha,227,28,199,135452,145
DE-TH,26-05-2020,RKI,4,4,0,1590451200000,16067,Gotha,231,28,203,135452,145
DE-TH,27-05-2020,RKI,5,5,0,1590537600000,16067,Gotha,236,28,208,135452,145
DE-TH,28-05-2020,RKI,4,4,0,1590624000000,16067,Gotha,240,28,212,135452,145
DE-TH,03-06-2020,RKI,0,0,0,1591142400000,16067,Gotha,240,28,212,135452,145
DE-TH,04-06-2020,RKI,0,0,0,1591228800000,16067,Gotha,240,28,212,135452,145
DE-TH,05-06-2020,RKI,3,3,0,1591315200000,16067,Gotha,243,28,215,135452,145
DE-TH,09-06-2020,RKI,0,0,0,1591660800000,16067,Gotha,243,28,215,135452,145
DE-TH,10-06-2020,RKI,0,0,0,1591747200000,16067,Gotha,243,28,215,135452,145
DE-TH,17-06-2020,RKI,0,0,0,1592352000000,16067,Gotha,243,28,215,135452,145
DE-TH,19-06-2020,RKI,0,0,0,1592524800000,16067,Gotha,243,28,215,135452,145
DE-TH,22-06-2020,RKI,0,0,0,1592784000000,16067,Gotha,243,28,215,135452,145
DE-TH,24-06-2020,RKI,0,0,0,1592956800000,16067,Gotha,243,28,215,135452,145
DE-TH,02-07-2020,RKI,0,0,0,1593648000000,16067,Gotha,243,28,215,135452,145
DE-TH,05-07-2020,RKI,1,1,0,1593907200000,16067,Gotha,244,28,216,135452,145
DE-TH,14-07-2020,RKI,0,0,0,1594684800000,16067,Gotha,244,28,216,135452,145
DE-TH,15-07-2020,RKI,0,0,0,1594771200000,16067,Gotha,244,28,216,135452,145
DE-TH,20-03-2020,RKI,0,0,0,1584662400000,16068,Sömmerda,1,0,1,69655,86
DE-TH,21-03-2020,RKI,0,0,0,1584748800000,16068,Sömmerda,1,0,1,69655,86
DE-TH,22-03-2020,RKI,1,1,0,1584835200000,16068,Sömmerda,2,0,2,69655,86
DE-TH,23-03-2020,RKI,1,1,0,1584921600000,16068,Sömmerda,3,0,3,69655,86
DE-TH,24-03-2020,RKI,0,0,0,1585008000000,16068,Sömmerda,3,0,3,69655,86
DE-TH,25-03-2020,RKI,3,3,0,1585094400000,16068,Sömmerda,6,0,6,69655,86
DE-TH,26-03-2020,RKI,5,5,0,1585180800000,16068,Sömmerda,11,0,11,69655,86
DE-TH,27-03-2020,RKI,2,2,0,1585267200000,16068,Sömmerda,13,0,13,69655,86
DE-TH,31-03-2020,RKI,0,0,0,1585612800000,16068,Sömmerda,13,0,13,69655,86
DE-TH,01-04-2020,RKI,2,2,0,1585699200000,16068,Sömmerda,15,0,15,69655,86
DE-TH,02-04-2020,RKI,1,1,0,1585785600000,16068,Sömmerda,16,0,16,69655,86
DE-TH,05-04-2020,RKI,0,0,0,1586044800000,16068,Sömmerda,16,0,16,69655,86
DE-TH,07-04-2020,RKI,0,0,0,1586217600000,16068,Sömmerda,16,0,16,69655,86
DE-TH,08-04-2020,RKI,0,0,0,1586304000000,16068,Sömmerda,16,0,16,69655,86
DE-TH,09-04-2020,RKI,0,0,0,1586390400000,16068,Sömmerda,16,0,16,69655,86
DE-TH,16-04-2020,RKI,0,0,0,1586995200000,16068,Sömmerda,16,0,16,69655,86
DE-TH,21-04-2020,RKI,2,2,0,1587427200000,16068,Sömmerda,18,0,18,69655,86
DE-TH,01-05-2020,RKI,0,0,0,1588291200000,16068,Sömmerda,18,0,18,69655,86
DE-TH,30-06-2020,RKI,0,0,0,1593475200000,16068,Sömmerda,18,0,18,69655,86
DE-TH,11-07-2020,RKI,0,0,0,1594425600000,16068,Sömmerda,18,0,18,69655,86
DE-TH,14-07-2020,RKI,0,0,0,1594684800000,16068,Sömmerda,18,0,18,69655,86
DE-TH,16-07-2020,RKI,0,0,0,1594857600000,16068,Sömmerda,18,0,18,69655,86
DE-TH,24-03-2020,RKI,0,0,0,1585008000000,16069,Hildburghausen,0,0,0,63553,68
DE-TH,25-03-2020,RKI,0,0,0,1585094400000,16069,Hildburghausen,0,0,0,63553,68
DE-TH,26-03-2020,RKI,2,2,0,1585180800000,16069,Hildburghausen,2,0,2,63553,68
DE-TH,27-03-2020,RKI,0,0,0,1585267200000,16069,Hildburghausen,2,0,2,63553,68
DE-TH,30-03-2020,RKI,1,1,0,1585526400000,16069,Hildburghausen,3,0,3,63553,68
DE-TH,31-03-2020,RKI,0,0,0,1585612800000,16069,Hildburghausen,3,0,3,63553,68
DE-TH,03-04-2020,RKI,0,0,0,1585872000000,16069,Hildburghausen,3,0,3,63553,68
DE-TH,08-04-2020,RKI,0,0,0,1586304000000,16069,Hildburghausen,3,0,3,63553,68
DE-TH,09-04-2020,RKI,0,0,0,1586390400000,16069,Hildburghausen,3,0,3,63553,68
DE-TH,11-04-2020,RKI,0,0,0,1586563200000,16069,Hildburghausen,3,0,3,63553,68
DE-TH,12-04-2020,RKI,0,0,0,1586649600000,16069,Hildburghausen,3,0,3,63553,68
DE-TH,16-04-2020,RKI,0,0,0,1586995200000,16069,Hildburghausen,3,0,3,63553,68
DE-TH,17-04-2020,RKI,1,1,0,1587081600000,16069,Hildburghausen,4,0,4,63553,68
DE-TH,23-04-2020,RKI,0,0,0,1587600000000,16069,Hildburghausen,4,0,4,63553,68
DE-TH,24-04-2020,RKI,0,0,0,1587686400000,16069,Hildburghausen,4,0,4,63553,68
DE-TH,29-04-2020,RKI,1,1,0,1588118400000,16069,Hildburghausen,5,0,5,63553,68
DE-TH,30-04-2020,RKI,0,0,0,1588204800000,16069,Hildburghausen,5,0,5,63553,68
DE-TH,04-05-2020,RKI,0,0,0,1588550400000,16069,Hildburghausen,5,0,5,63553,68
DE-TH,06-05-2020,RKI,2,2,0,1588723200000,16069,Hildburghausen,7,0,7,63553,68
DE-TH,07-05-2020,RKI,0,0,0,1588809600000,16069,Hildburghausen,7,0,7,63553,68
DE-TH,08-05-2020,RKI,2,2,0,1588896000000,16069,Hildburghausen,9,0,9,63553,68
DE-TH,12-05-2020,RKI,0,0,0,1589241600000,16069,Hildburghausen,9,0,9,63553,68
DE-TH,19-05-2020,RKI,0,0,0,1589846400000,16069,Hildburghausen,9,0,9,63553,68
DE-TH,20-05-2020,RKI,1,1,0,1589932800000,16069,Hildburghausen,10,0,10,63553,68
DE-TH,23-05-2020,RKI,1,1,0,1590192000000,16069,Hildburghausen,11,0,11,63553,68
DE-TH,24-05-2020,RKI,1,1,0,1590278400000,16069,Hildburghausen,12,0,12,63553,68
DE-TH,29-05-2020,RKI,2,2,0,1590710400000,16069,Hildburghausen,14,0,14,63553,68
DE-TH,01-06-2020,RKI,0,0,0,1590969600000,16069,Hildburghausen,14,0,14,63553,68
DE-TH,03-06-2020,RKI,8,8,0,1591142400000,16069,Hildburghausen,22,0,22,63553,68
DE-TH,05-06-2020,RKI,0,0,0,1591315200000,16069,Hildburghausen,22,0,22,63553,68
DE-TH,10-06-2020,RKI,1,1,0,1591747200000,16069,Hildburghausen,23,0,23,63553,68
DE-TH,12-06-2020,RKI,1,1,0,1591920000000,16069,Hildburghausen,24,0,24,63553,68
DE-TH,13-06-2020,RKI,0,0,0,1592006400000,16069,Hildburghausen,24,0,24,63553,68
DE-TH,14-06-2020,RKI,1,1,0,1592092800000,16069,Hildburghausen,25,0,25,63553,68
DE-TH,16-06-2020,RKI,1,1,0,1592265600000,16069,Hildburghausen,26,0,26,63553,68
DE-TH,18-06-2020,RKI,1,1,0,1592438400000,16069,Hildburghausen,27,0,27,63553,68
DE-TH,20-06-2020,RKI,1,1,0,1592611200000,16069,Hildburghausen,28,0,28,63553,68
DE-TH,23-06-2020,RKI,0,0,0,1592870400000,16069,Hildburghausen,28,0,28,63553,68
DE-TH,25-06-2020,RKI,0,0,0,1593043200000,16069,Hildburghausen,28,0,28,63553,68
DE-TH,26-06-2020,RKI,0,0,0,1593129600000,16069,Hildburghausen,28,0,28,63553,68
DE-TH,02-07-2020,RKI,1,0,0,1593648000000,16069,Hildburghausen,29,0,28,63553,68
DE-TH,04-07-2020,RKI,2,0,0,1593820800000,16069,Hildburghausen,31,0,28,63553,68
DE-TH,07-07-2020,RKI,0,0,0,1594080000000,16069,Hildburghausen,31,0,28,63553,68
DE-TH,08-07-2020,RKI,0,0,0,1594166400000,16069,Hildburghausen,31,0,28,63553,68
DE-TH,09-07-2020,RKI,0,0,0,1594252800000,16069,Hildburghausen,31,0,28,63553,68
DE-TH,10-07-2020,RKI,0,0,0,1594339200000,16069,Hildburghausen,31,0,28,63553,68
DE-TH,11-07-2020,RKI,0,0,0,1594425600000,16069,Hildburghausen,31,0,28,63553,68
DE-TH,15-07-2020,RKI,0,0,0,1594771200000,16069,Hildburghausen,31,0,28,63553,68
DE-TH,17-03-2020,RKI,0,0,0,1584403200000,16070,Ilm-Kreis,0,0,0,106622,132
DE-TH,18-03-2020,RKI,0,0,0,1584489600000,16070,Ilm-Kreis,0,0,0,106622,132
DE-TH,19-03-2020,RKI,0,0,0,1584576000000,16070,Ilm-Kreis,0,0,0,106622,132
DE-TH,20-03-2020,RKI,3,3,0,1584662400000,16070,Ilm-Kreis,3,0,3,106622,132
DE-TH,21-03-2020,RKI,1,1,0,1584748800000,16070,Ilm-Kreis,4,0,4,106622,132
DE-TH,22-03-2020,RKI,0,0,0,1584835200000,16070,Ilm-Kreis,4,0,4,106622,132
DE-TH,23-03-2020,RKI,1,1,0,1584921600000,16070,Ilm-Kreis,5,0,5,106622,132
DE-TH,24-03-2020,RKI,7,7,0,1585008000000,16070,Ilm-Kreis,12,0,12,106622,132
DE-TH,25-03-2020,RKI,8,8,0,1585094400000,16070,Ilm-Kreis,20,0,20,106622,132
DE-TH,26-03-2020,RKI,8,8,0,1585180800000,16070,Ilm-Kreis,28,0,28,106622,132
DE-TH,27-03-2020,RKI,11,11,0,1585267200000,16070,Ilm-Kreis,39,0,39,106622,132
DE-TH,28-03-2020,RKI,3,3,0,1585353600000,16070,Ilm-Kreis,42,0,42,106622,132
DE-TH,30-03-2020,RKI,2,2,0,1585526400000,16070,Ilm-Kreis,44,0,44,106622,132
DE-TH,31-03-2020,RKI,6,5,1,1585612800000,16070,Ilm-Kreis,50,1,49,106622,132
DE-TH,02-04-2020,RKI,8,8,0,1585785600000,16070,Ilm-Kreis,58,1,57,106622,132
DE-TH,03-04-2020,RKI,5,5,0,1585872000000,16070,Ilm-Kreis,63,1,62,106622,132
DE-TH,04-04-2020,RKI,11,11,0,1585958400000,16070,Ilm-Kreis,74,1,73,106622,132
DE-TH,06-04-2020,RKI,3,2,1,1586131200000,16070,Ilm-Kreis,77,2,75,106622,132
DE-TH,07-04-2020,RKI,0,0,0,1586217600000,16070,Ilm-Kreis,77,2,75,106622,132
DE-TH,08-04-2020,RKI,1,0,1,1586304000000,16070,Ilm-Kreis,78,3,75,106622,132
DE-TH,09-04-2020,RKI,1,0,1,1586390400000,16070,Ilm-Kreis,79,4,75,106622,132
DE-TH,13-04-2020,RKI,0,0,0,1586736000000,16070,Ilm-Kreis,79,4,75,106622,132
DE-TH,15-04-2020,RKI,0,0,0,1586908800000,16070,Ilm-Kreis,79,4,75,106622,132
DE-TH,16-04-2020,RKI,2,2,0,1586995200000,16070,Ilm-Kreis,81,4,77,106622,132
DE-TH,17-04-2020,RKI,2,2,0,1587081600000,16070,Ilm-Kreis,83,4,79,106622,132
DE-TH,18-04-2020,RKI,1,1,0,1587168000000,16070,Ilm-Kreis,84,4,80,106622,132
DE-TH,20-04-2020,RKI,0,0,0,1587340800000,16070,Ilm-Kreis,84,4,80,106622,132
DE-TH,21-04-2020,RKI,5,5,0,1587427200000,16070,Ilm-Kreis,89,4,85,106622,132
DE-TH,22-04-2020,RKI,0,0,0,1587513600000,16070,Ilm-Kreis,89,4,85,106622,132
DE-TH,24-04-2020,RKI,0,0,0,1587686400000,16070,Ilm-Kreis,89,4,85,106622,132
DE-TH,01-05-2020,RKI,0,0,0,1588291200000,16070,Ilm-Kreis,89,4,85,106622,132
DE-TH,02-05-2020,RKI,0,0,0,1588377600000,16070,Ilm-Kreis,89,4,85,106622,132
DE-TH,05-05-2020,RKI,1,1,0,1588636800000,16070,Ilm-Kreis,90,4,86,106622,132
DE-TH,06-05-2020,RKI,1,1,0,1588723200000,16070,Ilm-Kreis,91,4,87,106622,132
DE-TH,09-05-2020,RKI,1,1,0,1588982400000,16070,Ilm-Kreis,92,4,88,106622,132
DE-TH,20-05-2020,RKI,0,0,0,1589932800000,16070,Ilm-Kreis,92,4,88,106622,132
DE-TH,26-05-2020,RKI,2,1,1,1590451200000,16070,Ilm-Kreis,94,5,89,106622,132
DE-TH,27-05-2020,RKI,1,1,0,1590537600000,16070,Ilm-Kreis,95,5,90,106622,132
DE-TH,28-05-2020,RKI,0,0,0,1590624000000,16070,Ilm-Kreis,95,5,90,106622,132
DE-TH,08-07-2020,RKI,0,0,0,1594166400000,16070,Ilm-Kreis,95,5,90,106622,132
DE-TH,15-07-2020,RKI,2,0,0,1594771200000,16070,Ilm-Kreis,97,5,90,106622,132
DE-TH,17-03-2020,RKI,0,0,0,1584403200000,16071,Weimarer Land,0,0,0,81947,102
DE-TH,18-03-2020,RKI,2,2,0,1584489600000,16071,Weimarer Land,2,0,2,81947,102
DE-TH,19-03-2020,RKI,0,0,0,1584576000000,16071,Weimarer Land,2,0,2,81947,102
DE-TH,20-03-2020,RKI,3,3,0,1584662400000,16071,Weimarer Land,5,0,5,81947,102
DE-TH,22-03-2020,RKI,0,0,0,1584835200000,16071,Weimarer Land,5,0,5,81947,102
DE-TH,23-03-2020,RKI,1,1,0,1584921600000,16071,Weimarer Land,6,0,6,81947,102
DE-TH,24-03-2020,RKI,0,0,0,1585008000000,16071,Weimarer Land,6,0,6,81947,102
DE-TH,25-03-2020,RKI,0,0,0,1585094400000,16071,Weimarer Land,6,0,6,81947,102
DE-TH,26-03-2020,RKI,1,1,0,1585180800000,16071,Weimarer Land,7,0,7,81947,102
DE-TH,27-03-2020,RKI,0,0,0,1585267200000,16071,Weimarer Land,7,0,7,81947,102
DE-TH,28-03-2020,RKI,2,2,0,1585353600000,16071,Weimarer Land,9,0,9,81947,102
DE-TH,30-03-2020,RKI,2,2,0,1585526400000,16071,Weimarer Land,11,0,11,81947,102
DE-TH,31-03-2020,RKI,1,1,0,1585612800000,16071,Weimarer Land,12,0,12,81947,102
DE-TH,01-04-2020,RKI,2,2,0,1585699200000,16071,Weimarer Land,14,0,14,81947,102
DE-TH,02-04-2020,RKI,0,0,0,1585785600000,16071,Weimarer Land,14,0,14,81947,102
DE-TH,03-04-2020,RKI,5,5,0,1585872000000,16071,Weimarer Land,19,0,19,81947,102
DE-TH,04-04-2020,RKI,4,3,1,1585958400000,16071,Weimarer Land,23,1,22,81947,102
DE-TH,05-04-2020,RKI,11,8,3,1586044800000,16071,Weimarer Land,34,4,30,81947,102
DE-TH,06-04-2020,RKI,0,0,0,1586131200000,16071,Weimarer Land,34,4,30,81947,102
DE-TH,09-04-2020,RKI,2,2,0,1586390400000,16071,Weimarer Land,36,4,32,81947,102
DE-TH,10-04-2020,RKI,0,0,0,1586476800000,16071,Weimarer Land,36,4,32,81947,102
DE-TH,14-04-2020,RKI,0,0,0,1586822400000,16071,Weimarer Land,36,4,32,81947,102
DE-TH,16-04-2020,RKI,4,4,0,1586995200000,16071,Weimarer Land,40,4,36,81947,102
DE-TH,17-04-2020,RKI,0,0,0,1587081600000,16071,Weimarer Land,40,4,36,81947,102
DE-TH,19-04-2020,RKI,0,0,0,1587254400000,16071,Weimarer Land,40,4,36,81947,102
DE-TH,21-04-2020,RKI,0,0,0,1587427200000,16071,Weimarer Land,40,4,36,81947,102
DE-TH,28-04-2020,RKI,0,0,0,1588032000000,16071,Weimarer Land,40,4,36,81947,102
DE-TH,30-04-2020,RKI,0,0,0,1588204800000,16071,Weimarer Land,40,4,36,81947,102
DE-TH,05-05-2020,RKI,0,0,0,1588636800000,16071,Weimarer Land,40,4,36,81947,102
DE-TH,06-05-2020,RKI,0,0,0,1588723200000,16071,Weimarer Land,40,4,36,81947,102
DE-TH,07-05-2020,RKI,0,0,0,1588809600000,16071,Weimarer Land,40,4,36,81947,102
DE-TH,09-05-2020,RKI,0,0,0,1588982400000,16071,Weimarer Land,40,4,36,81947,102
DE-TH,05-06-2020,RKI,0,0,0,1591315200000,16071,Weimarer Land,40,4,36,81947,102
DE-TH,07-07-2020,RKI,0,0,0,1594080000000,16071,Weimarer Land,40,4,36,81947,102
DE-TH,15-07-2020,RKI,1,0,0,1594771200000,16071,Weimarer Land,41,4,36,81947,102
DE-TH,22-03-2020,RKI,0,0,0,1584835200000,16072,Sonneberg,4,0,4,58410,135
DE-TH,24-03-2020,RKI,2,2,0,1585008000000,16072,Sonneberg,6,0,6,58410,135
DE-TH,25-03-2020,RKI,1,1,0,1585094400000,16072,Sonneberg,7,0,7,58410,135
DE-TH,26-03-2020,RKI,2,2,0,1585180800000,16072,Sonneberg,9,0,9,58410,135
DE-TH,27-03-2020,RKI,1,1,0,1585267200000,16072,Sonneberg,10,0,10,58410,135
DE-TH,28-03-2020,RKI,3,3,0,1585353600000,16072,Sonneberg,13,0,13,58410,135
DE-TH,30-03-2020,RKI,1,1,0,1585526400000,16072,Sonneberg,14,0,14,58410,135
DE-TH,31-03-2020,RKI,7,7,0,1585612800000,16072,Sonneberg,21,0,21,58410,135
DE-TH,01-04-2020,RKI,1,0,1,1585699200000,16072,Sonneberg,22,1,21,58410,135
DE-TH,02-04-2020,RKI,0,0,0,1585785600000,16072,Sonneberg,22,1,21,58410,135
DE-TH,03-04-2020,RKI,1,1,0,1585872000000,16072,Sonneberg,23,1,22,58410,135
DE-TH,04-04-2020,RKI,0,0,0,1585958400000,16072,Sonneberg,23,1,22,58410,135
DE-TH,06-04-2020,RKI,0,0,0,1586131200000,16072,Sonneberg,23,1,22,58410,135
DE-TH,07-04-2020,RKI,1,1,0,1586217600000,16072,Sonneberg,24,1,23,58410,135
DE-TH,08-04-2020,RKI,4,3,1,1586304000000,16072,Sonneberg,28,2,26,58410,135
DE-TH,09-04-2020,RKI,2,2,0,1586390400000,16072,Sonneberg,30,2,28,58410,135
DE-TH,11-04-2020,RKI,1,1,0,1586563200000,16072,Sonneberg,31,2,29,58410,135
DE-TH,12-04-2020,RKI,0,0,0,1586649600000,16072,Sonneberg,31,2,29,58410,135
DE-TH,13-04-2020,RKI,0,0,0,1586736000000,16072,Sonneberg,31,2,29,58410,135
DE-TH,14-04-2020,RKI,1,0,1,1586822400000,16072,Sonneberg,32,3,29,58410,135
DE-TH,15-04-2020,RKI,0,0,0,1586908800000,16072,Sonneberg,32,3,29,58410,135
DE-TH,16-04-2020,RKI,2,2,0,1586995200000,16072,Sonneberg,34,3,31,58410,135
DE-TH,17-04-2020,RKI,1,0,1,1587081600000,16072,Sonneberg,35,4,31,58410,135
DE-TH,18-04-2020,RKI,1,1,0,1587168000000,16072,Sonneberg,36,4,32,58410,135
DE-TH,20-04-2020,RKI,10,8,2,1587340800000,16072,Sonneberg,46,6,40,58410,135
DE-TH,21-04-2020,RKI,1,1,0,1587427200000,16072,Sonneberg,47,6,41,58410,135
DE-TH,22-04-2020,RKI,2,2,0,1587513600000,16072,Sonneberg,49,6,43,58410,135
DE-TH,23-04-2020,RKI,4,3,1,1587600000000,16072,Sonneberg,53,7,46,58410,135
DE-TH,24-04-2020,RKI,3,2,1,1587686400000,16072,Sonneberg,56,8,48,58410,135
DE-TH,25-04-2020,RKI,2,2,0,1587772800000,16072,Sonneberg,58,8,50,58410,135
DE-TH,26-04-2020,RKI,0,0,0,1587859200000,16072,Sonneberg,58,8,50,58410,135
DE-TH,27-04-2020,RKI,3,3,0,1587945600000,16072,Sonneberg,61,8,53,58410,135
DE-TH,28-04-2020,RKI,9,9,0,1588032000000,16072,Sonneberg,70,8,62,58410,135
DE-TH,29-04-2020,RKI,2,2,0,1588118400000,16072,Sonneberg,72,8,64,58410,135
DE-TH,30-04-2020,RKI,4,3,1,1588204800000,16072,Sonneberg,76,9,67,58410,135
DE-TH,01-05-2020,RKI,0,0,0,1588291200000,16072,Sonneberg,76,9,67,58410,135
DE-TH,02-05-2020,RKI,0,0,0,1588377600000,16072,Sonneberg,76,9,67,58410,135
DE-TH,04-05-2020,RKI,5,3,2,1588550400000,16072,Sonneberg,81,11,70,58410,135
DE-TH,05-05-2020,RKI,3,3,0,1588636800000,16072,Sonneberg,84,11,73,58410,135
DE-TH,06-05-2020,RKI,4,3,1,1588723200000,16072,Sonneberg,88,12,76,58410,135
DE-TH,07-05-2020,RKI,13,11,2,1588809600000,16072,Sonneberg,101,14,87,58410,135
DE-TH,08-05-2020,RKI,5,5,0,1588896000000,16072,Sonneberg,106,14,92,58410,135
DE-TH,09-05-2020,RKI,6,6,0,1588982400000,16072,Sonneberg,112,14,98,58410,135
DE-TH,10-05-2020,RKI,1,1,0,1589068800000,16072,Sonneberg,113,14,99,58410,135
DE-TH,11-05-2020,RKI,6,6,0,1589155200000,16072,Sonneberg,119,14,105,58410,135
DE-TH,12-05-2020,RKI,2,2,0,1589241600000,16072,Sonneberg,121,14,107,58410,135
DE-TH,13-05-2020,RKI,2,1,1,1589328000000,16072,Sonneberg,123,15,108,58410,135
DE-TH,14-05-2020,RKI,2,2,0,1589414400000,16072,Sonneberg,125,15,110,58410,135
DE-TH,15-05-2020,RKI,3,2,1,1589500800000,16072,Sonneberg,128,16,112,58410,135
DE-TH,16-05-2020,RKI,8,7,1,1589587200000,16072,Sonneberg,136,17,119,58410,135
DE-TH,17-05-2020,RKI,1,0,1,1589673600000,16072,Sonneberg,137,18,119,58410,135
DE-TH,18-05-2020,RKI,0,0,0,1589760000000,16072,Sonneberg,137,18,119,58410,135
DE-TH,19-05-2020,RKI,8,8,0,1589846400000,16072,Sonneberg,145,18,127,58410,135
DE-TH,20-05-2020,RKI,1,1,0,1589932800000,16072,Sonneberg,146,18,128,58410,135
DE-TH,21-05-2020,RKI,4,4,0,1590019200000,16072,Sonneberg,150,18,132,58410,135
DE-TH,22-05-2020,RKI,1,1,0,1590105600000,16072,Sonneberg,151,18,133,58410,135
DE-TH,24-05-2020,RKI,1,1,0,1590278400000,16072,Sonneberg,152,18,134,58410,135
DE-TH,25-05-2020,RKI,4,4,0,1590364800000,16072,Sonneberg,156,18,138,58410,135
DE-TH,26-05-2020,RKI,6,6,0,1590451200000,16072,Sonneberg,162,18,144,58410,135
DE-TH,27-05-2020,RKI,2,2,0,1590537600000,16072,Sonneberg,164,18,146,58410,135
DE-TH,28-05-2020,RKI,18,18,0,1590624000000,16072,Sonneberg,182,18,164,58410,135
DE-TH,29-05-2020,RKI,2,2,0,1590710400000,16072,Sonneberg,184,18,166,58410,135
DE-TH,30-05-2020,RKI,0,0,0,1590796800000,16072,Sonneberg,184,18,166,58410,135
DE-TH,31-05-2020,RKI,3,2,1,1590883200000,16072,Sonneberg,187,19,168,58410,135
DE-TH,04-06-2020,RKI,7,7,0,1591228800000,16072,Sonneberg,194,19,175,58410,135
DE-TH,05-06-2020,RKI,2,2,0,1591315200000,16072,Sonneberg,196,19,177,58410,135
DE-TH,06-06-2020,RKI,2,2,0,1591401600000,16072,Sonneberg,198,19,179,58410,135
DE-TH,07-06-2020,RKI,2,2,0,1591488000000,16072,Sonneberg,200,19,181,58410,135
DE-TH,08-06-2020,RKI,1,1,0,1591574400000,16072,Sonneberg,201,19,182,58410,135
DE-TH,09-06-2020,RKI,1,1,0,1591660800000,16072,Sonneberg,202,19,183,58410,135
DE-TH,10-06-2020,RKI,3,3,0,1591747200000,16072,Sonneberg,205,19,186,58410,135
DE-TH,11-06-2020,RKI,2,2,0,1591833600000,16072,Sonneberg,207,19,188,58410,135
DE-TH,12-06-2020,RKI,1,1,0,1591920000000,16072,Sonneberg,208,19,189,58410,135
DE-TH,13-06-2020,RKI,0,0,0,1592006400000,16072,Sonneberg,208,19,189,58410,135
DE-TH,14-06-2020,RKI,1,1,0,1592092800000,16072,Sonneberg,209,19,190,58410,135
DE-TH,15-06-2020,RKI,0,0,0,1592179200000,16072,Sonneberg,209,19,190,58410,135
DE-TH,16-06-2020,RKI,2,2,0,1592265600000,16072,Sonneberg,211,19,192,58410,135
DE-TH,17-06-2020,RKI,0,0,0,1592352000000,16072,Sonneberg,211,19,192,58410,135
DE-TH,19-06-2020,RKI,1,1,0,1592524800000,16072,Sonneberg,212,19,193,58410,135
DE-TH,20-06-2020,RKI,5,4,0,1592611200000,16072,Sonneberg,217,19,197,58410,135
DE-TH,23-06-2020,RKI,0,0,0,1592870400000,16072,Sonneberg,217,19,197,58410,135
DE-TH,25-06-2020,RKI,1,1,0,1593043200000,16072,Sonneberg,218,19,198,58410,135
DE-TH,26-06-2020,RKI,0,0,0,1593129600000,16072,Sonneberg,218,19,198,58410,135
DE-TH,02-07-2020,RKI,0,0,0,1593648000000,16072,Sonneberg,218,19,198,58410,135
DE-TH,08-07-2020,RKI,0,0,0,1594166400000,16072,Sonneberg,218,19,198,58410,135
DE-TH,09-07-2020,RKI,0,0,0,1594252800000,16072,Sonneberg,218,19,198,58410,135
DE-TH,18-03-2020,RKI,5,5,0,1584489600000,16073,Saalfeld-Rudolstadt,9,0,9,104142,101
DE-TH,19-03-2020,RKI,0,0,0,1584576000000,16073,Saalfeld-Rudolstadt,9,0,9,104142,101
DE-TH,20-03-2020,RKI,4,4,0,1584662400000,16073,Saalfeld-Rudolstadt,13,0,13,104142,101
DE-TH,23-03-2020,RKI,0,0,0,1584921600000,16073,Saalfeld-Rudolstadt,13,0,13,104142,101
DE-TH,24-03-2020,RKI,2,2,0,1585008000000,16073,Saalfeld-Rudolstadt,15,0,15,104142,101
DE-TH,25-03-2020,RKI,6,6,0,1585094400000,16073,Saalfeld-Rudolstadt,21,0,21,104142,101
DE-TH,26-03-2020,RKI,3,3,0,1585180800000,16073,Saalfeld-Rudolstadt,24,0,24,104142,101
DE-TH,28-03-2020,RKI,2,2,0,1585353600000,16073,Saalfeld-Rudolstadt,26,0,26,104142,101
DE-TH,29-03-2020,RKI,1,1,0,1585440000000,16073,Saalfeld-Rudolstadt,27,0,27,104142,101
DE-TH,30-03-2020,RKI,0,0,0,1585526400000,16073,Saalfeld-Rudolstadt,27,0,27,104142,101
DE-TH,31-03-2020,RKI,3,3,0,1585612800000,16073,Saalfeld-Rudolstadt,30,0,30,104142,101
DE-TH,01-04-2020,RKI,3,3,0,1585699200000,16073,Saalfeld-Rudolstadt,33,0,33,104142,101
DE-TH,02-04-2020,RKI,0,0,0,1585785600000,16073,Saalfeld-Rudolstadt,33,0,33,104142,101
DE-TH,03-04-2020,RKI,1,1,0,1585872000000,16073,Saalfeld-Rudolstadt,34,0,34,104142,101
DE-TH,04-04-2020,RKI,0,0,0,1585958400000,16073,Saalfeld-Rudolstadt,34,0,34,104142,101
DE-TH,07-04-2020,RKI,0,0,0,1586217600000,16073,Saalfeld-Rudolstadt,34,0,34,104142,101
DE-TH,08-04-2020,RKI,1,1,0,1586304000000,16073,Saalfeld-Rudolstadt,35,0,35,104142,101
DE-TH,21-04-2020,RKI,1,1,0,1587427200000,16073,Saalfeld-Rudolstadt,36,0,36,104142,101
DE-TH,23-04-2020,RKI,0,0,0,1587600000000,16073,Saalfeld-Rudolstadt,36,0,36,104142,101
DE-TH,24-04-2020,RKI,0,0,0,1587686400000,16073,Saalfeld-Rudolstadt,36,0,36,104142,101
DE-TH,27-04-2020,RKI,0,0,0,1587945600000,16073,Saalfeld-Rudolstadt,36,0,36,104142,101
DE-TH,28-04-2020,RKI,3,3,0,1588032000000,16073,Saalfeld-Rudolstadt,39,0,39,104142,101
DE-TH,05-05-2020,RKI,0,0,0,1588636800000,16073,Saalfeld-Rudolstadt,39,0,39,104142,101
DE-TH,07-05-2020,RKI,0,0,0,1588809600000,16073,Saalfeld-Rudolstadt,39,0,39,104142,101
DE-TH,12-05-2020,RKI,0,0,0,1589241600000,16073,Saalfeld-Rudolstadt,39,0,39,104142,101
DE-TH,15-05-2020,RKI,0,0,0,1589500800000,16073,Saalfeld-Rudolstadt,39,0,39,104142,101
DE-TH,16-05-2020,RKI,0,0,0,1589587200000,16073,Saalfeld-Rudolstadt,39,0,39,104142,101
DE-TH,27-05-2020,RKI,0,0,0,1590537600000,16073,Saalfeld-Rudolstadt,39,0,39,104142,101
DE-TH,28-05-2020,RKI,0,0,0,1590624000000,16073,Saalfeld-Rudolstadt,39,0,39,104142,101
DE-TH,22-06-2020,RKI,0,0,0,1592784000000,16073,Saalfeld-Rudolstadt,39,0,39,104142,101
DE-TH,12-03-2020,RKI,1,1,0,1583971200000,16074,Saale-Holzland-Kreis,1,0,1,83051,102
DE-TH,17-03-2020,RKI,0,0,0,1584403200000,16074,Saale-Holzland-Kreis,1,0,1,83051,102
DE-TH,18-03-2020,RKI,2,2,0,1584489600000,16074,Saale-Holzland-Kreis,3,0,3,83051,102
DE-TH,19-03-2020,RKI,4,4,0,1584576000000,16074,Saale-Holzland-Kreis,7,0,7,83051,102
DE-TH,20-03-2020,RKI,0,0,0,1584662400000,16074,Saale-Holzland-Kreis,7,0,7,83051,102
DE-TH,21-03-2020,RKI,2,2,0,1584748800000,16074,Saale-Holzland-Kreis,9,0,9,83051,102
DE-TH,25-03-2020,RKI,1,1,0,1585094400000,16074,Saale-Holzland-Kreis,10,0,10,83051,102
DE-TH,26-03-2020,RKI,0,0,0,1585180800000,16074,Saale-Holzland-Kreis,10,0,10,83051,102
DE-TH,27-03-2020,RKI,0,0,0,1585267200000,16074,Saale-Holzland-Kreis,10,0,10,83051,102
DE-TH,28-03-2020,RKI,4,4,0,1585353600000,16074,Saale-Holzland-Kreis,14,0,14,83051,102
DE-TH,30-03-2020,RKI,0,0,0,1585526400000,16074,Saale-Holzland-Kreis,14,0,14,83051,102
DE-TH,31-03-2020,RKI,1,1,0,1585612800000,16074,Saale-Holzland-Kreis,15,0,15,83051,102
DE-TH,01-04-2020,RKI,0,0,0,1585699200000,16074,Saale-Holzland-Kreis,15,0,15,83051,102
DE-TH,02-04-2020,RKI,3,3,0,1585785600000,16074,Saale-Holzland-Kreis,18,0,18,83051,102
DE-TH,03-04-2020,RKI,4,4,0,1585872000000,16074,Saale-Holzland-Kreis,22,0,22,83051,102
DE-TH,05-04-2020,RKI,3,3,0,1586044800000,16074,Saale-Holzland-Kreis,25,0,25,83051,102
DE-TH,06-04-2020,RKI,0,0,0,1586131200000,16074,Saale-Holzland-Kreis,25,0,25,83051,102
DE-TH,07-04-2020,RKI,0,0,0,1586217600000,16074,Saale-Holzland-Kreis,25,0,25,83051,102
DE-TH,08-04-2020,RKI,0,0,0,1586304000000,16074,Saale-Holzland-Kreis,25,0,25,83051,102
DE-TH,09-04-2020,RKI,0,0,0,1586390400000,16074,Saale-Holzland-Kreis,25,0,25,83051,102
DE-TH,10-04-2020,RKI,0,0,0,1586476800000,16074,Saale-Holzland-Kreis,25,0,25,83051,102
DE-TH,21-04-2020,RKI,0,0,0,1587427200000,16074,Saale-Holzland-Kreis,25,0,25,83051,102
DE-TH,22-04-2020,RKI,1,1,0,1587513600000,16074,Saale-Holzland-Kreis,26,0,26,83051,102
DE-TH,23-04-2020,RKI,1,1,0,1587600000000,16074,Saale-Holzland-Kreis,27,0,27,83051,102
DE-TH,27-04-2020,RKI,0,0,0,1587945600000,16074,Saale-Holzland-Kreis,27,0,27,83051,102
DE-TH,30-04-2020,RKI,1,1,0,1588204800000,16074,Saale-Holzland-Kreis,28,0,28,83051,102
DE-TH,02-05-2020,RKI,0,0,0,1588377600000,16074,Saale-Holzland-Kreis,28,0,28,83051,102
DE-TH,05-05-2020,RKI,0,0,0,1588636800000,16074,Saale-Holzland-Kreis,28,0,28,83051,102
DE-TH,06-05-2020,RKI,1,1,0,1588723200000,16074,Saale-Holzland-Kreis,29,0,29,83051,102
DE-TH,09-05-2020,RKI,2,2,0,1588982400000,16074,Saale-Holzland-Kreis,31,0,31,83051,102
DE-TH,13-05-2020,RKI,0,0,0,1589328000000,16074,Saale-Holzland-Kreis,31,0,31,83051,102
DE-TH,16-05-2020,RKI,0,0,0,1589587200000,16074,Saale-Holzland-Kreis,31,0,31,83051,102
DE-TH,21-05-2020,RKI,0,0,0,1590019200000,16074,Saale-Holzland-Kreis,31,0,31,83051,102
DE-TH,26-05-2020,RKI,0,0,0,1590451200000,16074,Saale-Holzland-Kreis,31,0,31,83051,102
DE-TH,27-05-2020,RKI,0,0,0,1590537600000,16074,Saale-Holzland-Kreis,31,0,31,83051,102
DE-TH,04-06-2020,RKI,0,0,0,1591228800000,16074,Saale-Holzland-Kreis,31,0,31,83051,102
DE-TH,10-06-2020,RKI,0,0,0,1591747200000,16074,Saale-Holzland-Kreis,31,0,31,83051,102
DE-TH,10-03-2020,RKI,1,1,0,1583798400000,16075,Saale-Orla-Kreis,1,0,1,80868,70
DE-TH,18-03-2020,RKI,0,0,0,1584489600000,16075,Saale-Orla-Kreis,1,0,1,80868,70
DE-TH,19-03-2020,RKI,1,1,0,1584576000000,16075,Saale-Orla-Kreis,2,0,2,80868,70
DE-TH,20-03-2020,RKI,0,0,0,1584662400000,16075,Saale-Orla-Kreis,2,0,2,80868,70
DE-TH,23-03-2020,RKI,0,0,0,1584921600000,16075,Saale-Orla-Kreis,2,0,2,80868,70
DE-TH,25-03-2020,RKI,1,1,0,1585094400000,16075,Saale-Orla-Kreis,3,0,3,80868,70
DE-TH,26-03-2020,RKI,0,0,0,1585180800000,16075,Saale-Orla-Kreis,3,0,3,80868,70
DE-TH,27-03-2020,RKI,15,12,3,1585267200000,16075,Saale-Orla-Kreis,18,3,15,80868,70
DE-TH,30-03-2020,RKI,6,6,0,1585526400000,16075,Saale-Orla-Kreis,24,3,21,80868,70
DE-TH,31-03-2020,RKI,2,2,0,1585612800000,16075,Saale-Orla-Kreis,26,3,23,80868,70
DE-TH,01-04-2020,RKI,3,3,0,1585699200000,16075,Saale-Orla-Kreis,29,3,26,80868,70
DE-TH,02-04-2020,RKI,8,8,0,1585785600000,16075,Saale-Orla-Kreis,37,3,34,80868,70
DE-TH,03-04-2020,RKI,10,7,3,1585872000000,16075,Saale-Orla-Kreis,47,6,41,80868,70
DE-TH,04-04-2020,RKI,3,3,0,1585958400000,16075,Saale-Orla-Kreis,50,6,44,80868,70
DE-TH,05-04-2020,RKI,1,0,1,1586044800000,16075,Saale-Orla-Kreis,51,7,44,80868,70
DE-TH,07-04-2020,RKI,3,3,0,1586217600000,16075,Saale-Orla-Kreis,54,7,47,80868,70
DE-TH,08-04-2020,RKI,6,5,1,1586304000000,16075,Saale-Orla-Kreis,60,8,52,80868,70
DE-TH,09-04-2020,RKI,5,4,1,1586390400000,16075,Saale-Orla-Kreis,65,9,56,80868,70
DE-TH,10-04-2020,RKI,2,2,0,1586476800000,16075,Saale-Orla-Kreis,67,9,58,80868,70
DE-TH,11-04-2020,RKI,2,2,0,1586563200000,16075,Saale-Orla-Kreis,69,9,60,80868,70
DE-TH,12-04-2020,RKI,2,1,1,1586649600000,16075,Saale-Orla-Kreis,71,10,61,80868,70
DE-TH,13-04-2020,RKI,0,0,0,1586736000000,16075,Saale-Orla-Kreis,71,10,61,80868,70
DE-TH,14-04-2020,RKI,0,0,0,1586822400000,16075,Saale-Orla-Kreis,71,10,61,80868,70
DE-TH,15-04-2020,RKI,2,1,1,1586908800000,16075,Saale-Orla-Kreis,73,11,62,80868,70
DE-TH,16-04-2020,RKI,0,0,0,1586995200000,16075,Saale-Orla-Kreis,73,11,62,80868,70
DE-TH,17-04-2020,RKI,2,2,0,1587081600000,16075,Saale-Orla-Kreis,75,11,64,80868,70
DE-TH,18-04-2020,RKI,3,3,0,1587168000000,16075,Saale-Orla-Kreis,78,11,67,80868,70
DE-TH,20-04-2020,RKI,2,1,1,1587340800000,16075,Saale-Orla-Kreis,80,12,68,80868,70
DE-TH,21-04-2020,RKI,2,2,0,1587427200000,16075,Saale-Orla-Kreis,82,12,70,80868,70
DE-TH,22-04-2020,RKI,1,1,0,1587513600000,16075,Saale-Orla-Kreis,83,12,71,80868,70
DE-TH,23-04-2020,RKI,1,1,0,1587600000000,16075,Saale-Orla-Kreis,84,12,72,80868,70
DE-TH,25-04-2020,RKI,0,0,0,1587772800000,16075,Saale-Orla-Kreis,84,12,72,80868,70
DE-TH,26-04-2020,RKI,1,1,0,1587859200000,16075,Saale-Orla-Kreis,85,12,73,80868,70
DE-TH,28-04-2020,RKI,0,0,0,1588032000000,16075,Saale-Orla-Kreis,85,12,73,80868,70
DE-TH,29-04-2020,RKI,1,1,0,1588118400000,16075,Saale-Orla-Kreis,86,12,74,80868,70
DE-TH,30-04-2020,RKI,2,2,0,1588204800000,16075,Saale-Orla-Kreis,88,12,76,80868,70
DE-TH,05-05-2020,RKI,2,2,0,1588636800000,16075,Saale-Orla-Kreis,90,12,78,80868,70
DE-TH,06-05-2020,RKI,1,1,0,1588723200000,16075,Saale-Orla-Kreis,91,12,79,80868,70
DE-TH,08-05-2020,RKI,0,0,0,1588896000000,16075,Saale-Orla-Kreis,91,12,79,80868,70
DE-TH,10-05-2020,RKI,0,0,0,1589068800000,16075,Saale-Orla-Kreis,91,12,79,80868,70
DE-TH,11-05-2020,RKI,1,1,0,1589155200000,16075,Saale-Orla-Kreis,92,12,80,80868,70
DE-TH,13-05-2020,RKI,0,0,0,1589328000000,16075,Saale-Orla-Kreis,92,12,80,80868,70
DE-TH,14-05-2020,RKI,0,0,0,1589414400000,16075,Saale-Orla-Kreis,92,12,80,80868,70
DE-TH,15-05-2020,RKI,0,0,0,1589500800000,16075,Saale-Orla-Kreis,92,12,80,80868,70
DE-TH,16-05-2020,RKI,1,1,0,1589587200000,16075,Saale-Orla-Kreis,93,12,81,80868,70
DE-TH,19-05-2020,RKI,2,2,0,1589846400000,16075,Saale-Orla-Kreis,95,12,83,80868,70
DE-TH,22-05-2020,RKI,0,0,0,1590105600000,16075,Saale-Orla-Kreis,95,12,83,80868,70
DE-TH,26-05-2020,RKI,1,1,0,1590451200000,16075,Saale-Orla-Kreis,96,12,84,80868,70
DE-TH,28-05-2020,RKI,0,0,0,1590624000000,16075,Saale-Orla-Kreis,96,12,84,80868,70
DE-TH,02-06-2020,RKI,1,1,0,1591056000000,16075,Saale-Orla-Kreis,97,12,85,80868,70
DE-TH,29-06-2020,RKI,0,0,0,1593388800000,16075,Saale-Orla-Kreis,97,12,85,80868,70
DE-TH,16-03-2020,RKI,1,1,0,1584316800000,16076,Greiz,1,0,1,98159,116
DE-TH,17-03-2020,RKI,3,3,0,1584403200000,16076,Greiz,4,0,4,98159,116
DE-TH,18-03-2020,RKI,7,7,0,1584489600000,16076,Greiz,11,0,11,98159,116
DE-TH,19-03-2020,RKI,6,6,0,1584576000000,16076,Greiz,17,0,17,98159,116
DE-TH,20-03-2020,RKI,7,7,0,1584662400000,16076,Greiz,24,0,24,98159,116
DE-TH,21-03-2020,RKI,5,5,0,1584748800000,16076,Greiz,29,0,29,98159,116
DE-TH,22-03-2020,RKI,8,8,0,1584835200000,16076,Greiz,37,0,37,98159,116
DE-TH,23-03-2020,RKI,5,4,1,1584921600000,16076,Greiz,42,1,41,98159,116
DE-TH,24-03-2020,RKI,6,6,0,1585008000000,16076,Greiz,48,1,47,98159,116
DE-TH,25-03-2020,RKI,18,15,3,1585094400000,16076,Greiz,66,4,62,98159,116
DE-TH,26-03-2020,RKI,16,15,1,1585180800000,16076,Greiz,82,5,77,98159,116
DE-TH,27-03-2020,RKI,7,7,0,1585267200000,16076,Greiz,89,5,84,98159,116
DE-TH,28-03-2020,RKI,9,9,0,1585353600000,16076,Greiz,98,5,93,98159,116
DE-TH,29-03-2020,RKI,8,7,1,1585440000000,16076,Greiz,106,6,100,98159,116
DE-TH,30-03-2020,RKI,1,1,0,1585526400000,16076,Greiz,107,6,101,98159,116
DE-TH,31-03-2020,RKI,10,9,1,1585612800000,16076,Greiz,117,7,110,98159,116
DE-TH,01-04-2020,RKI,10,10,0,1585699200000,16076,Greiz,127,7,120,98159,116
DE-TH,02-04-2020,RKI,11,10,1,1585785600000,16076,Greiz,138,8,130,98159,116
DE-TH,03-04-2020,RKI,8,7,1,1585872000000,16076,Greiz,146,9,137,98159,116
DE-TH,04-04-2020,RKI,6,5,1,1585958400000,16076,Greiz,152,10,142,98159,116
DE-TH,05-04-2020,RKI,11,11,0,1586044800000,16076,Greiz,163,10,153,98159,116
DE-TH,06-04-2020,RKI,6,5,1,1586131200000,16076,Greiz,169,11,158,98159,116
DE-TH,07-04-2020,RKI,12,10,2,1586217600000,16076,Greiz,181,13,168,98159,116
DE-TH,08-04-2020,RKI,6,6,0,1586304000000,16076,Greiz,187,13,174,98159,116
DE-TH,09-04-2020,RKI,12,12,0,1586390400000,16076,Greiz,199,13,186,98159,116
DE-TH,10-04-2020,RKI,4,3,1,1586476800000,16076,Greiz,203,14,189,98159,116
DE-TH,11-04-2020,RKI,2,0,2,1586563200000,16076,Greiz,205,16,189,98159,116
DE-TH,12-04-2020,RKI,8,7,1,1586649600000,16076,Greiz,213,17,196,98159,116
DE-TH,13-04-2020,RKI,0,0,0,1586736000000,16076,Greiz,213,17,196,98159,116
DE-TH,14-04-2020,RKI,7,6,1,1586822400000,16076,Greiz,220,18,202,98159,116
DE-TH,15-04-2020,RKI,1,0,1,1586908800000,16076,Greiz,221,19,202,98159,116
DE-TH,16-04-2020,RKI,31,30,1,1586995200000,16076,Greiz,252,20,232,98159,116
DE-TH,17-04-2020,RKI,6,6,0,1587081600000,16076,Greiz,258,20,238,98159,116
DE-TH,18-04-2020,RKI,9,6,3,1587168000000,16076,Greiz,267,23,244,98159,116
DE-TH,19-04-2020,RKI,7,7,0,1587254400000,16076,Greiz,274,23,251,98159,116
DE-TH,20-04-2020,RKI,5,5,0,1587340800000,16076,Greiz,279,23,256,98159,116
DE-TH,21-04-2020,RKI,18,16,2,1587427200000,16076,Greiz,297,25,272,98159,116
DE-TH,22-04-2020,RKI,7,6,1,1587513600000,16076,Greiz,304,26,278,98159,116
DE-TH,23-04-2020,RKI,19,18,1,1587600000000,16076,Greiz,323,27,296,98159,116
DE-TH,24-04-2020,RKI,12,11,1,1587686400000,16076,Greiz,335,28,307,98159,116
DE-TH,25-04-2020,RKI,11,8,3,1587772800000,16076,Greiz,346,31,315,98159,116
DE-TH,26-04-2020,RKI,6,6,0,1587859200000,16076,Greiz,352,31,321,98159,116
DE-TH,27-04-2020,RKI,6,5,1,1587945600000,16076,Greiz,358,32,326,98159,116
DE-TH,28-04-2020,RKI,10,9,1,1588032000000,16076,Greiz,368,33,335,98159,116
DE-TH,29-04-2020,RKI,9,7,2,1588118400000,16076,Greiz,377,35,342,98159,116
DE-TH,30-04-2020,RKI,20,17,3,1588204800000,16076,Greiz,397,38,359,98159,116
DE-TH,01-05-2020,RKI,3,3,0,1588291200000,16076,Greiz,400,38,362,98159,116
DE-TH,02-05-2020,RKI,5,4,1,1588377600000,16076,Greiz,405,39,366,98159,116
DE-TH,03-05-2020,RKI,0,0,0,1588464000000,16076,Greiz,405,39,366,98159,116
DE-TH,04-05-2020,RKI,20,20,0,1588550400000,16076,Greiz,425,39,386,98159,116
DE-TH,05-05-2020,RKI,21,21,0,1588636800000,16076,Greiz,446,39,407,98159,116
DE-TH,06-05-2020,RKI,10,9,1,1588723200000,16076,Greiz,456,40,416,98159,116
DE-TH,07-05-2020,RKI,8,8,0,1588809600000,16076,Greiz,464,40,424,98159,116
DE-TH,08-05-2020,RKI,2,2,0,1588896000000,16076,Greiz,466,40,426,98159,116
DE-TH,09-05-2020,RKI,6,6,0,1588982400000,16076,Greiz,472,40,432,98159,116
DE-TH,10-05-2020,RKI,0,0,0,1589068800000,16076,Greiz,472,40,432,98159,116
DE-TH,11-05-2020,RKI,7,6,1,1589155200000,16076,Greiz,479,41,438,98159,116
DE-TH,12-05-2020,RKI,14,14,0,1589241600000,16076,Greiz,493,41,452,98159,116
DE-TH,13-05-2020,RKI,7,7,0,1589328000000,16076,Greiz,500,41,459,98159,116
DE-TH,14-05-2020,RKI,5,5,0,1589414400000,16076,Greiz,505,41,464,98159,116
DE-TH,15-05-2020,RKI,3,3,0,1589500800000,16076,Greiz,508,41,467,98159,116
DE-TH,16-05-2020,RKI,3,3,0,1589587200000,16076,Greiz,511,41,470,98159,116
DE-TH,17-05-2020,RKI,5,5,0,1589673600000,16076,Greiz,516,41,475,98159,116
DE-TH,19-05-2020,RKI,6,6,0,1589846400000,16076,Greiz,522,41,481,98159,116
DE-TH,20-05-2020,RKI,1,1,0,1589932800000,16076,Greiz,523,41,482,98159,116
DE-TH,21-05-2020,RKI,6,6,0,1590019200000,16076,Greiz,529,41,488,98159,116
DE-TH,22-05-2020,RKI,3,3,0,1590105600000,16076,Greiz,532,41,491,98159,116
DE-TH,23-05-2020,RKI,2,2,0,1590192000000,16076,Greiz,534,41,493,98159,116
DE-TH,24-05-2020,RKI,4,4,0,1590278400000,16076,Greiz,538,41,497,98159,116
DE-TH,25-05-2020,RKI,0,0,0,1590364800000,16076,Greiz,538,41,497,98159,116
DE-TH,26-05-2020,RKI,4,4,0,1590451200000,16076,Greiz,542,41,501,98159,116
DE-TH,27-05-2020,RKI,3,3,0,1590537600000,16076,Greiz,545,41,504,98159,116
DE-TH,28-05-2020,RKI,0,0,0,1590624000000,16076,Greiz,545,41,504,98159,116
DE-TH,29-05-2020,RKI,1,1,0,1590710400000,16076,Greiz,546,41,505,98159,116
DE-TH,31-05-2020,RKI,0,0,0,1590883200000,16076,Greiz,546,41,505,98159,116
DE-TH,01-06-2020,RKI,0,0,0,1590969600000,16076,Greiz,546,41,505,98159,116
DE-TH,08-06-2020,RKI,0,0,0,1591574400000,16076,Greiz,546,41,505,98159,116
DE-TH,09-06-2020,RKI,1,1,0,1591660800000,16076,Greiz,547,41,506,98159,116
DE-TH,10-06-2020,RKI,7,6,1,1591747200000,16076,Greiz,554,42,512,98159,116
DE-TH,11-06-2020,RKI,9,9,0,1591833600000,16076,Greiz,563,42,521,98159,116
DE-TH,12-06-2020,RKI,1,1,0,1591920000000,16076,Greiz,564,42,522,98159,116
DE-TH,13-06-2020,RKI,5,5,0,1592006400000,16076,Greiz,569,42,527,98159,116
DE-TH,14-06-2020,RKI,0,0,0,1592092800000,16076,Greiz,569,42,527,98159,116
DE-TH,16-06-2020,RKI,3,3,0,1592265600000,16076,Greiz,572,42,530,98159,116
DE-TH,17-06-2020,RKI,2,2,0,1592352000000,16076,Greiz,574,42,532,98159,116
DE-TH,18-06-2020,RKI,1,1,0,1592438400000,16076,Greiz,575,42,533,98159,116
DE-TH,25-06-2020,RKI,0,0,0,1593043200000,16076,Greiz,575,42,533,98159,116
DE-TH,26-06-2020,RKI,0,0,0,1593129600000,16076,Greiz,575,42,533,98159,116
DE-TH,30-06-2020,RKI,1,1,0,1593475200000,16076,Greiz,576,42,534,98159,116
DE-TH,16-03-2020,RKI,0,0,0,1584316800000,16077,Altenburger Land,1,0,1,90118,158
DE-TH,17-03-2020,RKI,1,1,0,1584403200000,16077,Altenburger Land,2,0,2,90118,158
DE-TH,21-03-2020,RKI,1,1,0,1584748800000,16077,Altenburger Land,3,0,3,90118,158
DE-TH,22-03-2020,RKI,0,0,0,1584835200000,16077,Altenburger Land,3,0,3,90118,158
DE-TH,24-03-2020,RKI,7,6,1,1585008000000,16077,Altenburger Land,10,1,9,90118,158
DE-TH,25-03-2020,RKI,0,0,0,1585094400000,16077,Altenburger Land,10,1,9,90118,158
DE-TH,27-03-2020,RKI,1,1,0,1585267200000,16077,Altenburger Land,11,1,10,90118,158
DE-TH,28-03-2020,RKI,0,0,0,1585353600000,16077,Altenburger Land,11,1,10,90118,158
DE-TH,31-03-2020,RKI,3,3,0,1585612800000,16077,Altenburger Land,14,1,13,90118,158
DE-TH,01-04-2020,RKI,3,3,0,1585699200000,16077,Altenburger Land,17,1,16,90118,158
DE-TH,02-04-2020,RKI,1,1,0,1585785600000,16077,Altenburger Land,18,1,17,90118,158
DE-TH,05-04-2020,RKI,0,0,0,1586044800000,16077,Altenburger Land,18,1,17,90118,158
DE-TH,07-04-2020,RKI,1,0,1,1586217600000,16077,Altenburger Land,19,2,17,90118,158
DE-TH,09-04-2020,RKI,0,0,0,1586390400000,16077,Altenburger Land,19,2,17,90118,158
DE-TH,10-04-2020,RKI,1,1,0,1586476800000,16077,Altenburger Land,20,2,18,90118,158
DE-TH,14-04-2020,RKI,0,0,0,1586822400000,16077,Altenburger Land,20,2,18,90118,158
DE-TH,15-04-2020,RKI,0,0,0,1586908800000,16077,Altenburger Land,20,2,18,90118,158
DE-TH,16-04-2020,RKI,2,2,0,1586995200000,16077,Altenburger Land,22,2,20,90118,158
DE-TH,20-04-2020,RKI,2,2,0,1587340800000,16077,Altenburger Land,24,2,22,90118,158
DE-TH,21-04-2020,RKI,0,0,0,1587427200000,16077,Altenburger Land,24,2,22,90118,158
DE-TH,22-04-2020,RKI,0,0,0,1587513600000,16077,Altenburger Land,24,2,22,90118,158
DE-TH,23-04-2020,RKI,0,0,0,1587600000000,16077,Altenburger Land,24,2,22,90118,158
DE-TH,27-04-2020,RKI,0,0,0,1587945600000,16077,Altenburger Land,24,2,22,90118,158
DE-TH,28-04-2020,RKI,1,1,0,1588032000000,16077,Altenburger Land,25,2,23,90118,158
DE-TH,29-04-2020,RKI,0,0,0,1588118400000,16077,Altenburger Land,25,2,23,90118,158
DE-TH,30-04-2020,RKI,0,0,0,1588204800000,16077,Altenburger Land,25,2,23,90118,158
DE-TH,06-05-2020,RKI,0,0,0,1588723200000,16077,Altenburger Land,25,2,23,90118,158
DE-TH,07-05-2020,RKI,0,0,0,1588809600000,16077,Altenburger Land,25,2,23,90118,158
DE-TH,11-05-2020,RKI,4,4,0,1589155200000,16077,Altenburger Land,29,2,27,90118,158
DE-TH,18-05-2020,RKI,0,0,0,1589760000000,16077,Altenburger Land,29,2,27,90118,158
DE-TH,19-05-2020,RKI,0,0,0,1589846400000,16077,Altenburger Land,29,2,27,90118,158
DE-TH,20-05-2020,RKI,0,0,0,1589932800000,16077,Altenburger Land,29,2,27,90118,158
DE-TH,21-05-2020,RKI,0,0,0,1590019200000,16077,Altenburger Land,29,2,27,90118,158
DE-TH,25-05-2020,RKI,0,0,0,1590364800000,16077,Altenburger Land,29,2,27,90118,158
DE-TH,26-05-2020,RKI,0,0,0,1590451200000,16077,Altenburger Land,29,2,27,90118,158
DE-TH,27-05-2020,RKI,0,0,0,1590537600000,16077,Altenburger Land,29,2,27,90118,158
DE-TH,28-05-2020,RKI,3,3,0,1590624000000,16077,Altenburger Land,32,2,30,90118,158
DE-TH,29-05-2020,RKI,0,0,0,1590710400000,16077,Altenburger Land,32,2,30,90118,158
DE-TH,08-06-2020,RKI,0,0,0,1591574400000,16077,Altenburger Land,32,2,30,90118,158
DE-TH,09-06-2020,RKI,2,2,0,1591660800000,16077,Altenburger Land,34,2,32,90118,158
DE-TH,29-06-2020,RKI,0,0,0,1593388800000,16077,Altenburger Land,34,2,32,90118,158
DE-TH,14-07-2020,RKI,0,0,0,1594684800000,16077,Altenburger Land,34,2,32,90118,158
DE-TH,15-07-2020,RKI,1,0,0,1594771200000,16077,Altenburger Land,35,2,32,90118,158
